Season,Rank,Player,Jersey number,Team,POS,GP,G,A,TP,PIM,GWG,PPG,SOG,HITS,BKS,+,-,+/-,TOI/GP
,1,Ryan Lasch,81,Frölunda,F,46,12,38,50,18,3,3,83,10,4,31,42,-11,18:35
,2,Joakim Lindström,10,Skellefteå,F,48,18,24,42,20,5,5,165,5,10,37,28,9,17:33
,3,Derek Roy,9,Linköping,F,49,8,34,42,28,0,4,92,9,25,34,26,8,17:48
,4,Jesse Virtanen,71,Färjestad,D,52,6,35,41,47,0,4,85,13,48,42,26,16,22:17
,5,Markus Ljungh,16,HV71,F,52,16,24,40,8,2,2,98,12,17,39,32,7,18:00
,6,Konstantin Komarek,67,Malmö,F,49,13,26,39,18,4,7,105,7,14,24,22,2,14:53
,7,Oscar Möller,45,Skellefteå,F,51,19,19,38,8,3,6,172,35,43,33,22,11,18:21
,8,Ted Brithén,90,Rögle,F,46,12,26,38,12,1,5,116,11,35,34,27,7,18:45
,9,Ryan Gunderson,13,Brynäs,D,52,8,30,38,18,1,3,116,3,43,44,42,2,25:41:00
,10,Oskar Steen,29,Färjestad,F,46,17,20,37,49,2,2,95,55,15,37,20,17,15:37
,11,Kodie Curran,4,Rögle,D,49,12,25,37,24,3,6,133,34,43,45,41,4,23:46
,12,Jakob Lilja,15,Djurgården,F,52,12,25,37,18,3,2,110,21,27,36,33,3,18:03
,13,Spencer Abbott,77,Mora,F,42,7,29,36,8,3,1,79,2,16,31,20,11,17:06
,14,Emil Bemström,72,Djurgården,F,47,23,12,35,8,2,10,92,27,13,29,19,10,13:46
,15,Joakim Nygård,11,Färjestad,F,52,21,14,35,20,3,6,153,11,20,38,23,15,18:29
,16,Daniel Brodin,34,Djurgården,F,52,19,16,35,63,4,6,127,92,21,35,35,0,16:08
,17,Jack Connolly,20,Luleå,F,52,16,19,35,26,8,3,86,16,18,29,15,14,18:34
,18,Mathias Bromé,86,Mora,F,52,15,20,35,18,1,6,110,9,23,38,39,-1,18:50
,19,Daniel Zaar,72,Rögle,F,50,13,22,35,16,3,3,150,29,9,31,24,7,17:13
,20,Jesper Boqvist,90,Brynäs,F,51,13,22,35,14,1,3,120,35,17,37,31,6,18:25
,21,Jacob Josefson,40,Djurgården,F,40,12,23,35,32,3,2,83,20,20,31,25,6,17:53
,22,Niklas Olausson,16,Luleå,F,43,16,18,34,24,5,2,67,2,16,33,20,13,17:45
,23,Joel Kellman,11,Brynäs,F,45,16,18,34,16,2,8,93,5,12,35,32,3,19:16
,24,Brendan Shinnimin,24,Växjö,F,47,17,16,33,86,3,4,111,33,14,30,20,10,17:39
,25,Jesper Olofsson,92,Färjestad,F,51,17,16,33,8,3,7,130,25,10,34,19,15,15:26
,26,Andrew Rowe,9,Mora,F,46,15,18,33,28,2,4,104,22,24,36,36,0,18:23
,27,Roman Horák,23,Växjö,F,50,15,18,33,24,3,3,108,19,37,34,24,10,18:36
,28,Simon Hjalmarsson,59,Frölunda,F,52,15,18,33,26,4,7,80,21,29,31,33,-2,15:35
,29,Leon Bristedt,67,Rögle,F,46,13,20,33,30,2,4,100,31,16,33,30,3,18:10
,30,Nick Ebert,74,Örebro,D,49,11,22,33,46,3,6,144,31,36,34,36,-2,21:23
,31,Robin Kovacs,96,Luleå,F,52,11,22,33,38,1,6,90,10,16,34,28,6,16:00
,32,Simon Önerud,11,HV71,F,46,17,15,32,20,5,3,127,15,24,33,21,12,17:33
,33,Michael Lindqvist,34,Färjestad,F,33,16,16,32,10,4,5,85,5,16,25,16,9,16:35
,34,Michael Haga,85,Mora,F,52,15,17,32,20,4,1,72,18,13,26,39,-13,17:02
,35,Mattias Tedenby,21,HV71,F,50,12,20,32,24,1,1,110,16,16,33,30,3,17:08
,36,Henrik Törnqvist,11,Timrå,F,51,9,23,32,10,0,3,90,35,28,34,33,1,15:50
,37,Joel Lundqvist,20,Frölunda,F,51,13,18,31,26,3,5,77,91,14,34,33,1,17:53
,38,Rickard Palmberg,91,Timrå,F,46,9,22,31,10,1,4,101,15,17,20,27,-7,14:00
,39,Joel Persson,94,Växjö,D,50,6,25,31,8,2,4,150,18,25,32,26,6,19:11
,40,Janne Pesonen,22,Växjö,F,42,17,13,30,18,5,3,111,14,10,28,20,8,16:18
,41,Nicklas Danielsson,74,Brynäs,F,50,15,15,30,63,3,4,140,29,19,34,33,1,18:36
,41,Robin Figren,23,HV71,F,50,15,15,30,26,4,4,137,17,31,27,31,-4,16:38
,43,Patrik Carlsson,72,Frölunda,F,45,12,18,30,8,3,7,112,19,20,29,31,-2,17:05
,44,Broc Little,41,Linköping,F,33,17,12,29,22,6,6,78,10,11,22,20,2,17:12
,45,Frederik Storm,9,Malmö,F,47,17,12,29,6,3,6,91,15,16,27,18,9,15:19
,46,Johan Ryno,61,Färjestad,F,45,14,15,29,57,4,4,100,18,23,27,20,7,17:21
,47,Joe Whitney,19,Linköping,F,51,14,15,29,34,1,4,93,24,12,28,22,6,15:21
,48,Aaron Palushaj,11,Örebro,F,31,12,16,28,54,3,4,104,3,16,21,18,3,17:42
,49,Shane Harper,10,Örebro,F,52,9,19,28,14,1,3,83,30,15,25,31,-6,16:09
,50,Marcus Nilsson,10,Färjestad,F,52,7,21,28,2,3,1,53,7,5,26,20,6,12:13
,50,Linus Fröberg,71,Växjö,F,52,7,21,28,24,2,1,97,7,24,28,30,-2,17:32
,52,Anton Wedin,57,Timrå,F,32,14,13,27,8,5,2,89,10,9,20,26,-6,19:10
,53,Petter Emanuelsson,11,Luleå,F,52,14,13,27,16,3,3,144,12,23,32,13,19,18:10
,54,Sebastian Strandberg,29,Djurgården,F,52,11,16,27,26,5,0,76,7,19,27,24,3,15:40
,55,Marcus Davidsson,9,Djurgården,F,52,10,17,27,16,2,4,73,39,29,33,23,10,15:46
,56,Linus Hultström,33,Djurgården,D,52,9,18,27,4,1,4,156,7,31,45,39,6,20:20
,57,Pathrik Westerholm,7,Frölunda,F,51,7,20,27,16,1,3,119,7,27,25,24,1,14:40
,58,Erik Gustafsson,29,Luleå,D,49,6,21,27,37,2,4,106,13,51,41,31,10,24:44:00
,59,Kristian Näkyvä,51,Örebro,D,51,6,21,27,38,1,1,103,24,32,32,33,-1,20:35
,60,Rodrigo Abols,18,Örebro,F,45,18,8,26,20,2,5,100,26,18,27,28,-1,16:04
,61,Bud Holloway,4,Skellefteå,F,52,11,15,26,10,1,5,128,21,34,27,25,2,15:03
,62,Andrew Gordon,13,Linköping,F,47,9,17,26,16,3,3,119,55,37,26,33,-7,16:44
,62,Jonathan Pudas,64,Skellefteå,D,47,9,17,26,24,4,1,91,22,45,34,27,7,20:43
,64,Fredrik Händemark,63,Malmö,F,49,6,20,26,91,2,1,79,72,25,27,24,3,18:09
,65,Samuel Fagemo,11,Frölunda,F,42,14,11,25,6,2,2,109,9,23,27,22,5,13:56
,66,Linus Johansson,59,Färjestad,F,51,10,15,25,67,2,2,77,41,55,34,18,16,18:19
,67,Ludvig Rensfeldt,29,Timrå,F,49,9,16,25,10,0,2,107,8,28,21,41,-20,16:24
,68,Chay Genoway,5,Frölunda,D,51,9,16,25,12,3,1,112,7,52,41,36,5,21:03
,69,Dick Axelsson,31,Djurgården,F,36,7,18,25,39,1,2,61,34,15,23,15,8,14:03
,70,Joakim Andersson,18,HV71,F,51,5,20,25,26,0,0,55,11,18,31,22,9,15:51
,71,Andreas Wingerli,24,Skellefteå,F,52,14,10,24,55,1,0,74,35,25,33,25,8,15:04
,72,Lukas Bengtsson,32,Linköping,D,42,7,17,24,12,1,2,87,27,48,29,36,-7,21:58
,73,Mikko Lehtonen,44,HV71,D,52,5,19,24,30,0,2,115,17,32,43,34,9,21:49
,74,Mathis Olimb,46,Skellefteå,F,52,4,20,24,30,0,2,84,9,13,23,23,0,16:10
,75,Linus Sandin,20,Rögle,F,50,16,7,23,16,2,2,88,17,21,25,25,0,15:45
,76,Nick Sörensen,10,Linköping,F,39,14,9,23,22,3,3,93,37,25,22,22,0,14:43
,77,Emil Sylvegård,51,Malmö,F,49,11,12,23,34,2,4,80,70,28,23,17,6,17:55
,78,Anton Hedman,8,Örebro,F,48,9,14,23,28,0,1,75,79,32,25,27,-2,14:50
,79,Dominik Bokk,78,Växjö,F,47,8,15,23,10,1,6,76,5,7,20,21,-1,12:28
,80,Johannes Kinnvall,28,Timrå,D,52,12,10,22,14,2,6,88,9,34,33,48,-15,18:55
,81,Max Görtz,17,Malmö,F,43,10,12,22,4,4,5,95,17,13,14,13,1,14:05
,82,Jere Sallinen,76,Örebro,F,51,8,14,22,53,0,2,121,50,27,28,27,1,17:21
,83,Adam Brodecki,68,Linköping,F,46,7,15,22,10,1,2,95,23,31,27,33,-6,14:29
,84,Max Friberg,12,Frölunda,F,52,7,15,22,14,1,1,79,47,33,27,26,1,16:13
,84,Oscar Sundh,13,HV71,F,52,7,15,22,12,4,2,65,8,22,21,25,-4,14:50
,84,Jimmy Andersson,84,Linköping,F,52,7,15,22,18,0,1,79,27,21,29,30,-1,14:32
,87,Emil Djuse,57,Skellefteå,D,49,6,16,22,45,2,2,99,44,62,28,29,-1,20:57
,88,Jordan Boucher,39,Örebro,F,52,6,16,22,36,2,0,76,42,17,24,19,5,13:39
,89,Ryan Johnston,89,Mora,D,50,3,19,22,36,0,2,76,19,33,28,44,-16,19:42
,90,Jonathan Davidsson,71,Djurgården,F,37,10,11,21,18,1,1,86,48,24,22,14,8,16:47
,91,Rhett Rakhshani,49,Frölunda,F,38,9,12,21,30,1,2,82,5,10,21,23,-2,15:05
,92,Einar Emanuelsson,10,Luleå,F,51,9,12,21,4,2,1,75,14,26,30,28,2,15:04
,93,Filip Hållander,51,Timrå,F,45,7,14,21,4,1,3,79,4,27,26,28,-2,15:38
,94,Niclas Bergfors,10,Djurgården,F,52,6,15,21,12,2,2,162,21,18,29,20,9,14:42
,95,Carl-Johan Lerby,14,Malmö,D,47,5,16,21,20,0,3,84,17,49,25,24,1,20:08
,96,Kevin Gagné,12,Mora,D,46,4,17,21,14,2,2,60,3,25,37,47,-10,20:33
,97,Chad Billins,4,Linköping,D,52,3,18,21,18,0,1,86,19,54,32,43,-11,21:24
,98,Emil Larsson,36,Luleå,F,48,9,11,20,20,4,1,97,38,17,28,32,-4,17:20
,99,Taylor Matson,17,Rögle,F,52,8,12,20,36,1,1,57,47,18,30,27,3,17:22
,99,Ponthus Westerholm,27,Frölunda,F,52,8,12,20,6,2,2,69,8,18,26,19,7,12:31
,99,Daniel Viksten,13,Färjestad,F,52,8,12,20,4,5,0,100,22,16,31,15,16,14:49
,102,Marcus Weinstock,20,Örebro,F,46,7,13,20,45,2,2,78,33,18,25,25,0,15:45
,103,Michael Keränen,77,Mora,F,45,6,14,20,24,4,2,102,31,12,22,26,-4,15:52
,104,Daniel Sondell,50,Luleå,D,49,6,14,20,34,2,2,83,17,39,28,28,0,18:50
,105,Mikael Wikstrand,6,Färjestad,D,47,4,16,20,14,1,2,81,16,48,35,36,-1,22:39
,106,Lucas Elvenes,75,Rögle,F,42,3,17,20,4,0,0,37,1,12,23,21,2,14:08
,107,Gustav Rydahl,15,Färjestad,F,47,12,7,19,28,1,2,52,63,18,35,20,15,13:52
,108,Johan Olofsson,8,Malmö,F,50,11,8,19,4,4,3,64,8,14,17,24,-7,14:21
,109,Andreas Thuresson,12,HV71,F,43,10,9,19,26,1,6,85,35,4,19,19,0,14:40
,110,Jimmie Ericsson,21,Skellefteå,F,42,8,11,19,28,3,3,66,33,22,23,16,7,15:52
,111,Julius Junttila,13,Växjö,F,50,6,13,19,6,2,1,62,7,15,25,12,13,13:28
,112,Johannes Salmonsson,25,Timrå,F,33,4,15,19,14,0,1,50,15,8,20,23,-3,19:18
,113,Matt Bailey,22,Mora,F,41,12,6,18,57,2,0,54,45,23,24,38,-14,18:07
,114,Karl Fabricius,52,Luleå,F,52,10,8,18,16,2,2,70,20,28,23,14,9,13:44
,115,Sebastian Wännström,22,HV71,F,48,9,9,18,12,3,2,67,8,15,25,16,9,11:04
,116,Vilmos Gallo,55,Timrå,F,52,9,9,18,30,2,1,77,52,51,23,46,-23,14:53
,117,Simon Bertilsson,15,Brynäs,D,52,3,15,18,28,0,0,96,59,101,38,37,1,23:31
,118,Johan Harju,24,Luleå,F,52,11,6,17,24,1,3,105,43,24,15,20,-5,16:11
,119,Nils Andersson,8,HV71,D,43,5,12,17,18,0,3,76,9,21,30,22,8,18:40
,120,Tom Wandell,14,Örebro,F,49,5,12,17,12,2,1,88,19,29,26,27,-1,16:30
,121,Adam Pettersson,12,Skellefteå,F,52,5,12,17,18,1,1,64,35,36,24,20,4,14:51
,122,Tobias Ekberg,50,Malmö,D,44,3,14,17,16,1,0,74,23,22,28,20,8,17:53
,123,Ludvig Nilsson,41,Brynäs,F,50,3,14,17,14,0,1,47,35,22,16,20,-4,13:52
,124,Albin Eriksson,23,Skellefteå,F,44,9,7,16,29,4,3,69,12,19,14,14,0,10:18
,125,Jonathan Sigalet,56,Frölunda,D,45,7,9,16,20,2,1,59,72,58,34,30,4,21:11
,126,Anton Bengtsson,28,HV71,F,50,7,9,16,14,1,0,74,57,20,20,21,-1,14:37
,127,Adam Masuhr,38,Mora,D,52,5,11,16,26,1,3,72,51,79,40,37,3,21:27
,127,Oscar Engsund,32,Luleå,D,52,5,11,16,30,2,0,61,113,56,35,18,17,17:37
,129,Robert Kousal,71,Brynäs,F,40,9,6,15,24,0,4,72,41,16,13,27,-14,15:56
,130,Emil Forslund,18,Brynäs,F,52,9,6,15,4,3,0,61,23,40,17,29,-12,11:30
,131,Patrik Virta,19,Örebro,F,37,7,8,15,10,2,3,61,16,16,15,19,-4,14:25
,132,Mats Rosseli Olsen,51,Frölunda,F,47,6,9,15,24,2,0,46,24,25,19,20,-1,14:08
,133,Tomi Sallinen,51,/,F,33,4,11,15,4,0,0,35,9,9,21,26,-5,17:18
,133,Mattias Sjögren,11,Rögle,F,33,4,11,15,10,2,4,28,27,15,11,26,-15,16:30
,135,Olle Alsing,38,Djurgården,D,49,4,11,15,10,0,1,78,14,23,39,13,26,17:23
,136,Filip Karlsson,26,Linköping,F,46,3,12,15,2,2,2,44,10,14,15,32,-17,12:54
,137,Jesper Sellgren,23,Luleå,D,52,3,12,15,10,0,0,69,20,36,34,28,6,20:42
,138,Theodor Lennström,34,Färjestad,D,47,2,13,15,34,1,0,56,14,16,32,24,8,14:14
,139,Pontus Netterberg,14,/,F,46,9,5,14,10,3,1,61,12,6,13,22,-9,10:42
,140,Matej Stransky,44,Mora,F,24,8,6,14,16,0,1,48,12,4,21,21,0,17:10
,141,Henrik Hetta,20,Malmö,F,49,7,7,14,33,2,0,57,48,38,19,18,1,13:33
,142,Nils Höglander,21,Rögle,F,50,7,7,14,22,1,1,56,8,25,16,24,-8,12:36
,143,Tim Söderlund,9,/,F,48,6,8,14,33,3,0,65,19,7,17,17,0,11:47
,144,Joachim Rohdin,72,Brynäs,F,52,5,9,14,18,1,0,98,52,37,17,31,-14,17:56
,145,Christopher Mastomäki,33,Örebro,F,43,4,10,14,18,1,0,78,10,24,18,12,6,13:55
,146,Jens Olsson,28,Malmö,D,52,4,10,14,14,0,1,60,26,29,31,20,11,20:54
,147,Craig Schira,6,Rögle,D,41,2,12,14,12,0,1,79,75,51,31,32,-1,21:45
,148,Viktor Amnér,4,Mora,D,46,2,12,14,18,1,1,78,17,47,29,38,-9,19:50
,149,Robin Alvarez,27,Skellefteå,F,52,13,0,13,24,3,2,99,28,26,19,27,-8,14:44
,150,Johan Södergran,38,Linköping,F,42,8,5,13,4,3,1,67,13,11,17,18,-1,12:26
,151,Lars Bryggman,22,Malmö,F,30,7,6,13,16,1,1,42,17,17,20,11,9,15:58
,152,Anton Karlsson,47,Linköping,D,47,5,8,13,51,0,0,44,45,75,33,28,5,17:24
,153,Linus Arnesson,28,Örebro,D,50,5,8,13,12,0,1,72,29,40,27,28,-1,19:17
,154,Marcus Björk,7,/,D,52,5,8,13,12,1,3,100,25,25,24,29,-5,15:59
,155,Tuomas Kiiskinen,19,Växjö,F,34,4,9,13,2,0,1,38,8,27,18,14,4,16:13
,156,Jacob Blomqvist,44,Brynäs,F,49,4,9,13,45,1,3,85,11,33,15,26,-11,16:24
,157,Simon Ryfors,15,Rögle,F,51,3,10,13,41,0,1,46,11,18,21,27,-6,13:13
,158,Eddie Larsson,53,Linköping,D,43,2,11,13,32,0,0,46,37,35,33,30,3,21:17
,159,Edwin Hedberg,20,Skellefteå,F,52,9,3,12,22,1,1,64,19,10,20,17,3,11:13
,160,Trevor Mingoia,14,Rögle,F,26,7,5,12,2,0,1,50,8,10,12,16,-4,14:30
,161,Christoffer Forsberg,23,Malmö,F,52,7,5,12,12,1,0,49,20,22,21,21,0,13:31
,162,Henrik Eriksson,17,Djurgården,F,43,6,6,12,6,2,0,86,52,26,19,16,3,13:46
,163,Martin Johansson,25,Färjestad,F,44,6,6,12,12,2,0,53,39,23,20,14,6,13:56
,164,Austin Farley,91,Luleå,F,30,5,7,12,31,1,2,39,6,3,15,6,9,15:59
,165,Olle Lycksell,31,Linköping,F,51,5,7,12,10,0,0,55,9,12,19,22,-3,11:14
,166,Joel Mustonen,40,Frölunda,F,36,4,8,12,20,0,0,45,7,9,16,13,3,12:34
,167,Christoffer Törngren,67,HV71,F,49,4,8,12,14,0,0,57,8,6,17,10,7,10:49
,168,Axel Wemmenborn,15,Malmö,F,50,4,8,12,6,0,0,58,30,13,20,16,4,16:03
,169,Austin Ortega,16,Växjö,F,31,3,9,12,10,0,0,48,11,5,12,10,2,12:49
,170,Jesper Pettersson,37,Djurgården,D,50,3,9,12,51,0,0,69,28,32,23,22,1,17:24
,171,David Gustafsson,27,HV71,F,36,2,10,12,10,0,0,45,10,7,14,16,-2,14:12
,172,Ilari Melart,11,Färjestad,D,40,2,10,12,30,1,0,65,46,36,25,18,7,18:06
,173,Daniel Bertov,3,Rögle,D,49,2,10,12,44,0,0,62,56,37,38,24,14,17:36
,173,Kristofer Berglund,2,HV71,D,49,2,10,12,47,0,0,31,25,23,27,20,7,15:57
,175,John Persson,67,Mora,F,27,9,2,11,12,1,0,47,13,3,17,21,-4,14:31
,176,Sebastian Collberg,49,Timrå,F,37,7,4,11,10,1,1,49,22,9,12,33,-21,13:08
,177,James Wright,18,Linköping,F,44,5,6,11,10,0,1,54,31,11,14,23,-9,15:01
,178,Kris Versteeg,10,Växjö,F,12,4,7,11,4,1,0,23,1,1,10,5,5,17:26
,179,Johan Johnsson,41,HV71,F,52,4,7,11,4,1,0,50,12,17,18,12,6,11:35
,180,Hampus Larsson,26,Timrå,D,52,3,8,11,34,0,1,62,42,54,33,39,-6,21:01
,181,Axel Ottosson,18,Färjestad,F,44,2,9,11,39,0,0,32,13,18,17,16,1,10:09
,182,Filip Berglund,6,Skellefteå,D,52,2,9,11,22,0,0,72,33,56,29,28,1,19:02
,182,Jens Westin,3,Färjestad,D,52,2,9,11,8,0,0,55,18,56,39,18,21,18:20
,184,Marcus Hardegård,7,Timrå,D,40,1,10,11,14,0,0,36,7,37,20,36,-16,17:55
,185,Marcus Sylvegård,18,Malmö,F,45,6,4,10,78,0,2,42,29,5,11,16,-5,10:26
,186,Daniel Widing,41,/,F,46,6,4,10,37,4,0,80,15,21,18,18,0,11:26
,187,Isac Brännström,17,HV71,F,50,6,4,10,8,2,0,34,15,12,14,7,7,9:28
,188,Tylor Spink,9,Örebro,F,51,6,4,10,20,0,2,52,3,20,9,21,-12,11:48
,189,Johan Alcén,14,Brynäs,F,50,5,5,10,16,1,0,45,65,22,12,10,2,13:13
,190,Jason Garrison,7,Djurgården,D,20,4,6,10,4,1,0,17,8,22,18,13,5,16:51
,191,Mattias Guter,44,/  /,F,38,4,6,10,2,0,0,50,18,20,9,14,-5,11:33
,192,Fredrik Karlström,81,Linköping,F,45,4,6,10,8,1,0,37,8,11,12,18,-6,9:56
,193,Johan Forsberg,9,Luleå,F,49,4,6,10,6,1,0,37,12,6,12,17,-5,10:46
,194,Anton Öhman,36,Malmö,D,23,3,7,10,6,2,1,28,8,3,6,4,2,10:02
,195,Jesper Jensen,40,/,F,36,3,7,10,43,1,0,45,9,14,10,17,-7,15:40
,196,Nils Lundkvist,27,Luleå,D,41,3,7,10,8,0,0,35,10,10,22,15,7,12:43
,197,Pontus Holmberg,29,Växjö,F,47,3,7,10,12,0,0,56,6,13,13,15,-2,13:11
,198,Johan Ivarsson,7,Färjestad,D,49,3,7,10,64,0,0,36,87,28,31,22,9,14:32
,199,Jonathan Andersson,22,Örebro,D,52,3,7,10,22,0,0,52,15,30,31,31,0,17:10
,200,Robin Press,8,Färjestad,D,40,2,8,10,8,1,1,42,3,13,22,19,3,9:35
,201,Arvid Lundberg,52,Växjö,D,51,2,8,10,10,0,0,70,12,40,27,28,-1,18:41
,202,Linus Högberg,6,Växjö,D,52,2,8,10,8,1,0,53,9,27,33,25,8,17:10
,203,Axel Jonsson-Fjällby,91,Djurgården,F,36,1,9,10,8,0,0,38,28,13,18,11,7,13:43
,204,Tom Nilsson,43,Djurgården,D,48,1,9,10,16,0,0,48,73,64,33,20,13,18:57
,205,Patrik Norén,26,Skellefteå,D,52,1,9,10,16,0,0,47,37,47,27,15,12,14:05
,206,Anton Mylläri,59,Malmö,D,37,0,10,10,18,0,0,39,13,26,23,19,4,16:57
,207,Daniel Mannberg,79,Brynäs,F,46,5,4,9,14,2,0,39,12,26,12,15,-3,10:11
,208,Petteri Wirtanen,13,Djurgården,F,33,4,5,9,18,1,0,40,24,30,15,13,2,16:28
,209,Robin Johansson,58,Mora,F,35,4,5,9,37,0,1,57,26,23,13,21,-8,16:38
,210,Christopher Bengtsson,40,/,F,44,4,5,9,6,0,0,29,24,10,12,21,-9,10:26
,211,Anders Grönlund,15,Frölunda,D,48,4,5,9,14,0,0,42,22,47,31,29,2,15:57
,212,Jacob Olofsson,38,Timrå,F,34,3,6,9,2,1,2,36,16,9,14,28,-14,15:18
,213,Sebastian Stålberg,17,Frölunda,F,45,3,6,9,20,0,0,56,19,30,16,19,-3,13:19
,214,Isac Lundeström,37,Luleå,F,17,2,7,9,2,0,0,25,5,4,12,7,5,16:20
,215,Gustav Possler,80,Djurgården,F,26,1,8,9,6,0,0,46,12,19,10,6,4,14:08
,216,Juhamatti Aaltonen,71,Skellefteå,F,35,1,8,9,6,0,1,43,6,14,6,11,-5,12:43
,217,Johan Alm,,Skellefteå,D,52,0,9,9,49,0,0,33,36,52,25,23,2,14:14
,218,Samuel Jonsson,22,Rögle,D,51,5,3,8,6,2,0,51,8,31,24,29,-5,17:34
,219,Filip Cederqvist,21,Växjö,F,33,4,4,8,27,2,0,23,12,10,13,11,2,7:57
,220,Nichlas Hardt,43,/,F,40,4,4,8,14,0,0,41,59,11,10,6,4,11:19
,221,Glenn Gustafsson,37,Örebro,F,51,4,4,8,20,1,0,44,59,34,19,12,7,11:06
,222,David Bernhardt,49,/,D,36,3,5,8,4,0,1,28,10,6,16,9,7,12:06
,223,Alexander Ytterell,66,HV71,D,43,2,6,8,14,1,0,59,29,11,22,19,3,14:41
,224,Emil Berglund,22,Timrå,F,43,1,7,8,36,0,0,46,50,30,9,33,-24,13:27
,225,Markus Lauridsen,3,HV71,D,49,1,7,8,8,0,0,58,44,27,29,24,5,17:15
,226,Stefan Warg,6,/,D,50,1,7,8,28,1,0,57,61,54,24,23,1,16:58
,227,Olle Liss,44,Rögle,F,44,5,2,7,14,1,1,76,12,14,10,18,-8,10:20
,228,Alexander Reichenberg,81,Färjestad,F,27,4,3,7,14,0,0,21,5,8,12,14,-2,10:53
,229,Liam Reddox,85,Växjö,F,39,4,3,7,12,0,0,81,32,9,12,16,-4,14:43
,230,Jacob Moverare,3,Frölunda,D,42,4,3,7,10,1,0,23,19,34,21,23,-2,15:17
,230,Sebastian Hartmann,94,Mora,F,42,4,3,7,12,1,0,33,49,22,11,18,-7,10:52
,232,Kim Rosdahl,96,Malmö,F,44,4,3,7,46,0,0,31,32,18,16,9,7,10:58
,232,Victor Söderström,8,Brynäs,D,44,4,3,7,22,1,2,65,11,48,18,29,-11,17:06
,234,Niki Petti,96,Mora,F,45,4,3,7,37,0,0,43,40,11,12,26,-14,12:51
,235,Alexander Hilmerson,11,Mora,F,36,3,4,7,12,0,0,39,6,33,7,13,-6,12:07
,236,Jonas Ahnelöv,55,Rögle,D,39,3,4,7,20,2,0,39,48,49,23,23,0,16:49
,237,Albin Lundin,25,/,F,43,3,4,7,8,0,0,31,22,9,13,10,3,10:53
,238,Dan Pettersson,27,Linköping,F,47,3,4,7,35,0,0,36,42,40,14,21,-7,14:02
,239,Morten Madsen,29,Timrå,F,49,3,4,7,18,0,0,47,24,33,16,27,-11,12:45
,239,Fredrik Lindgren,61,Skellefteå,D,49,3,4,7,47,0,0,35,62,23,28,24,4,16:46
,239,Jeremy Boyce,23,Timrå,F,49,3,4,7,4,1,1,71,51,36,13,39,-26,13:25
,242,Erik Josefsson,60,Växjö,F,50,3,4,7,20,1,0,56,24,27,18,22,-4,15:22
,243,Jonas Berglund,14,Luleå,F,52,3,4,7,12,1,0,38,11,14,13,18,-5,12:24
,244,Brandon Gormley,36,Frölunda,D,17,2,5,7,6,0,2,25,3,13,16,18,-2,17:20
,245,Mattias Bäckman,5,Linköping,D,18,2,5,7,8,0,0,30,1,25,10,7,3,20:12
,246,Marek Daloga,71,Mora,D,34,2,5,7,39,0,1,53,9,26,19,34,-15,17:48
,247,Peter Andersson,44,Växjö,D,39,2,5,7,51,0,1,37,37,37,13,15,-2,13:35
,248,Alexander Falk,41,Timrå,D,41,2,5,7,26,0,0,40,30,22,17,41,-24,17:36
,249,Carl Persson,95,Malmö,F,35,1,6,7,10,0,0,54,24,7,15,16,-1,13:15
,250,Martin Fehervary,5,HV71,D,45,1,6,7,10,0,0,44,19,24,25,24,1,15:15
,251,Petter Granberg,8,Skellefteå,D,46,1,6,7,30,0,0,33,85,48,24,18,6,14:53
,252,Daniel Rahimi,48,Växjö,D,51,0,7,7,38,0,0,67,84,67,29,23,6,18:59
,253,Emil Aronsson,18,Mora,F,29,5,1,6,6,0,0,25,6,19,9,14,-5,13:31
,254,Carl Jakobsson,31,Färjestad,F,37,4,2,6,2,0,0,43,3,11,13,10,3,8:41
,255,Niklas Arell,42,Malmö,D,34,3,3,6,22,0,0,37,13,27,17,18,-1,17:26
,256,Gustav Lindström,10,Frölunda,D,40,3,3,6,50,0,1,58,30,36,20,25,-5,18:00
,257,Linus Lindström,16,Skellefteå,F,44,3,3,6,16,0,0,45,6,22,14,14,0,12:04
,258,Niclas Andersén,9,Brynäs,D,45,3,3,6,28,0,1,48,30,59,20,28,-8,19:44
,259,Didrik Strömberg,9,HV71,D,49,3,3,6,34,0,0,45,72,39,29,17,12,16:04
,260,Per Åslund,22,Färjestad,F,12,2,4,6,4,1,1,14,5,8,4,7,-3,16:14
,261,Jonas Röndbjerg,17,Växjö,F,45,2,4,6,6,0,0,35,4,12,6,15,-9,10:37
,262,Sebastian Erixon,50,Färjestad,D,25,1,5,6,18,0,0,34,16,21,18,8,10,16:51
,263,Samuel Asklöf,12,Brynäs,F,33,1,5,6,2,1,0,28,18,11,7,6,1,9:33
,264,Erik Andersson,38,Rögle,F,47,1,5,6,2,0,0,22,20,28,10,15,-5,10:11
,265,Robin Norell,56,Djurgården,D,52,1,5,6,18,0,0,44,25,28,26,30,-4,16:16
,266,Pontus Själin,39,Luleå,D,30,0,6,6,8,0,0,16,10,22,13,9,4,15:04
,267,Joonas Jalvanti,19,Luleå,D,51,0,6,6,16,0,0,36,6,25,19,23,-4,13:56
,268,Emil Molin,24,Malmö,F,10,4,1,5,2,2,1,20,0,3,2,5,-3,14:33
,269,Patrik Blomberg,25,Timrå,F,35,3,2,5,6,1,1,30,21,12,7,20,-13,10:50
,270,Noel Gunler,8,Luleå,F,15,2,3,5,2,1,1,17,2,5,5,1,4,7:37
,271,Matt Carey,15,Rögle,F,20,2,3,5,27,0,0,37,34,4,8,5,3,11:03
,272,Martin Janolhs,61,Malmö,F,21,2,3,5,2,0,1,13,1,2,3,3,0,6:15
,273,Gustav Backström,5,Örebro,D,52,2,3,5,12,1,0,56,17,34,22,26,-4,14:27
,274,Martin Thörnberg,10,HV71,F,10,1,4,5,4,0,0,17,7,3,9,1,8,14:27
,275,Rudolf Cerveny,85,Brynäs,F,11,1,4,5,2,0,0,25,18,3,6,13,-7,18:09
,276,Mattias Nörstebö,18,Frölunda,D,18,1,4,5,10,0,0,15,2,21,9,11,-2,13:16
,277,Lukas Kilström,5,Brynäs,D,29,1,4,5,20,0,0,31,23,44,14,16,-2,17:43
,278,Oscar Drugge,42,Timrå,D,33,1,4,5,8,0,0,27,7,17,9,18,-9,12:02
,279,Viktor Lodin,17,Örebro,F,41,1,4,5,14,0,0,19,26,9,11,10,1,8:52
,280,Alexander Urbom,55,Djurgården,D,44,1,4,5,22,0,0,36,40,36,22,19,3,17:20
,281,Adam Ginning,37,Linköping,D,48,1,4,5,49,0,0,47,47,42,20,27,-7,15:56
,282,Niclas Burström,3,Växjö,D,51,1,4,5,14,0,0,48,11,34,26,24,2,18:17
,283,Viktor Ekbom,8,Frölunda,D,46,0,5,5,32,0,0,39,68,47,30,25,5,15:54
,284,Filip Westerlund,85,/,D,23,3,1,4,6,0,0,19,3,15,5,12,-7,11:15
,285,Sebastian Ohlsson,72,Timrå,F,39,3,1,4,35,0,0,37,18,32,13,34,-21,14:22
,286,Fabian Zetterlund,28,Färjestad,F,16,2,2,4,8,0,0,25,7,6,4,7,-3,10:10
,287,Oliwer Fjellström,46,Frölunda,F,40,2,2,4,4,0,0,25,9,13,7,16,-9,8:42
,288,Daniel Olsson Trkulja,17,Linköping,F,47,2,2,4,2,1,0,45,5,11,11,19,-8,13:22
,289,Éric Gélinas,86,Rögle,D,8,1,3,4,4,0,1,22,4,9,3,7,-4,19:35
,290,Kalle Olsson,85,Örebro,F,35,1,3,4,8,0,0,24,9,22,5,10,-5,10:16
,291,Oskar Svanlund,28,Mora,F,46,1,3,4,4,0,0,39,14,16,9,19,-10,8:58
,292,Daniel Kristo,7,Brynäs,F,10,0,4,4,6,0,0,26,3,4,3,6,-3,15:27
,293,Alexander Johansson,16,Färjestad,F,14,0,4,4,26,0,0,11,13,7,4,4,0,10:53
,294,Johan Persson,10,Timrå,F,17,2,1,3,0,0,0,15,6,2,6,9,-3,11:50
,295,Linus Nässén,22,Frölunda,F,27,2,1,3,0,1,0,9,2,6,7,4,3,6:28
,296,Janne Jalasvaara,46,Timrå,D,38,2,1,3,16,0,0,22,84,24,20,30,-10,16:38
,296,Andreas Söderberg,47,Timrå,D,38,2,1,3,10,0,0,9,8,6,7,15,-8,8:50
,298,Nils Carnbäck,20,/,F,41,2,1,3,16,0,1,28,11,17,5,14,-9,10:53
,299,Carl Mattsson,15,Luleå,F,48,2,1,3,0,0,0,19,21,10,8,10,-2,8:08
,300,Lauri Tukonen,32,Växjö,F,8,1,2,3,0,0,0,7,6,3,3,5,-2,11:23
,301,Adrian Elefalk,36,Brynäs,F,13,1,2,3,0,0,1,6,8,4,3,4,-1,3:33
,301,Matias Lassen,16,Malmö,D,13,1,2,3,0,0,0,12,6,5,9,6,3,16:39
,303,Almen Bibic,3,Linköping,D,22,1,2,3,18,0,0,16,40,15,9,10,-1,11:44
,304,David Printz,55,/,D,41,1,2,3,47,0,0,27,35,22,19,30,-11,17:00
,305,Eric Norin,47,Brynäs,D,13,0,3,3,6,0,0,9,8,9,2,10,-8,12:57
,306,Jonatan Berggren,48,Skellefteå,F,16,0,3,3,4,0,0,7,0,2,3,3,0,10:22
,307,Christoffer Persson,6,HV71,D,24,0,3,3,24,0,0,21,20,23,10,15,-5,15:28
,308,Jonathan Carlsson,36,Mora,D,27,0,3,3,8,0,0,38,14,25,10,13,-3,14:58
,309,Simon Lundmark,45,Linköping,D,28,0,3,3,6,0,0,24,15,7,11,20,-9,13:37
,310,Fredrik Styrman,2,Luleå,D,41,0,3,3,8,0,0,19,9,8,10,7,3,7:20
,311,Erlend Lesund,7,Mora,D,48,0,3,3,43,0,0,38,65,45,19,26,-7,18:05
,311,Rasmus Rissanen,2,Örebro,D,48,0,3,3,53,0,0,47,25,36,17,15,2,14:56
,313,Christoffer Jansson,12,Timrå,F,6,2,0,2,2,0,0,6,1,1,3,3,0,12:05
,314,Lucas Raymond,18,Frölunda,F,10,2,0,2,0,0,0,5,1,1,3,2,1,7:58
,315,Tyson Spink,8,Örebro,F,29,2,0,2,8,0,0,16,5,8,3,10,-7,8:06
,316,Marcus Ersson,10,Brynäs,D,44,2,0,2,10,0,0,39,56,39,6,13,-7,10:54
,317,Jakob Heljemo,20,Växjö,F,7,1,1,2,0,0,0,3,1,1,2,0,2,3:44
,317,Viktor Svedberg,8,Linköping,D,7,1,1,2,6,0,0,8,8,6,4,3,1,14:04
,319,Adam Falk,61,Djurgården,F,10,1,1,2,2,0,0,6,1,0,2,3,-1,7:37
,320,Nikola Pasic,29,Linköping,F,15,1,1,2,0,0,0,4,0,0,2,1,1,2:24
,321,Adam Deutsch,32,Brynäs,D,17,1,1,2,0,0,0,3,8,11,4,5,-1,8:12
,322,Erik Walli-Walterholm,24,Djurgården,F,31,1,1,2,35,0,0,11,22,9,4,2,2,4:49
,323,Kristoffer Gunnarsson,14,/,D,41,1,1,2,22,1,0,14,58,28,10,14,-4,11:57
,324,Niclas Lundgren,8,/,D,44,1,1,2,8,1,0,18,3,41,18,23,-5,13:32
,325,Jacob Peterson,44,Frölunda,F,2,0,2,2,2,0,0,4,0,0,2,0,2,10:35
,326,Emil Bejmo,13,Mora,F,17,0,2,2,4,0,0,10,7,7,2,11,-9,9:25
,327,Karl Johansson,57,Växjö,D,18,0,2,2,4,0,0,3,3,0,4,3,1,4:48
,328,Alexander Bjurström,17,Brynäs,F,22,0,2,2,0,0,0,5,4,2,2,1,1,3:45
,329,Bobbo Petersson,53,Djurgården,D,31,0,2,2,2,0,0,3,1,10,9,7,2,6:58
,330,Oliver Bohm,3,Växjö,D,32,0,2,2,14,0,0,27,15,32,13,13,0,13:32
,331,Andreas Molinder,24,Timrå,F,45,0,2,2,6,0,0,11,7,34,13,31,-18,13:02
,332,Jonas Gustavsson,50,Linköping,Gk,46,0,2,2,0,0,0,0,0,0,66,72,-6,0:00
,333,Johan Mattsson,33,Frölunda,Gk,47,0,2,2,0,0,0,0,0,0,67,46,21,0:00
,334,Adam Reideborn,39,Djurgården,Gk,49,0,2,2,0,0,0,0,0,0,81,56,25,0:00
,335,Justin Pogge,49,Rögle,Gk,52,0,2,2,8,0,0,0,0,0,66,64,2,0:00
,336,Anton Heikkinen,23,HV71,F,7,1,0,1,0,0,0,1,1,2,1,0,1,5:08
,337,Albin Sundsvik,29,Skellefteå,F,12,1,0,1,0,0,0,5,2,4,4,1,3,4:21
,338,Max Wennlund,26,HV71,F,16,1,0,1,4,0,0,5,2,1,4,1,3,4:11
,339,Alexander Karlsson,6,Linköping,D,20,1,0,1,31,1,0,6,1,4,4,7,-3,5:53
,340,Jesper Williamsson,34,Rögle,D,47,1,0,1,16,0,0,34,30,23,8,20,-12,12:24
,341,Nick Olesen,97,Malmö,F,1,0,1,1,2,0,0,1,2,0,1,0,1,2:57
,342,Jesper Emanuelsson,43,Frölunda,F,4,0,1,1,2,0,0,0,0,0,1,1,0,5:40
,343,Linus Cronholm,12,Malmö,D,6,0,1,1,6,0,0,2,12,0,4,0,4,12:29
,344,Gustaf Nielsen,48,Timrå,D,8,0,1,1,2,0,0,5,2,4,2,5,-3,12:15
,345,Wilson Johansson,29,Färjestad,F,9,0,1,1,0,0,0,0,0,1,1,1,0,1:42
,346,Jhonas Enroth,1,Örebro,Gk,10,0,1,1,0,0,0,0,0,0,18,16,2,0:00
,347,Christian Thomas,92,Rögle,F,11,0,1,1,0,0,0,16,8,2,0,5,-5,11:35
,347,Dennis Svensson,28,Djurgården,F,11,0,1,1,4,0,0,8,1,1,2,1,1,10:11
,349,Martin Lundberg,27,Växjö,F,14,0,1,1,6,0,0,20,15,9,0,5,-5,13:18
,350,Adam Edström,34,Mora,F,15,0,1,1,0,0,0,2,14,3,1,3,-2,3:31
,350,Jakob Bondesson,14,Rögle,D,15,0,1,1,0,0,0,8,3,5,7,4,3,10:12
,350,Sebastian Karlsson,12,Linköping,F,15,0,1,1,6,0,0,10,8,10,3,2,1,11:06
,353,David Lindquist,17,Luleå,F,16,0,1,1,2,0,0,3,0,2,1,4,-3,4:10
,354,Albin Johansson,4,Malmö,D,17,0,1,1,2,0,0,13,7,7,1,7,-6,8:12
,355,Marcus Westfält,20,Brynäs,F,19,0,1,1,2,0,0,5,4,2,6,1,5,5:23
,356,Nichlas Torp,38,Malmö,D,22,0,1,1,12,0,0,13,27,29,5,13,-8,12:34
,356,Kevin Wennström,24,Rögle,F,22,0,1,1,0,0,0,10,5,7,1,5,-4,5:53
,358,Tomas Skogs,23,Mora,D,31,0,1,1,8,0,0,10,8,20,6,12,-6,8:57
,358,Joacim Eriksson,30,Brynäs,Gk,31,0,1,1,0,0,0,0,0,0,33,40,-7,0:00
,360,Christian Engstrand,1,Mora,Gk,33,0,1,1,0,0,0,0,0,0,26,42,-16,0:00
,361,Eero Kilpeläinen,37,Örebro,Gk,38,0,1,1,2,0,0,0,0,0,26,34,-8,0:00
,362,Alen Bibic,5,Rögle,D,44,0,1,1,22,0,0,23,49,30,11,12,-1,10:50
,363,Oscar Alsenfelt,69,Malmö,Gk,47,0,1,1,2,0,0,0,0,0,64,48,16,0:00
,364,Robin Jensen,35,Djurgården,Gk,50,0,1,1,0,0,0,0,0,0,26,24,2,0:00
,365,Adam Werner,35,Färjestad,Gk,51,0,1,1,2,0,0,0,0,0,59,36,23,0:00
,366,Pontus Andreasson,28,Frölunda,F,1,0,0,0,0,0,0,0,0,0,0,0,0,0:46
,366,William Kaijser,99,Malmö,D,1,0,0,0,0,0,0,0,0,0,0,0,0,7:39
,366,Manuel Ågren,62,Djurgården,F,1,0,0,0,0,0,0,0,1,1,0,0,0,2:36
,366,Matt Anderson,29,Rögle,F,1,0,0,0,2,0,0,1,0,1,0,0,0,15:30
,366,Emil Kruse,35,Rögle,Gk,1,0,0,0,0,0,0,0,0,0,0,0,0,0:00
,366,Olle Eriksson Ek,20,Färjestad,Gk,1,0,0,0,0,0,0,0,0,0,0,0,0,0:00
,366,Arvid Ljung,1,Brynäs,Gk,1,0,0,0,0,0,0,0,0,0,0,0,0,0:00
,366,Victor Sandberg,23,Färjestad,F,1,0,0,0,2,0,0,1,0,0,0,2,-2,2:49
,366,Simon Holmström,26,HV71,F,1,0,0,0,0,0,0,0,0,0,0,0,0,7:58
,366,Bálint Horvath,24,Rögle,F,1,0,0,0,0,0,0,1,0,1,0,0,0,4:59
,366,Hugo Alnefelt,60,HV71,Gk,1,0,0,0,0,0,0,0,0,0,0,0,0,0:00
,366,Marek Korencik,17,Luleå,D,1,0,0,0,0,0,0,0,0,0,0,0,0,0:00
,366,Magnus Åkerlund,1,Färjestad,Gk,1,0,0,0,0,0,0,0,0,0,0,0,0,0:00
,366,Rasmus Kahilainen,36,Djurgården,F,1,0,0,0,0,0,0,0,0,0,0,0,0,1:33
,366,Lucas Jidenius,26,Luleå,F,1,0,0,0,2,0,0,0,0,0,0,0,0,3:53
,366,Otto Henell,12,Växjö,F,1,0,0,0,0,0,0,0,0,0,0,0,0,1:12
,366,Jonathan Widén,23,Färjestad,D,1,0,0,0,0,0,0,0,0,0,0,0,0,0:00
,366,Hannes Lindström,55,Skellefteå,D,1,0,0,0,0,0,0,0,0,0,0,1,-1,1:23
,366,Willhelm Wassberg,4,Färjestad,D,1,0,0,0,0,0,0,0,0,0,0,0,0,0:00
,366,Filip Roos,4,Frölunda,D,1,0,0,0,0,0,0,0,0,0,0,0,0,0:45
,366,Dennis Hildeby,1,Timrå,Gk,1,0,0,0,0,0,0,0,0,0,0,0,0,0:00
,366,William Ignberg Nilsson,,Timrå,F,1,0,0,0,0,0,0,0,0,0,0,1,-1,3:27
,366,Rasmus Sirugo,3,Mora,F,1,0,0,0,0,0,0,0,0,0,0,1,-1,2:06
,366,Niklas Sandberg Örnmarker,5,Mora,F,1,0,0,0,0,0,0,0,0,0,0,2,-2,4:18
,390,Oscar Walldén,30,Djurgården,Gk,2,0,0,0,0,0,0,0,0,0,0,0,0,0:00
,390,Andreas Engqvist,21,Djurgården,F,2,0,0,0,0,0,0,5,1,3,0,0,0,15:02
,390,Linus Andersson,19,Skellefteå,F,2,0,0,0,0,0,0,0,0,0,0,0,0,0:00
,390,Isak Ragnevad,35,Rögle,Gk,2,0,0,0,0,0,0,0,0,0,0,0,0,0:00
,390,William Josbrant,1,Luleå,Gk,2,0,0,0,0,0,0,0,0,0,0,0,0,0:00
,390,Leon Lerebäck,21,Frölunda,D,2,0,0,0,0,0,0,0,0,1,0,0,0,3:38
,390,William Dageryd,17,Luleå,D,2,0,0,0,0,0,0,0,0,0,0,0,0,0:00
,390,David Elmgren,1,Malmö,Gk,2,0,0,0,0,0,0,0,0,0,0,0,0,0:00
,390,Tex Williamsson,66,Frölunda,Gk,2,0,0,0,0,0,0,0,0,0,0,0,0,0:00
,390,Isac Johnsson,32,Rögle,Gk,2,0,0,0,0,0,0,1,0,0,0,0,0,0:36
,390,Alex Lind,29,Mora,F,2,0,0,0,0,0,0,0,0,0,0,1,-1,1:26
,390,Nils Thomasson,15,Luleå,F,2,0,0,0,0,0,0,0,0,0,0,0,0,4:38
,390,Ludvig Stenvall,2,Skellefteå,D,2,0,0,0,0,0,0,3,0,0,1,1,0,8:56
,390,Albin Carlson,14,Timrå,D,2,0,0,0,0,0,0,1,1,0,1,2,-1,16:07
,390,Linus Öberg,21,Örebro,F,2,0,0,0,0,0,0,0,1,0,0,1,-1,0:52
,390,Alfred Barklund,57,Örebro,D,2,0,0,0,0,0,0,0,0,0,1,0,1,2:32
,390,Karl Henriksson,21,Frölunda,F,2,0,0,0,0,0,0,0,0,0,0,1,-1,2:28
,407,Linus Marcko,35,Timrå,Gk,3,0,0,0,0,0,0,0,0,0,0,5,-5,0:00
,407,Alexander Holtz,88,Djurgården,F,3,0,0,0,0,0,0,1,0,1,0,0,0,5:32
,407,Isak Mantler,1,Örebro,Gk,3,0,0,0,0,0,0,0,0,0,0,0,0,0:00
,407,Lukas Enqvist,39,Timrå,F,3,0,0,0,0,0,0,1,0,1,0,0,0,5:20
,407,Olof Lindbom,30,Djurgården,Gk,3,0,0,0,0,0,0,0,0,0,0,0,0,0:00
,407,David Madsen,61,Malmö,F,3,0,0,0,0,0,0,1,0,0,0,0,0,1:14
,407,Per Ledin,97,Malmö,F,3,0,0,0,2,0,0,4,1,0,0,1,-1,4:06
,407,Tobias Forsgren,,Brynäs,Gk,3,0,0,0,0,0,0,0,0,0,0,0,0,0:00
,407,Victor Östman,30,HV71,Gk,3,0,0,0,0,0,0,0,0,0,0,0,0,0:00
,407,Filip Sandberg,16,HV71,F,3,0,0,0,2,0,0,4,3,0,1,0,1,16:29
,407,Albert Johansson,33,Färjestad,D,3,0,0,0,0,0,0,0,0,0,0,0,0,0:02
,407,Sebastian Kaijser,21,Timrå,F,3,0,0,0,12,0,0,2,2,0,0,3,-3,9:52
,407,Samuel Eriksson,85,Timrå,F,3,0,0,0,0,0,0,0,2,1,0,0,0,4:38
,407,Calle Clang,31,Rögle,Gk,3,0,0,0,0,0,0,0,0,0,0,0,0,0:00
,407,Jacob Hallberg,4,Malmö,F,3,0,0,0,0,0,0,0,0,0,0,0,0,0:06
,422,Ken Jäger,71,Rögle,F,4,0,0,0,0,0,0,0,0,0,0,0,0,2:22
,422,Jacob Sundberg,28,Timrå,F,4,0,0,0,2,0,0,3,4,6,0,4,-4,8:07
,422,Filip Sjöberg,44,Timrå,F,4,0,0,0,0,0,0,2,2,2,0,3,-3,7:10
,422,Anton Johansson,14,Örebro,F,4,0,0,0,0,0,0,0,0,0,0,1,-1,2:12
,422,Helge Holmstrand,29,HV71,D,4,0,0,0,0,0,0,0,0,0,0,0,0,0:00
,422,Felix Dahlroth,7,Skellefteå,D,4,0,0,0,0,0,0,0,1,0,2,0,2,6:42
,422,Oliver Norgren,30,Mora,Gk,4,0,0,0,0,0,0,0,0,0,0,0,0,0:00
,422,Arvid Costmar,14,Linköping,F,4,0,0,0,0,0,0,0,1,0,0,0,0,0:52
,422,André Fredriksson,23,Färjestad,F,4,0,0,0,0,0,0,1,0,0,0,0,0,2:40
,431,Jakob Ringsby,27,Färjestad,F,5,0,0,0,0,0,0,1,2,2,1,0,1,4:14
,431,Lucas Gustavsson,38,Brynäs,D,5,0,0,0,0,0,0,0,0,0,0,0,0,0:00
,431,Isac Ohlsson,1,Örebro,Gk,5,0,0,0,0,0,0,0,0,0,0,0,0,0:00
,431,Oscar Fröberg,1,Örebro,Gk,5,0,0,0,0,0,0,0,0,0,0,0,0,0:00
,431,Arvid Söderblom,1,Frölunda,Gk,5,0,0,0,0,0,0,0,0,0,0,2,-2,0:00
,431,Linus Hedman,4,Skellefteå,F,5,0,0,0,0,0,0,2,1,0,2,2,0,3:09
,431,Helge Grans,2,Malmö,D,5,0,0,0,0,0,0,3,0,1,1,1,0,6:58
,431,Robin Christoffersson,30,Mora,Gk,5,0,0,0,0,0,0,0,0,0,0,0,0,0:00
,431,Linus Gidbark,37,Malmö,Gk,5,0,0,0,0,0,0,0,0,0,0,0,0,0:00
,431,Karl Påhlsson,19,Rögle,F,5,0,0,0,0,0,0,0,0,0,0,0,0,0:00
,441,Andreas Falk,19,HV71,F,6,0,0,0,0,0,0,3,0,0,0,2,-2,3:47
,441,Jesper Myrenberg,60,Linköping,Gk,6,0,0,0,0,0,0,0,0,0,0,0,0,0:00
,441,William Wiå,28,Djurgården,F,6,0,0,0,0,0,0,5,2,0,0,2,-2,5:11
,441,Herman Johansson,14,Färjestad,D,6,0,0,0,0,0,0,0,0,2,0,0,0,1:06
,441,Filip Hasa,21,Frölunda,D,6,0,0,0,0,0,0,0,1,0,1,0,1,2:58
,441,Joakim Lilliehöök,33,Mora,D,6,0,0,0,0,0,0,1,3,0,0,1,-1,3:09
,441,Jesper Eliasson,1,Växjö,Gk,6,0,0,0,0,0,0,0,0,0,0,0,0,0:00
,441,Lars Volden,31,Malmö,Gk,6,0,0,0,0,0,0,0,0,0,6,1,5,0:00
,441,Gustav Walldén,37,Malmö,Gk,6,0,0,0,0,0,0,0,0,0,0,0,0,0:00
,450,Samuel Johannesson,8,Rögle,D,7,0,0,0,0,0,0,0,0,0,0,1,-1,1:14
,450,Jonatan Lundin-Andersson,16,Frölunda,F,7,0,0,0,0,0,0,2,4,1,1,0,1,4:21
,450,Tobias Björnfot,3,Djurgården,D,7,0,0,0,2,0,0,1,2,3,1,1,0,7:50
,450,Oscar Lawner,4,Färjestad,F,7,0,0,0,0,0,0,1,1,0,0,1,-1,2:19
,450,Ludvig Elvenes,25,Rögle,F,7,0,0,0,0,0,0,4,5,3,0,1,-1,9:20
,450,Lukas Pilö,16,Örebro,D,7,0,0,0,0,0,0,1,0,0,0,0,0,0:33
,456,Henrik Larsson,94,Brynäs,D,8,0,0,0,0,0,0,0,3,1,1,1,0,2:53
,456,William Fransson,29,HV71,D,8,0,0,0,0,0,0,2,1,1,0,0,0,3:10
,456,Eric Forsberg,1,Färjestad,Gk,8,0,0,0,0,0,0,0,0,0,0,0,0,0:00
,456,Isak Garfve,36,Mora,F,8,0,0,0,0,0,0,0,0,0,0,0,0,2:22
,456,Albin Kedbrant,,Brynäs,F,8,0,0,0,0,0,0,2,1,2,0,1,-1,3:02
,461,Daniel Baastrup-Andersen,24,Linköping,D,9,0,0,0,0,0,0,0,0,0,0,0,0,0:50
,461,Charles Eklund,,Mora,F,9,0,0,0,0,0,0,3,0,1,0,0,0,3:34
,461,Adam Wilsby,2,Skellefteå,D,9,0,0,0,2,0,0,0,2,0,1,1,0,3:39
,464,John Westermark,1,Skellefteå,Gk,10,0,0,0,0,0,0,0,0,0,0,0,0,0:00
,465,Ben Youds,55,Rögle,D,12,0,0,0,22,0,0,15,7,6,0,6,-6,14:33
,466,Malte Setkov,3,Malmö,D,13,0,0,0,2,0,0,5,3,1,4,4,0,10:26
,466,William Alftberg,67,Brynäs,D,13,0,0,0,0,0,0,1,0,0,0,0,0,0:04
,468,Albin Grewe,46,Djurgården,F,15,0,0,0,16,0,0,7,23,4,3,1,2,5:45
,468,Victor Edström,24,Luleå,F,15,0,0,0,2,0,0,2,0,0,0,0,0,3:08
,468,Matej Galbavy,10,Mora,F,15,0,0,0,0,0,0,4,1,5,0,4,-4,4:37
,471,Tomi Karhunen,33,Brynäs,Gk,19,0,0,0,0,0,0,0,0,0,13,15,-2,0:00
,471,Anton Schagerberg,26,Mora,D,19,0,0,0,2,0,0,2,0,2,1,2,-1,1:47
,471,Samuel Solem,48,Brynäs,F,19,0,0,0,4,0,0,7,18,4,1,3,-2,4:45
,474,Isak Wallin,35,/  /,Gk,32,0,0,0,0,0,0,0,0,0,13,27,-14,0:00
,475,Janne Juvonen,30,Mora,Gk,34,0,0,0,2,0,0,0,0,0,54,52,2,0:00
,476,Cristopher Nihlstorp,41,Malmö,Gk,35,0,0,0,0,0,0,0,0,0,21,29,-8,0:00
,477,Markus Svensson,35,Färjestad,Gk,40,0,0,0,2,0,0,0,0,0,60,46,14,0:00
,478,Gustaf Lindvall,30,Skellefteå,Gk,42,0,0,0,0,0,0,0,0,0,47,30,17,0:00
,479,Stefan Steen,26,Örebro,Gk,43,0,0,0,0,0,0,0,0,0,45,41,4,0:00
,480,Ville Kolppanen,31,Rögle,Gk,46,0,0,0,25,0,0,0,0,0,29,28,1,0:00
,481,Viktor Fasth,30,Växjö,Gk,48,0,0,0,2,0,0,0,0,0,62,50,12,0:00
,481,Niklas Svedberg,89,Timrå,Gk,48,0,0,0,24,0,0,0,0,0,48,91,-43,0:00
,483,Jonas Gunnarsson,37,HV71,Gk,49,0,0,0,0,0,0,0,0,0,62,54,8,0:00
,484,Joel Lassinantti,34,Luleå,Gk,50,0,0,0,0,0,0,0,0,0,78,58,20,0:00
,484,David Rautio,30,Brynäs,Gk,50,0,0,0,2,0,0,0,0,0,35,46,-11,0:00
,484,Johan Gustafsson,37,Frölunda,Gk,50,0,0,0,0,0,0,0,0,0,44,57,-13,0:00
,484,Viktor Andrén,45,Växjö,Gk,50,0,0,0,0,0,0,0,0,0,33,29,4,0:00
,488,Felix Sandström,25,HV71,Gk,51,0,0,0,0,0,0,0,0,0,44,31,13,0:00
,489,Victor Brattström,1,Timrå,Gk,52,0,0,0,0,0,0,0,0,0,34,43,-9,0:00
,489,Mantas Armalis,50,Skellefteå,Gk,52,0,0,0,2,0,0,0,0,0,52,49,3,0:00
,489,Niklas Rubin,41,Luleå,Gk,52,0,0,0,0,0,0,0,0,0,24,20,4,0:00
,489,Jacob Johansson,30,Linköping,Gk,52,0,0,0,2,0,0,0,0,0,31,33,-2,0:00
,1,Elias Pettersson,40,Växjö,F,44,24,32,56,14,6,9,113,7,18,39,12,27,16:17
,2,Ryan Lasch,81,Frölunda,F,49,15,40,55,18,4,4,108,12,7,31,27,4,18:33
,3,Joakim Lindström,10,Skellefteå,F,46,16,34,50,63,3,3,156,18,3,45,28,17,18:15
,4,Pär Lindholm,17,Skellefteå,F,49,18,29,47,28,5,4,128,28,33,53,35,18,19:12
,5,Johan Ryno,61,Färjestad,F,46,9,37,46,28,0,3,104,20,14,40,27,13,17:41
,6,Dick Axelsson,31,Färjestad,F,48,21,24,45,44,4,6,90,31,23,40,32,8,16:59
,7,Aaron Palushaj,11,Brynäs,F,51,19,26,45,42,5,7,137,4,11,37,40,-3,17:13
,8,Victor Olofsson,11,Frölunda,F,50,27,16,43,8,7,14,161,13,18,29,28,1,16:39
,9,Oscar Möller,45,Skellefteå,F,49,18,24,42,6,5,5,177,30,28,45,30,15,18:15
,10,Andrew Calof,18,Växjö,F,52,24,17,41,14,6,5,162,6,9,41,24,17,15:59
,11,Robert Rosén,87,Växjö,F,49,17,23,40,20,4,9,99,8,20,36,22,14,17:09
,12,Patrik Lundh,79,Djurgården,F,52,15,25,40,12,4,6,106,10,24,38,20,18,19:31
,13,Lawrence Pilut,20,HV71,D,52,8,30,38,22,0,2,90,23,42,43,30,13,21:46
,14,Derek Roy,9,Linköping,F,45,12,23,35,24,2,3,94,4,12,38,21,17,17:47
,15,Michael Lindqvist,34,Färjestad,F,33,20,14,34,22,4,10,72,7,13,28,25,3,14:43
,16,Victor Ejdsell,14,HV71,F,50,20,14,34,32,0,5,116,32,17,36,31,5,14:51
,17,Joakim Nygård,11,Färjestad,F,52,17,17,34,28,2,7,123,23,12,41,32,9,17:36
,18,Joel Kellman,11,Karlskrona,F,51,15,19,34,30,4,1,104,17,40,33,44,-11,17:56
,19,Brendan Shinnimin,24,Växjö,F,45,14,20,34,83,3,5,92,33,9,34,20,14,16:26
,20,Mathis Olimb,46,Linköping,F,50,12,22,34,32,2,4,83,4,12,31,28,3,16:07
,21,Joel Persson,94,Växjö,D,51,6,28,34,8,1,4,94,6,23,34,17,17,17:06
,22,Kevin Clark,11,Brynäs,F,49,17,16,33,46,3,6,140,18,13,29,35,-6,18:33
,23,Niklas Olausson,16,Luleå,F,45,7,26,33,16,3,1,45,1,15,29,21,8,19:36
,24,Emil Larsson,36,Luleå,F,49,23,9,32,20,5,3,96,27,17,30,23,7,16:51
,25,Andy Miele,21,/,F,46,10,22,32,39,2,2,87,16,19,28,35,-7,17:34
,26,Per Åslund,22,Färjestad,F,51,16,15,31,26,4,5,88,16,34,29,29,0,17:43
,27,Martin Johansson,25,Färjestad,F,45,11,20,31,0,4,2,85,37,20,34,21,13,15:30
,28,Ted Brithén,90,Rögle,F,49,10,21,31,8,2,2,88,23,50,31,28,3,18:25
,29,Jonathan Davidsson,71,Djurgården,F,52,10,21,31,12,3,1,97,47,26,33,15,18,14:24
,30,Rhett Rakhshani,49,Malmö,F,37,9,22,31,24,2,5,75,7,10,23,24,-1,16:44
,31,Simon Hjalmarsson,59,Frölunda,F,51,8,23,31,22,1,2,64,19,26,28,27,1,16:00
,32,Bryan Lerg,11,Rögle,F,52,19,11,30,24,3,7,147,24,25,26,39,-13,16:24
,33,Marcus Nilsson,10,Färjestad,F,52,8,22,30,2,2,3,70,3,6,22,25,-3,13:48
,34,David Ullström,29,HV71,F,47,6,24,30,26,2,1,90,25,12,27,16,11,15:00
,35,Jesse Virtanen,71,Färjestad,D,51,6,24,30,30,1,1,88,13,38,44,42,2,22:20
,36,Adam Almquist,5,Frölunda,D,50,6,23,29,34,3,3,106,15,24,33,35,-2,19:34
,37,Ryan Gunderson,13,Brynäs,D,43,4,25,29,6,2,2,84,4,44,32,46,-14,23:43
,38,Sakari Manninen,65,Örebro,F,48,11,17,28,8,3,0,89,12,23,33,29,4,16:22
,39,Fredrik Händemark,63,Malmö,F,52,11,17,28,32,3,5,108,46,31,31,29,2,18:08
,40,Jonathan Pudas,64,Skellefteå,D,52,10,18,28,20,2,3,82,14,50,41,27,14,22:17
,41,Nils Andersson,8,Malmö,D,47,8,20,28,20,3,5,97,16,33,28,33,-5,18:37
,42,Ken Andre Olimb,40,Linköping,F,48,8,20,28,8,3,3,119,6,25,26,30,-4,17:04
,43,Rasmus Asplund,74,Färjestad,F,50,8,20,28,20,1,0,64,21,14,39,35,4,16:49
,44,Craig Schira,6,Rögle,D,52,4,24,28,28,1,2,129,72,83,36,37,-1,23:46
,45,Niclas Bergfors,10,Djurgården,F,52,14,13,27,14,1,2,158,15,8,30,27,3,15:15
,46,Robin Kovacs,96,Luleå,F,44,13,14,27,20,6,6,77,18,14,21,27,-6,17:23
,47,Frederik Storm,9,Malmö,F,43,12,15,27,10,1,4,93,6,17,32,27,5,16:17
,48,Marcus Weinstock,20,Örebro,F,52,11,16,27,10,2,2,97,23,23,21,28,-7,14:45
,49,Konstantin Komarek,67,Karlskrona,F,52,8,19,27,6,1,3,88,10,11,22,44,-22,15:49
,50,Matt Donovan,15,Frölunda,D,52,7,20,27,69,1,4,82,39,63,41,30,11,19:13
,51,Andrew Gordon,13,Linköping,F,47,16,10,26,37,2,6,119,60,30,29,27,2,17:01
,52,Mattias Tedenby,21,HV71,F,51,16,10,26,20,7,4,104,31,8,26,26,0,16:24
,53,Einar Emanuelsson,10,Luleå,F,45,13,13,26,0,4,2,59,4,14,21,17,4,13:51
,54,Johan Harju,24,Luleå,F,48,13,13,26,12,2,5,86,16,18,28,22,6,19:20
,55,Tom Wandell,14,Örebro,F,52,13,13,26,22,3,6,84,19,36,34,32,2,16:36
,56,Juuso Ikonen,61,Brynäs,F,49,12,14,26,6,3,1,81,12,10,29,28,1,14:20
,57,Linus Johansson,59,Djurgården,F,44,9,17,26,36,0,0,53,14,18,32,17,15,14:52
,58,Daniel Zaar,72,Malmö,F,50,9,17,26,6,1,4,90,34,23,22,26,-4,14:54
,59,Linus Fröberg,71,Växjö,F,52,9,17,26,28,1,1,66,6,27,33,22,11,15:33
,60,Kristian Näkyvä,51,Linköping,D,52,2,24,26,32,1,1,113,35,40,32,29,3,19:36
,61,Jacob Blomqvist,44,Brynäs,F,52,12,13,25,16,0,6,129,16,16,25,28,-3,15:51
,62,Carl Grundström,3,Frölunda,F,35,17,7,24,8,6,7,86,31,13,21,13,8,14:22
,63,Patrick Cehlin,71,Luleå,F,36,14,10,24,18,5,6,137,21,25,17,21,-4,20:06
,64,Johan Olofsson,8,Malmö,F,51,13,11,24,16,4,0,90,16,16,16,29,-13,14:06
,65,Carl Persson,95,Karlskrona,F,52,13,11,24,22,3,4,96,19,15,28,27,1,15:12
,66,Ludvig Rensfeldt,29,Rögle,F,52,10,14,24,22,1,4,76,12,24,27,32,-5,15:07
,67,Joachim Rohdin,72,Karlskrona,F,49,9,15,24,41,0,1,99,37,28,20,29,-9,17:27
,68,Jesper Jensen,40,Brynäs,F,43,7,17,24,18,1,1,76,14,27,22,31,-9,18:18
,69,Linus Hultström,33,Djurgården,D,44,5,19,24,16,0,2,112,8,20,26,13,13,16:35
,70,Mattias Guter,44,Karlskrona,F,45,13,10,23,10,2,5,108,21,20,14,38,-24,15:58
,71,Edwin Hedberg,20,Rögle,F,51,11,12,23,16,1,0,98,11,10,27,32,-5,14:21
,72,Adam Pettersson,12,Skellefteå,F,52,10,13,23,28,3,3,87,38,30,28,23,5,16:31
,73,David Kase,97,Mora,F,44,9,14,23,6,4,1,70,13,22,20,36,-16,15:44
,74,Jere Sallinen,76,Örebro,F,50,8,15,23,38,2,1,118,52,28,33,25,8,16:39
,75,Linus Ölund,36,Brynäs,F,51,8,15,23,4,0,1,88,26,39,34,37,-3,16:28
,76,Daniel Sondell,50,Luleå,D,47,4,19,23,24,0,0,73,23,36,30,24,6,20:39
,77,Chad Billins,4,Linköping,D,50,4,19,23,20,1,3,88,12,40,34,39,-5,22:09
,78,Marcus Högström,4,Djurgården,D,50,3,20,23,40,0,1,110,33,37,46,31,15,24:01:00
,79,Nick Sörensen,10,Linköping,F,37,14,8,22,14,5,2,114,44,20,19,21,-2,16:16
,80,René Bourque,19,Djurgården,F,35,13,9,22,34,2,2,111,33,5,24,12,12,18:16
,81,Jakob Lilja,15,Linköping,F,40,12,10,22,10,2,0,70,5,30,30,18,12,16:21
,82,Martin Thörnberg,10,HV71,F,45,11,11,22,22,2,4,112,45,12,25,27,-2,16:30
,83,Daniel Viksten,13,Örebro,F,50,11,11,22,6,2,3,111,24,16,19,30,-11,14:22
,84,Andreas Engqvist,21,Djurgården,F,27,10,12,22,4,3,2,56,10,20,24,8,16,17:57
,85,Lukas Vejdemo,44,Djurgården,F,47,10,12,22,16,3,0,80,17,28,31,24,7,16:35
,86,Janne Pesonen,22,Växjö,F,30,8,14,22,4,2,1,78,8,4,17,7,10,14:23
,87,Bud Holloway,4,Skellefteå,F,39,8,14,22,8,1,2,77,15,18,26,16,10,15:21
,88,Kevin Stenlund,82,HV71,F,43,7,15,22,28,4,1,78,37,12,28,24,4,16:56
,89,Jesper Olofsson,92,Skellefteå,F,52,11,10,21,8,3,3,124,18,14,23,23,0,13:07
,90,Nichlas Hardt,43,Malmö,F,36,9,12,21,14,2,3,48,72,12,24,18,6,13:08
,91,Marcus Davidsson,9,Djurgården,F,39,9,12,21,14,2,1,45,16,11,25,9,16,12:49
,92,Mathias Bromé,86,Mora,F,52,9,12,21,18,3,0,80,12,18,22,34,-12,15:23
,93,Markus Ljungh,16,Djurgården,F,40,7,14,21,12,3,3,61,13,13,20,16,4,18:39
,94,Lars Bryggman,22,Malmö,F,48,7,14,21,20,2,1,73,47,29,31,29,2,16:16
,95,Stefan Elliott,24,HV71,D,34,4,17,21,14,0,4,87,11,16,30,14,16,20:00
,96,Mark Katic,23,Skellefteå,D,51,4,17,21,28,0,2,60,35,34,29,31,-2,18:12
,97,Emil Djuse,57,Skellefteå,D,50,3,18,21,32,0,0,78,88,65,38,29,9,19:28
,98,Jan Mursak,9,Frölunda,F,15,10,10,20,4,1,4,41,11,4,12,7,5,16:12
,99,Calle Ridderwall,81,Djurgården,F,52,10,10,20,12,2,3,101,20,8,26,18,8,13:57
,100,Max Görtz,17,Malmö,F,38,9,11,20,4,1,6,66,16,10,17,18,-1,14:50
,101,Pierre Engvall,88,HV71,F,31,7,13,20,12,0,2,48,13,3,23,11,12,13:38
,102,Rasmus Dahlin,26,Frölunda,D,41,7,13,20,20,0,0,84,30,36,31,27,4,19:02
,103,Jens Olsson,28,Malmö,D,51,7,13,20,37,2,0,78,19,27,33,31,2,19:51
,104,Robin Figren,23,HV71,F,49,5,15,20,14,2,0,93,21,28,24,28,-4,16:01
,105,Joel Lundqvist,20,Frölunda,F,43,4,16,20,49,1,3,45,89,17,21,25,-4,18:17
,106,Andrew Rowe,9,Mora,F,50,9,10,19,37,0,2,71,42,8,25,30,-5,16:06
,107,Juhamatti Aaltonen,71,Rögle,F,35,8,11,19,14,3,3,52,5,11,15,28,-13,15:04
,108,Tuomas Kiiskinen,19,Växjö,F,36,7,12,19,6,3,5,49,8,24,24,14,10,15:11
,109,Jack Connolly,20,Rögle,F,52,5,14,19,6,0,2,66,9,31,21,33,-12,15:08
,110,Ben Youds,55,/,D,40,1,18,19,26,1,0,46,26,22,21,35,-14,17:59
,111,Max Wärn,4,HV71,F,49,10,8,18,16,1,0,74,49,36,29,26,3,14:53
,112,Tyson Spink,8,Örebro,F,52,10,8,18,40,2,0,76,7,24,24,32,-8,14:48
,113,Jacob Nilsson,39,Mora,F,40,8,10,18,14,1,1,68,23,12,18,26,-8,16:17
,114,Tylor Spink,9,Örebro,F,48,8,10,18,30,1,0,48,12,24,22,31,-9,15:25
,115,Mikael Wikstrand,6,Färjestad,D,45,5,13,18,14,2,2,95,11,41,50,32,18,22:48
,116,Robin Johansson,58,Mora,F,52,11,6,17,20,3,0,82,35,34,27,27,0,15:42
,117,John Persson,67,Mora,F,50,10,7,17,16,2,5,88,31,12,19,28,-9,15:24
,118,Anton Bengtsson,28,HV71,F,52,9,8,17,18,1,1,82,58,19,26,21,5,16:40
,119,Lucas Carlsson,23,Brynäs,D,44,7,10,17,28,2,2,69,21,57,24,33,-9,18:24
,120,Liam Reddox,85,Växjö,F,49,7,10,17,10,1,0,91,23,19,22,10,12,14:53
,121,Christoffer Ehn,21,Frölunda,F,50,7,10,17,24,1,0,72,45,35,23,21,2,14:08
,122,Ponthus Westerholm,27,Frölunda,F,52,7,10,17,4,2,2,47,11,26,25,22,3,10:56
,123,Libor Hudacek,79,/,F,38,6,11,17,64,1,2,65,9,4,17,19,-2,14:39
,124,Steven Seigo,6,Mora,D,51,5,12,17,16,1,1,81,21,34,34,47,-13,18:27
,125,Michael Kostka,55,Skellefteå,D,50,4,13,17,38,1,0,93,9,53,30,24,6,17:41
,126,Jacob Lagacé,91,Mora,F,51,4,13,17,20,0,1,63,45,36,28,23,5,14:55
,127,Max Friberg,12,Frölunda,F,52,4,13,17,20,2,0,80,59,44,19,20,-1,14:29
,128,Eric Martinsson,64,Växjö,D,46,3,14,17,34,1,0,81,3,34,38,24,14,21:17
,129,Jonathan Andersson,22,Örebro,D,48,3,14,17,26,0,0,71,11,37,33,31,2,20:20
,130,Brandon Gormley,36,Mora,D,41,2,15,17,30,1,0,82,8,40,27,31,-4,20:00
,131,Matt Bailey,22,Mora,F,52,10,6,16,46,1,5,89,80,23,21,38,-17,16:47
,132,Pontus Netterberg,14,Växjö,F,50,9,7,16,8,0,1,59,29,13,22,15,7,11:50
,133,Sebastian Wännström,22,HV71,F,26,8,8,16,10,1,4,46,6,3,10,12,-2,12:33
,134,Axel Jonsson-Fjällby,91,Djurgården,F,42,7,9,16,12,4,0,48,39,22,25,14,11,13:46
,135,Oscar Sundh,13,HV71,F,50,6,10,16,14,1,0,56,28,27,19,23,-4,15:29
,136,Christoffer Törngren,67,Färjestad,F,51,6,10,16,14,1,0,44,9,13,22,23,-1,10:26
,137,Lucas Elvenes,75,Rögle,F,28,5,11,16,10,1,3,21,8,10,13,14,-1,14:05
,138,Gustav Possler,80,Djurgården,F,41,5,11,16,8,1,1,46,4,14,20,11,9,10:11
,139,Theodor Lennström,34,Färjestad,D,47,5,11,16,24,2,0,55,29,20,33,25,8,14:15
,140,Bill Sweatt,96,HV71,F,30,8,7,15,12,1,3,59,18,5,14,12,2,13:53
,141,Joakim Andersson,18,Örebro,F,39,8,7,15,12,0,2,59,12,7,23,19,4,16:03
,142,Marcus Paulsson,53,Karlskrona,F,42,8,7,15,10,2,3,69,21,8,13,34,-21,15:04
,143,Emil Sylvegård,51,Linköping,F,52,8,7,15,65,2,2,70,111,22,18,19,-1,12:48
,144,Linus Persson,25,Färjestad,F,43,7,8,15,20,1,0,48,24,28,24,23,1,14:25
,145,Isac Lundeström,37,Luleå,F,42,6,9,15,14,2,3,42,7,15,21,14,7,16:04
,146,Sebastian Erixon,50,Färjestad,D,44,5,10,15,18,0,0,45,14,44,35,27,8,18:42
,147,Anton Hedman,8,/,F,46,5,10,15,54,0,1,61,71,11,16,17,-1,10:53
,148,Erik Brännström,26,HV71,D,44,2,13,15,22,0,0,71,4,45,24,27,-3,17:24
,148,Victor Bartley,78,Örebro,D,44,2,13,15,32,0,1,92,34,42,30,44,-14,20:06
,150,Cory Murphy,,Karlskrona,D,51,1,14,15,32,0,1,67,10,74,16,50,-34,18:55
,151,Oscar Engsund,32,Luleå,D,52,0,15,15,20,0,0,46,125,87,25,28,-3,18:37
,152,Tim Söderlund,9,Skellefteå,F,43,9,5,14,6,0,1,39,22,9,16,13,3,11:12
,153,Lias Andersson,23,Frölunda,F,22,7,7,14,20,0,4,46,16,9,17,11,6,14:39
,154,Olle Liss,44,Rögle,F,11,6,8,14,6,1,3,26,4,3,13,7,6,16:48
,155,Mats Rosseli Olsen,51,Frölunda,F,46,5,9,14,38,1,0,68,18,29,23,20,3,15:57
,156,Sebastian Stålberg,17,Frölunda,F,50,5,9,14,16,0,0,69,25,38,20,21,-1,13:46
,157,Daniel Rahimi,48,Växjö,D,43,4,10,14,75,2,0,52,79,31,40,17,23,18:21
,158,Stefan Warg,6,Malmö,D,52,3,11,14,22,1,0,46,47,43,30,33,-3,16:45
,158,Niklas Persson,23,Linköping,F,52,3,11,14,32,1,1,47,30,53,19,26,-7,14:12
,160,Oliver Bohm,3,Växjö,D,50,2,12,14,22,1,0,31,38,36,35,26,9,16:23
,161,Elias Fälth,33,Brynäs,D,40,1,13,14,30,0,0,66,31,24,27,19,8,15:57
,162,Robin Alvarez,27,Malmö,F,34,9,4,13,20,0,2,82,16,9,17,21,-4,16:00
,163,Henrik Hetta,20,Skellefteå,F,50,9,4,13,14,1,4,60,82,33,13,21,-8,13:16
,164,Joel Mustonen,40,Frölunda,F,34,8,5,13,14,0,0,50,3,8,15,10,5,11:51
,165,Johan Alcén,14,Brynäs,F,51,8,5,13,38,1,0,45,65,27,22,17,5,13:05
,166,Jonathan Granström,31,Brynäs,F,43,7,6,13,79,2,2,38,23,20,17,27,-10,15:00
,167,Henrik Eriksson,17,Djurgården,F,52,7,6,13,8,1,1,73,78,21,22,15,7,12:20
,168,Emil Bejmo,13,Mora,F,52,6,7,13,14,1,0,65,47,25,15,27,-12,13:44
,169,Jesper Pettersson,37,Djurgården,D,52,4,9,13,30,1,0,67,42,22,41,21,20,17:53
,170,Jesper Boqvist,90,Brynäs,F,23,3,10,13,2,1,0,43,4,12,13,14,-1,15:25
,171,Petter Emanuelsson,11,Luleå,F,43,3,10,13,0,0,1,82,4,15,11,16,-5,14:37
,172,Filip Berglund,6,Skellefteå,D,44,3,10,13,32,0,0,56,32,49,35,23,12,17:03
,173,Andreas Wingerli,24,Skellefteå,F,52,3,10,13,18,0,0,47,37,25,17,11,6,12:16
,174,Tony Mårtensson,9,Linköping,F,48,2,11,13,14,0,0,72,7,21,20,26,-6,15:19
,175,Bobbo Petersson,53,Karlskrona,D,49,2,11,13,20,0,1,44,6,51,24,42,-18,17:43
,176,John Nyberg,8,Frölunda,D,52,2,11,13,40,0,0,50,24,65,32,32,0,18:37
,177,Mattias Karlsson,20,Karlskrona,D,45,1,12,13,22,0,1,49,28,57,14,40,-26,20:57
,178,William Lagesson,3,Djurgården,D,49,1,12,13,30,1,0,55,12,73,31,18,13,19:27
,179,Taylor Matson,17,Rögle,F,40,8,4,12,12,1,1,46,23,18,13,25,-12,14:32
,180,Daniel Olsson Trkulja,17,Linköping,F,46,8,4,12,6,3,1,61,6,15,23,15,8,12:52
,181,Martin Lundberg,27,Växjö,F,45,6,6,12,18,2,1,72,41,33,18,18,0,15:55
,181,David Gustafsson,27,HV71,F,45,6,6,12,8,1,0,33,9,11,18,13,5,11:12
,183,Emil Lundberg,79,Karlskrona,F,49,6,6,12,4,1,1,78,17,14,10,30,-20,14:04
,183,Daniel Widing,41,Rögle,F,49,6,6,12,22,1,2,72,12,21,13,24,-11,13:19
,185,Jonathan Sigalet,56,Frölunda,D,51,5,7,12,16,0,0,49,59,77,34,33,1,18:58
,186,Dylan Reese,42,HV71,D,36,4,8,12,22,1,0,69,8,21,21,26,-5,19:41
,187,Christopher Mastomäki,33,Örebro,F,46,4,8,12,24,0,0,68,9,24,15,14,1,13:05
,188,Tobias Ekberg,50,Malmö,D,25,3,9,12,10,1,0,29,9,13,15,15,0,15:28
,189,Andreas Falk,19,Luleå,F,52,2,10,12,28,0,0,37,18,19,18,27,-9,14:06
,190,Brendan Mikkelson,27,Luleå,D,50,0,12,12,24,0,0,94,18,59,23,27,-4,19:55
,191,Jimmy Andersson,84,Linköping,F,48,8,3,11,12,0,0,55,28,20,16,20,-4,12:07
,192,Adam Brodecki,68,Växjö,F,50,8,3,11,16,3,1,112,18,31,19,15,4,12:11
,193,Erik Forssell,20,Malmö,F,22,6,5,11,6,1,0,37,2,9,20,12,8,14:50
,194,Jonas Röndbjerg,17,Växjö,F,35,6,5,11,4,1,0,37,6,10,17,9,8,8:34
,195,Emil Larsson,,Karlskrona,F,49,6,5,11,14,0,2,61,18,39,14,45,-31,15:47
,196,Alexander Johansson,16,Färjestad,F,28,5,6,11,18,0,1,53,29,18,12,14,-2,15:32
,197,Karl Fabricius,52,Luleå,F,52,5,6,11,6,0,0,67,9,30,17,16,1,11:53
,198,Patrick Mullen,77,Linköping,D,34,4,7,11,14,0,1,51,11,24,12,23,-11,15:47
,199,Sebastian Karlsson,12,Linköping,F,48,4,7,11,20,0,0,54,34,42,17,19,-2,14:49
,200,Marc Zanetti,51,/,D,45,3,8,11,20,2,0,37,36,48,25,31,-6,15:22
,201,Anton Mylläri,59,Malmö,D,52,3,8,11,32,0,0,53,22,45,27,27,0,16:03
,202,Ryan Johnston,89,Luleå,D,36,2,9,11,26,0,2,32,18,31,19,20,-1,19:42
,203,Arvid Lundberg,52,Växjö,D,46,1,10,11,24,0,0,66,16,30,34,16,18,18:12
,204,Eddie Larsson,53,Linköping,D,50,1,10,11,30,0,1,43,48,39,36,23,13,20:22
,205,David Bernhardt,49,Djurgården,D,51,1,10,11,6,0,0,48,6,13,28,16,12,12:47
,206,Tuukka Mäntylä,4,Malmö,D,50,0,11,11,32,0,0,38,54,39,32,22,10,15:18
,207,Sebastian Ohlsson,72,Skellefteå,F,51,7,3,10,28,3,0,62,43,16,17,13,4,12:12
,208,Johan Forsberg,9,Luleå,F,52,6,4,10,8,1,1,41,16,18,13,12,1,11:37
,209,Drew Miller,27,Brynäs,F,29,5,5,10,6,0,1,45,20,14,17,16,1,16:44
,210,Erik Josefsson,60,Växjö,F,37,5,5,10,10,1,0,41,9,15,16,12,4,15:41
,211,Daniel Mannberg,79,Brynäs,F,43,5,5,10,12,1,0,52,19,27,16,21,-5,12:48
,212,Jason Akeson,36,Mora,F,24,4,6,10,8,0,0,46,5,7,9,18,-9,16:27
,213,Axel Wemmenborn,15,Malmö,F,39,4,6,10,8,0,0,51,16,9,14,11,3,14:21
,214,Niklas Fogström,36,Färjestad,F,43,4,6,10,6,0,0,21,3,21,13,13,0,9:55
,215,Pontus Själin,39,Luleå,D,46,4,6,10,4,0,0,44,10,47,21,22,-1,16:45
,216,Viktor Ekbom,8,Örebro,D,48,4,6,10,53,2,1,57,16,103,26,32,-6,16:27
,216,Morgan Ellis,4,/,D,48,4,6,10,44,0,1,57,20,34,30,24,6,16:38
,218,Gustav Backström,5,Örebro,D,47,3,7,10,10,0,0,55,24,47,28,27,1,16:34
,219,Niclas Lundgren,8,Linköping,D,52,3,7,10,4,0,0,33,6,33,38,29,9,17:57
,220,Jens Westin,3,Färjestad,D,52,2,8,10,8,1,0,57,19,45,37,29,8,17:02
,221,Tomas Skogs,23,Mora,D,45,1,9,10,20,0,0,30,40,56,18,22,-4,18:47
,222,David Printz,55,Karlskrona,D,52,0,10,10,46,0,0,32,44,51,29,47,-18,18:58
,223,Kevin Gagné,12,Rögle,D,36,6,3,9,8,1,0,29,5,38,31,34,-3,20:09
,224,Noah Welch,5,Växjö,D,26,4,5,9,63,1,0,42,27,46,17,15,2,20:40
,225,Sebastian Collberg,49,Rögle,F,35,4,5,9,14,0,3,52,17,12,13,12,1,13:50
,226,Sebastian Hartmann,94,Mora,F,45,4,5,9,16,0,1,36,34,14,14,12,2,10:34
,227,Ilari Melart,11,Färjestad,D,46,4,5,9,94,0,0,67,88,63,28,33,-5,18:16
,228,Christoffer Forsberg,23,Malmö,F,52,4,5,9,12,0,0,48,21,16,18,27,-9,13:00
,229,Daniel Gunnarsson,16,Karlskrona,D,51,3,6,9,16,0,2,73,20,87,15,40,-25,18:55
,230,Henrik Nilsson,27,Karlskrona,D,45,2,7,9,28,0,0,36,15,61,24,37,-13,17:19
,231,Lukas Kilström,5,Brynäs,D,50,2,7,9,53,0,0,60,44,82,35,32,3,18:56
,232,Daine Todd,57,Örebro,D,40,1,8,9,14,0,1,28,13,46,18,19,-1,16:32
,233,Joonas Jalvanti,19,Luleå,D,44,1,8,9,16,0,0,47,2,25,29,21,8,18:43
,234,Henrik Törnqvist,11,/,F,51,6,2,8,8,1,2,67,27,25,12,14,-2,11:51
,235,Daniel Grillfors,32,Mora,D,37,4,4,8,10,0,0,22,20,54,13,25,-12,18:56
,236,Matt Anderson,29,Skellefteå,F,23,3,5,8,18,1,1,31,5,12,12,13,-1,15:32
,237,Simon Bertilsson,15,Brynäs,D,39,3,5,8,12,0,0,57,61,93,25,26,-1,19:35
,238,Topi Jaakola,18,HV71,D,39,2,6,8,16,0,0,50,22,33,24,17,7,17:49
,239,Simon Ryfors,15,Rögle,F,49,2,6,8,10,1,0,35,10,20,17,23,-6,11:45
,240,Alexander Falk,41,Djurgården,D,50,2,6,8,12,0,0,35,26,22,30,24,6,14:38
,241,Olle Lycksell,31,Linköping,F,26,5,2,7,2,0,0,32,5,11,10,6,4,8:41
,242,Kalle Olsson,85,Örebro,F,39,4,3,7,10,0,0,39,11,21,15,16,-1,12:01
,243,Kim Rosdahl,96,Malmö,F,45,4,3,7,28,0,0,32,48,27,12,6,6,10:17
,244,Mikael Ahlén,13,Djurgården,F,50,4,3,7,45,1,1,39,42,15,12,10,2,7:51
,245,Fabian Zetterlund,28,Färjestad,F,35,3,4,7,6,0,0,32,20,5,13,15,-2,8:51
,246,Matias Lassen,16,/,D,42,3,4,7,12,0,0,37,15,13,17,12,5,12:19
,246,Almen Bibic,3,/,D,42,3,4,7,34,0,0,32,99,33,23,24,-1,12:59
,246,Linus Sandin,20,Rögle,F,42,3,4,7,4,0,2,54,17,30,9,21,-12,13:24
,249,Alexander Younan,10,Rögle,D,46,3,4,7,10,0,0,36,5,42,21,24,-3,14:50
,250,Christopher Liljewall,52,Brynäs,F,49,3,4,7,16,2,1,30,14,14,10,21,-11,8:14
,251,Morten Madsen,29,Karlskrona,F,50,3,4,7,16,1,0,57,25,29,17,31,-14,15:20
,252,Marcus Fagerudd,29,/,D,51,2,5,7,22,0,0,78,52,55,23,30,-7,17:48
,253,Alen Bibic,5,Rögle,D,52,2,5,7,59,0,0,47,64,55,25,28,-3,16:28
,254,Glenn Gustafsson,37,Örebro,F,36,5,1,6,10,0,1,32,35,19,8,17,-9,9:54
,255,Oskar Steen,29,Färjestad,F,45,4,2,6,16,0,0,63,26,6,17,17,0,11:40
,256,Jesper Williamsson,34,Rögle,D,22,3,3,6,18,1,1,22,14,24,10,24,-14,17:28
,256,Carl-Johan Lerby,14,Malmö,D,22,3,3,6,10,0,1,25,5,11,9,16,-7,14:28
,258,Johan Wiklander,56,Örebro,F,31,3,3,6,12,0,0,24,19,10,8,12,-4,12:19
,259,Emil Aronsson,18,Mora,F,52,3,3,6,0,0,0,40,20,20,13,22,-9,12:24
,260,Stephen Perfetto,14,Rögle,F,25,2,4,6,6,0,0,19,15,1,11,19,-8,14:28
,261,Samuel Asklöf,12,Brynäs,F,34,2,4,6,6,0,0,23,8,11,7,13,-6,6:51
,262,Linus Högberg,6,Växjö,D,42,2,4,6,6,0,0,32,4,19,22,13,9,14:36
,263,Mattias Nörstebö,18,Frölunda,D,20,1,5,6,6,0,0,14,7,12,12,9,3,14:52
,264,Joseph Jonsson,39,Karlskrona,F,48,1,5,6,4,0,0,35,31,17,7,13,-6,7:59
,265,Alexander Hellström,7,Örebro,D,46,0,6,6,59,0,0,34,68,46,21,24,-3,14:31
,266,Keaton Ellerby,77,Mora,D,52,0,6,6,26,0,0,60,25,90,21,32,-11,19:13
,267,Daniel Sylwander,23,Rögle,F,49,4,1,5,22,0,0,66,39,18,12,20,-8,9:28
,268,Filip Cruseman,48,Karlskrona,F,50,4,1,5,8,0,0,35,19,9,8,23,-15,10:16
,269,Pathrik Westerholm,7,Frölunda,F,13,3,2,5,16,1,0,22,5,2,5,8,-3,11:57
,270,Marcus Sylvegård,18,Malmö,F,25,3,2,5,0,1,0,13,23,7,7,4,3,7:44
,271,Mathias From,20,Rögle,F,21,2,3,5,6,0,0,23,5,8,8,13,-5,11:09
,272,Jonas Berglund,14,Luleå,F,25,2,3,5,2,0,0,28,3,7,12,11,1,13:55
,273,Nils Lundkvist,27,Luleå,D,28,2,3,5,0,0,0,21,12,14,14,12,2,16:00
,274,Pontus Petterström,18,Skellefteå,F,33,2,3,5,37,0,0,33,21,31,8,11,-3,12:44
,275,Fredrik Karlström,81,Linköping,F,35,2,3,5,6,0,0,18,6,8,9,11,-2,8:07
,276,Daniel Paille,16,Brynäs,F,14,1,4,5,12,0,0,19,6,3,6,8,-2,16:43
,277,Jimmie Ericsson,21,Skellefteå,F,17,1,4,5,14,1,1,27,10,6,7,6,1,14:49
,278,Viktor Amnér,4,/,D,22,1,4,5,6,0,0,26,3,13,11,12,-1,12:18
,279,Gustaf Franzén,13,Örebro,F,40,1,4,5,4,0,0,22,6,13,7,18,-11,8:50
,280,Peter Andersson,44,Växjö,D,40,0,5,5,14,0,0,34,21,19,19,12,7,11:40
,281,Linus Lindström,16,Skellefteå,F,41,3,1,4,14,0,1,41,15,22,10,14,-4,12:04
,282,Gustav Rydahl,15,/,F,49,3,1,4,41,1,0,35,38,17,11,13,-2,8:38
,283,Joey Hishon,26,Luleå,F,22,2,2,4,20,0,2,26,8,14,3,9,-6,12:56
,284,Jörgen Sundqvist,22,Brynäs,D,37,2,2,4,53,0,0,20,33,40,20,21,-1,14:37
,285,Anton Karlsson,47,Linköping,D,48,2,2,4,36,0,0,52,53,29,24,22,2,15:57
,286,Pontus Widerström,67,Frölunda,F,50,2,2,4,43,1,0,44,68,38,14,20,-6,9:25
,287,Jeremy Williams,19,Örebro,F,8,1,3,4,0,0,0,19,2,4,7,5,2,15:46
,288,Tom Nilsson,43,Djurgården,D,18,1,3,4,8,0,0,12,26,12,15,8,7,16:00
,289,Cade Fairchild,28,Rögle,D,20,1,3,4,16,0,0,19,2,20,9,22,-13,17:43
,290,Johan Alm,,Skellefteå,D,28,1,3,4,12,0,0,14,23,22,14,5,9,15:17
,290,Michael Haga,85,/,F,28,1,3,4,10,0,1,33,14,7,3,11,-8,13:13
,290,Jesper Emanuelsson,43,Frölunda,F,28,1,3,4,2,0,0,9,3,4,7,10,-3,6:46
,293,Marcus Westfält,20,Brynäs,F,31,1,3,4,6,0,0,15,7,10,9,14,-5,7:17
,294,Lukas Haudum,21,Malmö,F,24,0,4,4,4,0,0,23,18,9,5,3,2,10:26
,295,Niklas Arell,42,Malmö,D,32,0,4,4,14,0,0,21,18,26,21,16,5,17:25
,296,Christoffer Persson,6,HV71,D,39,0,4,4,30,0,0,27,27,45,22,19,3,17:51
,297,Justin Pogge,49,Rögle,Gk,47,0,4,4,8,0,0,0,0,0,60,76,-16,0:00
,298,Ludvig Elvenes,25,Rögle,F,5,2,1,3,0,1,0,7,0,1,3,3,0,12:14
,299,Nick Ebert,74,Örebro,D,7,2,1,3,8,0,0,20,2,4,7,5,2,18:47
,300,Samuel Jonsson,22,Rögle,D,35,2,1,3,4,0,0,27,1,7,13,14,-1,11:59
,301,Sean Bergenheim,10,Frölunda,F,4,1,2,3,4,0,0,5,2,4,3,2,1,12:47
,302,Filip Karlsson,26,Rögle,F,12,1,2,3,4,0,1,12,0,2,2,8,-6,13:26
,303,Anton Öhman,36,Skellefteå,D,18,1,2,3,2,0,0,7,4,5,7,5,2,7:45
,304,Alexander Hilmerson,11,Mora,F,45,1,2,3,14,0,1,45,14,11,5,22,-17,9:16
,305,Mike Weber,57,Frölunda,D,10,0,3,3,12,0,0,16,7,10,8,0,8,16:15
,306,Mikael Johansson,85,Brynäs,F,13,0,3,3,0,0,0,17,0,7,3,12,-9,18:00
,307,Kristoffer Söder,19,Karlskrona,F,48,0,3,3,29,0,0,34,21,11,8,22,-14,11:32
,308,Filip Lennström,56,Malmö,F,9,2,0,2,0,0,0,6,4,2,2,1,1,6:12
,309,Erik Walli-Walterholm,24,Djurgården,F,20,2,0,2,0,0,0,7,3,0,2,0,2,3:40
,310,Isac Brännström,17,HV71,F,30,2,0,2,2,1,1,20,8,3,5,5,0,6:37
,311,Dennis Rasmussen,70,Växjö,F,7,1,1,2,4,0,0,12,3,3,8,1,7,17:18
,312,Ludvig Nilsson,41,Brynäs,F,8,1,1,2,6,0,0,8,5,7,2,2,0,13:14
,313,Anton Grundel,73,Färjestad,D,10,1,1,2,35,0,0,10,8,5,2,4,-2,14:03
,314,Dominik Bokk,78,Växjö,F,15,1,1,2,0,1,0,17,1,3,2,1,1,9:48
,315,Jan Sandström,7,Luleå,D,18,1,1,2,2,0,0,10,7,16,5,3,2,8:20
,316,Alexander Deilert,54,Karlskrona,D,20,1,1,2,6,0,0,23,6,14,4,5,-1,14:08
,317,Alexander Bjurström,17,Brynäs,F,23,1,1,2,0,0,0,10,1,6,4,10,-6,6:55
,318,Adam Ginning,37,Linköping,D,28,1,1,2,10,0,0,15,12,12,9,16,-7,11:33
,319,Simon Krekula,74,Skellefteå,F,35,1,1,2,14,0,0,21,6,8,6,10,-4,8:05
,320,Alexander Urbom,55,Djurgården,D,38,1,1,2,24,0,0,29,40,25,16,12,4,15:35
,320,Marcus Ersson,10,Brynäs,D,38,1,1,2,18,0,0,33,39,40,15,17,-2,13:15
,322,Erlend Lesund,7,Mora,D,40,1,1,2,30,1,0,11,24,17,10,10,0,8:08
,323,Alexander Ytterell,66,HV71,D,11,0,2,2,2,0,0,12,5,2,5,7,-2,13:47
,324,Johan Ivarsson,7,Färjestad,D,12,0,2,2,8,0,0,10,15,8,8,5,3,11:38
,325,Filip Westerlund,85,Frölunda,D,19,0,2,2,0,0,0,13,3,9,3,7,-4,10:09
,326,Tom Hedberg,16,HV71,D,28,0,2,2,2,0,0,12,4,10,11,12,-1,9:31
,327,Viktor Grahn,6,Luleå,D,37,0,2,2,4,0,0,15,5,12,8,9,-1,7:18
,328,Victor Aronsson,7,Karlskrona,D,39,0,2,2,4,0,0,9,5,11,9,12,-3,6:36
,329,Linus Arnesson,28,Örebro,D,43,0,2,2,14,0,0,55,5,32,23,25,-2,18:37
,330,Henrik Larsson,94,Brynäs,D,46,0,2,2,14,0,0,32,23,30,16,31,-15,13:01
,331,Andrew Kozek,10,Mora,F,4,1,0,1,2,0,0,5,4,2,1,0,1,9:20
,332,Ari Gröndahl,81,Örebro,D,7,1,0,1,4,0,0,11,4,7,4,3,1,19:18
,333,Daniel Brodin,34,Djurgården,F,8,1,0,1,0,0,0,8,8,4,2,1,1,8:59
,333,Melvin Karlsson,32,Rögle,F,8,1,0,1,0,0,0,3,3,1,1,0,1,3:34
,333,Simon Johansson,18,Djurgården,D,8,1,0,1,0,0,0,7,2,2,1,2,-1,5:21
,336,David Madsen,61,Växjö,F,10,1,0,1,2,0,0,2,4,1,1,1,0,4:25
,337,Erik Andersson,2,Malmö,D,11,1,0,1,2,1,0,6,1,10,5,5,0,13:29
,338,Janne Jalasvaara,46,Rögle,D,25,1,0,1,12,0,0,20,57,12,12,14,-2,17:05
,339,Erik Andersson,38,HV71,F,47,1,0,1,12,0,0,33,18,20,8,11,-3,9:00
,340,Hugo Enock,23,Färjestad,D,2,0,1,1,0,0,0,2,2,0,1,0,1,10:43
,341,Oliver Olsson,3,Malmö,F,4,0,1,1,0,0,0,0,2,1,1,0,1,2:18
,342,Rasmus Sandin,22,Rögle,D,5,0,1,1,0,0,0,2,0,3,2,4,-2,10:08
,343,Louie Caporusso,9,Brynäs,F,7,0,1,1,0,0,0,6,2,2,0,5,-5,9:15
,344,Mark Zengerle,11,Linköping,F,9,0,1,1,2,0,0,8,0,1,1,3,-2,11:03
,345,Ludwig Blomstrand,80,Karlskrona,F,10,0,1,1,2,0,0,10,9,5,1,7,-6,8:20
,346,Adam Pardy,25,Frölunda,D,11,0,1,1,18,0,0,7,7,12,4,4,0,14:59
,346,Kristofer Berglund,2,HV71,D,11,0,1,1,20,0,0,11,11,9,6,3,3,16:41
,348,Linus Karlsson,16,Karlskrona,F,13,0,1,1,2,0,0,5,0,0,0,3,-3,4:59
,349,Kristian Jakobsson,10,Mora,F,14,0,1,1,0,0,0,6,1,4,1,1,0,5:59
,349,Joakim Lilliehöök,33,Mora,D,14,0,1,1,2,0,0,5,5,11,2,3,-1,8:31
,351,Filip Ahl,93,Örebro,F,15,0,1,1,4,0,0,7,10,0,3,7,-4,6:41
,351,Adam Boqvist,7,Brynäs,D,15,0,1,1,4,0,0,4,5,4,2,9,-7,7:27
,353,Oskar Svanlund,28,Mora,F,16,0,1,1,0,0,0,13,3,1,2,2,0,4:13
,354,Albin Eriksson,23,Skellefteå,F,17,0,1,1,6,0,0,3,4,5,1,2,-1,3:27
,355,Per Ledin,97,/,F,20,0,1,1,10,0,0,9,14,5,2,13,-11,10:56
,356,Adam Åhman,70,HV71,Gk,25,0,1,1,0,0,0,0,0,0,12,5,7,0:00
,357,Rodrigo Abols,18,Örebro,F,26,0,1,1,6,0,0,15,14,15,2,6,-4,7:34
,358,Lucas Nordsäter,7,Färjestad,D,30,0,1,1,2,0,0,10,4,10,10,11,-1,6:10
,359,Nils Carnbäck,20,Växjö,F,39,0,1,1,22,0,0,20,14,9,5,11,-6,8:41
,360,Fredrik Pettersson-Wentzel,53,HV71,Gk,42,0,1,1,0,0,0,0,0,0,50,52,-2,0:00
,361,Oscar Alsenfelt,69,Malmö,Gk,44,0,1,1,4,0,0,0,0,0,75,65,10,0:00
,362,Viktor Fasth,30,Växjö,Gk,47,0,1,1,12,0,0,1,0,0,69,42,27,0:00
,363,Jonas Gustavsson,50,Linköping,Gk,49,0,1,1,6,0,0,0,0,0,71,61,10,0:00
,364,Lars Haugen,30,Färjestad,Gk,50,0,1,1,0,0,0,0,0,0,67,54,13,0:00
,365,Christian Engstrand,1,Mora,Gk,51,0,1,1,2,0,0,0,0,0,64,72,-8,0:00
,366,Gustaf Lindvall,30,Skellefteå,Gk,52,0,1,1,0,0,0,0,0,0,40,29,11,0:00
,366,Johan Gustafsson,37,Frölunda,Gk,52,0,1,1,0,0,0,0,0,0,65,65,0,0:00
,366,Adam Reideborn,39,Djurgården,Gk,52,0,1,1,0,0,0,0,0,0,58,33,25,0:00
,369,Martin Fehervary,5,HV71,D,1,0,0,0,0,0,0,1,3,0,0,1,-1,12:50
,369,Oliver Dackell,35,Rögle,Gk,1,0,0,0,0,0,0,0,0,0,0,0,0,0:00
,369,Simon Holmström,26,HV71,F,1,0,0,0,0,0,0,0,0,0,0,0,0,0:00
,369,Lukas Ljungblom,8,Växjö,D,1,0,0,0,0,0,0,0,0,0,0,0,0,0:40
,369,Joel Vännström,99,Karlskrona,Gk,1,0,0,0,0,0,0,0,0,0,0,0,0,0:00
,369,Kevin Wennström,24,Rögle,F,1,0,0,0,0,0,0,0,0,0,0,0,0,0:00
,369,Robin Jensen,35,Malmö,Gk,1,0,0,0,0,0,0,0,0,0,0,0,0,0:00
,369,Niklas Torgersson,,Karlskrona,D,1,0,0,0,0,0,0,0,0,0,0,0,0,0:00
,369,Oscar Fröberg,1,Karlskrona,Gk,1,0,0,0,0,0,0,0,0,0,0,0,0,0:00
,369,Victor Sandberg,23,Färjestad,F,1,0,0,0,0,0,0,0,0,0,0,0,0,0:00
,369,Isak Wallin,35,Mora,Gk,1,0,0,0,0,0,0,0,0,0,0,0,0,0:00
,369,William Kreü,3,Linköping,D,1,0,0,0,0,0,0,0,0,0,0,0,0,3:20
,369,André Dahlqvist,3,Mora,D,1,0,0,0,0,0,0,0,0,0,0,0,0,0:00
,369,Pontus Andreasson,28,Frölunda,F,1,0,0,0,0,0,0,0,0,0,0,0,0,1:34
,369,Arvid Ljung,1,Örebro,Gk,1,0,0,0,0,0,0,0,0,0,0,0,0,0:00
,369,Arvid Henrikson,16,Örebro,D,1,0,0,0,0,0,0,0,0,0,0,0,0,2:38
,369,Malte Setkov,3,Malmö,D,1,0,0,0,0,0,0,0,0,0,0,0,0,7:26
,369,Sebastian Dyk,3,Malmö,F,1,0,0,0,0,0,0,2,0,0,0,0,0,7:40
,369,Didrik Henbrant,,Karlskrona,F,1,0,0,0,0,0,0,0,0,0,0,0,0,3:58
,369,Tim Henriksson,38,Brynäs,D,1,0,0,0,0,0,0,0,0,0,0,0,0,4:18
,369,Filip Hasa,21,Frölunda,D,1,0,0,0,0,0,0,0,0,0,0,0,0,3:37
,369,Fredrik Strömgren,20,Mora,F,1,0,0,0,0,0,0,0,0,0,0,1,-1,1:34
,369,Christoffer Jona,18,Djurgården,F,1,0,0,0,0,0,0,0,1,0,0,0,0,4:02
,369,Andreas Söderberg,47,Malmö,D,1,0,0,0,0,0,0,3,1,0,0,1,-1,11:14
,369,Ludvig Stenvall,2,Skellefteå,D,1,0,0,0,0,0,0,2,0,0,0,0,0,5:35
,369,Tom Johansson,,Karlskrona,D,1,0,0,0,0,0,0,0,0,0,0,0,0,0:00
,369,William Josbrant,1,Luleå,Gk,1,0,0,0,0,0,0,0,0,0,0,0,0,0:00
,396,Anton Johansson,14,Örebro,F,2,0,0,0,0,0,0,1,0,0,0,0,0,2:02
,396,André Nordstrand,8,Karlskrona,F,2,0,0,0,0,0,0,0,0,0,0,1,-1,0:52
,396,Filip Engarås,8,Skellefteå,F,2,0,0,0,0,0,0,0,2,0,0,0,0,3:20
,396,Jakob Stenqvist,41,Frölunda,D,2,0,0,0,2,0,0,1,0,0,0,0,0,11:30
,396,Ludvig Östman,,Linköping,D,2,0,0,0,0,0,0,0,0,0,0,0,0,0:00
,396,Daniel Baastrup-Andersen,24,Linköping,D,2,0,0,0,0,0,0,0,0,0,0,0,0,0:00
,396,Samuel Fagemo,11,Frölunda,F,2,0,0,0,0,0,0,1,2,1,0,1,-1,6:04
,396,Victor Östman,30,HV71,Gk,2,0,0,0,0,0,0,0,0,0,0,0,0,0:00
,396,Jonatan Bjurö,41,Malmö,Gk,2,0,0,0,0,0,0,0,0,0,0,0,0,0:00
,396,Pontus Holmberg,29,Växjö,F,2,0,0,0,0,0,0,0,1,3,3,1,2,14:50
,396,Jakob Heljemo,20,Frölunda,F,2,0,0,0,0,0,0,0,0,0,0,0,0,1:40
,396,Mikael Hedlund,91,Färjestad,F,2,0,0,0,0,0,0,2,0,0,0,0,0,4:04
,396,Isak Ragnevad,35,Rögle,Gk,2,0,0,0,0,0,0,0,0,0,0,0,0,0:00
,396,Niclas Puikkonen,76,Djurgården,F,2,0,0,0,0,0,0,0,0,0,0,0,0,0:16
,396,Isak Mantler,1,Örebro,Gk,2,0,0,0,0,0,0,0,0,0,0,3,-3,0:00
,411,Edwin Enstrand,38,Skellefteå,F,3,0,0,0,0,0,0,0,2,0,0,0,0,1:35
,411,Nikola Pasic,29,Linköping,F,3,0,0,0,0,0,0,0,0,0,0,1,-1,0:21
,411,Simon Ericsson,39,Malmö,D,3,0,0,0,0,0,0,0,0,0,1,1,0,0:29
,411,Herman Johansson,14,Färjestad,D,3,0,0,0,0,0,0,0,0,0,0,0,0,0:00
,411,Axel Sundberg,9,Växjö,F,3,0,0,0,0,0,0,4,0,1,0,0,0,6:36
,411,Tim Kämpeberg,2,Luleå,F,3,0,0,0,0,0,0,0,0,0,0,0,0,0:34
,411,Arvid Söderblom,1,Frölunda,Gk,3,0,0,0,0,0,0,0,0,0,0,0,0,0:00
,411,Simon Lundmark,45,Linköping,D,3,0,0,0,0,0,0,0,0,0,0,1,-1,0:38
,411,Alexander Karlsson,6,Linköping,D,3,0,0,0,0,0,0,0,0,0,1,0,1,4:55
,411,Joel Svensson,98,Rögle,Gk,3,0,0,0,0,0,0,0,0,0,0,0,0,0:00
,411,Lukas Enqvist,39,Färjestad,F,3,0,0,0,0,0,0,1,0,0,1,1,0,1:27
,411,Jesper Myrenberg,60,Linköping,Gk,3,0,0,0,0,0,0,0,0,0,0,0,0,0:00
,411,Leon Lerebäck,21,Frölunda,D,3,0,0,0,0,0,0,0,1,0,1,0,1,3:56
,424,Gustav Jäderberg,52,Karlskrona,D,4,0,0,0,2,0,0,0,0,0,0,1,-1,2:45
,424,Lucas Gustavsson,38,Brynäs,D,4,0,0,0,0,0,0,0,0,0,1,2,-1,1:22
,424,Kevin Marshall,46,Rögle,D,4,0,0,0,2,0,0,1,6,2,1,2,-1,12:08
,424,Alexander Leandersson,4,Färjestad,D,4,0,0,0,0,0,0,0,0,0,0,0,0,0:07
,424,Max Wennlund,26,HV71,F,4,0,0,0,2,0,0,2,1,1,0,2,-2,6:42
,424,Joakim Stjern Svensson,37,HV71,F,4,0,0,0,0,0,0,0,0,0,0,0,0,0:31
,424,Ludwig Wistén,20,Växjö,F,4,0,0,0,0,0,0,0,0,0,0,0,0,0:11
,424,Sebastian Strandberg,29,Djurgården,F,4,0,0,0,0,0,0,2,0,1,0,1,-1,5:38
,432,Axel Levander,29,Luleå,F,5,0,0,0,0,0,0,1,1,0,0,1,-1,2:25
,432,Olle Eriksson Ek,20,Färjestad,Gk,5,0,0,0,0,0,0,0,0,0,0,0,0,0:00
,432,Samuel Ersson,33,Brynäs,Gk,5,0,0,0,0,0,0,0,0,0,0,2,-2,0:00
,432,Linus Gidbark,37,Malmö,Gk,5,0,0,0,0,0,0,0,0,0,0,0,0,0:00
,436,Johan Adolfsson,15,Färjestad,F,6,0,0,0,4,0,0,4,4,1,0,2,-2,6:44
,436,Akim Aliu,,Karlskrona,D,6,0,0,0,62,0,0,10,1,7,2,9,-7,17:13
,436,Anton Malmborg,69,Malmö,Gk,6,0,0,0,0,0,0,0,0,0,0,0,0,0:00
,436,Gustav Willman Borvik,21,Luleå,F,6,0,0,0,0,0,0,0,2,1,0,0,0,0:52
,436,Kim Johansson,8,Luleå,D,6,0,0,0,0,0,0,0,0,0,0,0,0,0:00
,436,Pontus Eltonius,31,Växjö,Gk,6,0,0,0,0,0,0,0,0,0,0,0,0,0:00
,436,Gabriel Altberg,,Karlskrona,F,6,0,0,0,0,0,0,1,0,0,0,1,-1,1:24
,436,Matej Galbavy,10,Mora,F,6,0,0,0,0,0,0,0,0,0,0,1,-1,2:50
,444,Lukas Pilö,16,Örebro,D,7,0,0,0,4,0,0,6,1,1,4,0,4,9:27
,444,Bálint Horvath,24,Rögle,F,7,0,0,0,0,0,0,1,0,0,0,1,-1,2:26
,444,Fredrik Lindgren,61,Skellefteå,D,7,0,0,0,4,0,0,0,1,1,1,2,-1,9:33
,444,Dennis Svensson,28,Karlskrona,F,7,0,0,0,0,0,0,7,2,2,0,8,-8,12:14
,444,Johan Holmqvist,40,Karlskrona,Gk,7,0,0,0,2,0,0,0,0,0,4,12,-8,0:00
,449,Adam Hirsch,18,Brynäs,F,8,0,0,0,0,0,0,0,0,0,0,1,-1,1:02
,449,William Wiå,28,Djurgården,F,8,0,0,0,0,0,0,3,2,1,0,2,-2,2:00
,449,Arvid Holm,75,Karlskrona,Gk,8,0,0,0,0,0,0,0,0,0,0,0,0,0:00
,449,Jonathan Rodensjö,16,Linköping,F,8,0,0,0,0,0,0,1,1,0,0,0,0,2:11
,449,Oscar Masiello,31,Luleå,Gk,8,0,0,0,0,0,0,0,0,0,5,0,5,0:00
,454,August Nilsson,7,Växjö,D,9,0,0,0,0,0,0,7,10,6,2,2,0,8:59
,454,Linus Andersson,19,Skellefteå,F,9,0,0,0,2,0,0,4,10,3,0,1,-1,4:28
,454,Jacob Peterson,44,Frölunda,F,9,0,0,0,0,0,0,3,0,2,0,1,-1,2:41
,457,Jonatan Berggren,48,Skellefteå,F,10,0,0,0,0,0,0,1,0,4,0,3,-3,7:17
,457,Jacob Cederholm,3,HV71,D,10,0,0,0,2,0,0,2,3,4,1,2,-1,8:34
,457,Marcus Collin,23,Luleå,F,10,0,0,0,0,0,0,1,1,0,0,1,-1,2:02
,457,Edwin Johansson,73,HV71,D,10,0,0,0,2,0,0,2,1,3,1,0,1,3:17
,457,Cristopher Nihlstorp,41,Malmö,Gk,10,0,0,0,0,0,0,0,0,0,1,1,0,0:00
,462,Carl Jakobsson,31,Färjestad,F,11,0,0,0,2,0,0,4,1,3,0,1,-1,4:46
,462,Filip Sveningsson,71,HV71,F,11,0,0,0,0,0,0,1,3,0,0,1,-1,3:14
,464,Oscar Eklind,12,Malmö,F,12,0,0,0,0,0,0,4,3,1,2,0,2,4:06
,465,Anton Björkman,2,Linköping,D,13,0,0,0,2,0,0,3,4,5,4,2,2,6:19
,465,Jakob Bondesson,14,Rögle,D,13,0,0,0,0,0,0,0,1,1,0,0,0,0:43
,465,Fredrik Styrman,2,/,D,13,0,0,0,6,0,0,14,5,17,2,7,-5,14:11
,468,Arvid Aronsson,55,Örebro,D,14,0,0,0,8,0,0,5,5,6,3,6,-3,8:58
,468,Oskar Bäck,27,Färjestad,F,14,0,0,0,0,0,0,2,0,4,0,4,-4,5:45
,470,Oliwer Fjellström,46,Frölunda,F,17,0,0,0,2,0,0,10,4,12,4,5,-1,7:01
,471,Linus Söderström,30,HV71,Gk,18,0,0,0,2,0,0,0,0,0,31,26,5,0:00
,472,Felix Sandström,25,/,Gk,19,0,0,0,0,0,0,0,0,0,20,21,-1,0:00
,473,Johan Södergran,38,Linköping,F,20,0,0,0,0,0,0,2,0,2,0,1,-1,0:55
,474,Ville Kolppanen,31,Rögle,Gk,24,0,0,0,4,0,0,0,0,0,16,21,-5,0:00
,475,Anton Danielsson,5,Skellefteå,D,25,0,0,0,0,0,0,10,11,3,5,5,0,6:04
,476,Emil Kruse,35,Rögle,Gk,27,0,0,0,0,0,0,0,0,0,16,29,-13,0:00
,477,Linus Fernström,39,Brynäs,Gk,39,0,0,0,0,0,0,0,0,0,23,28,-5,0:00
,478,Henrik Lundberg,1,Karlskrona,Gk,43,0,0,0,0,0,0,0,0,0,6,22,-16,0:00
,479,Filip Gustavsson,30,Luleå,Gk,44,0,0,0,0,0,0,0,0,0,30,28,2,0:00
,480,Kristoffer Gunnarsson,14,Frölunda,D,46,0,0,0,24,0,0,17,35,31,14,12,2,9:54
,481,David Rautio,30,Brynäs,Gk,47,0,0,0,2,0,0,0,0,0,66,67,-1,0:00
,481,Jonas Gunnarsson,37,/,Gk,47,0,0,0,0,0,0,0,0,0,34,37,-3,0:00
,483,Johannes Jönsson,38,Karlskrona,Gk,48,0,0,0,0,0,0,0,0,0,56,101,-45,0:00
,484,Stefan Steen,26,Färjestad,Gk,49,0,0,0,0,0,0,1,0,0,61,52,9,0:00
,484,Johan Mattsson,33,Frölunda,Gk,49,0,0,0,0,0,0,0,0,0,42,31,11,0:00
,486,Eero Kilpeläinen,37,Örebro,Gk,50,0,0,0,4,0,0,0,0,0,76,75,1,0:00
,487,Axel Brage,33,Örebro,Gk,51,0,0,0,0,0,0,0,0,0,20,29,-9,0:00
,487,Viktor Andrén,45,Växjö,Gk,51,0,0,0,0,0,0,0,0,0,50,28,22,0:00
,489,Joacim Eriksson,30,Djurgården,Gk,52,0,0,0,2,0,0,0,0,0,59,37,22,0:00
,489,Joni Ortio,31,Skellefteå,Gk,52,0,0,0,0,0,0,0,0,0,69,52,17,0:00
,489,Jacob Johansson,30,Linköping,Gk,52,0,0,0,0,0,0,0,0,0,33,33,0,0:00
,489,Mattias Pettersson,30,Mora,Gk,52,0,0,0,2,0,0,0,0,0,13,31,-18,0:00
,489,Joel Lassinantti,34,Luleå,Gk,52,0,0,0,4,0,0,0,0,0,52,52,0,0:00
,1,Joakim Lindström,10,Skellefteå,F,51,18,36,54,32,3,7,186,26,8,38,39,-1,18:28
,2,Broc Little,41,Linköping,F,52,19,34,53,16,5,7,149,10,26,37,25,12,18:06
,3,Olli Palola,34,Växjö,F,52,21,27,48,18,5,4,140,38,8,42,23,19,16:11
,4,Oskar Lindblom,96,Brynäs,F,52,22,25,47,18,3,6,109,25,24,48,32,16,17:02
,5,Jesper Jensen,40,Brynäs,F,50,9,33,42,14,2,2,93,24,17,42,29,13,17:00
,6,Alexander Bergström,26,Karlskrona,F,52,15,25,40,26,2,1,107,28,32,31,33,-2,17:29
,7,Kevin Clark,11,Brynäs,F,52,23,16,39,22,7,4,161,15,17,37,33,4,16:41
,8,Henrik Tömmernes,7,Frölunda,D,49,8,31,39,16,1,5,115,24,48,30,28,2,22:28
,9,Emil Pettersson,14,/,F,51,15,23,38,12,4,4,135,12,23,33,26,7,16:54
,10,Libor Hudacek,79,Örebro,F,49,14,24,38,38,2,6,88,20,11,37,31,6,16:13
,11,Johan Sundström,28,Frölunda,F,45,12,26,38,16,4,6,148,11,25,29,20,9,16:51
,12,Dennis Everberg,18,Växjö,F,52,18,19,37,53,2,4,97,57,22,39,24,15,17:01
,13,Garrett Roe,11,Linköping,F,49,16,21,37,49,4,7,110,51,20,32,21,11,17:01
,14,Johan Ryno,61,Färjestad,F,47,16,20,36,28,3,6,112,10,18,44,22,22,18:09
,15,Matt Anderson,29,Djurgården,F,50,18,16,34,16,6,4,113,10,29,32,31,1,18:50
,16,Bryan Lerg,11,Rögle,F,52,20,13,33,44,4,10,179,37,39,24,41,-17,18:19
,17,Casey Wellman,9,Frölunda,F,45,14,19,33,2,0,8,115,16,15,21,19,2,16:57
,18,Ilari Filppula,81,Malmö,F,48,13,20,33,43,0,5,68,6,11,23,26,-3,17:02
,19,Andreas Thuresson,12,Malmö,F,51,12,21,33,18,4,5,156,70,7,28,23,5,16:30
,20,Alexander Johansson,16,Färjestad,F,47,15,17,32,58,5,3,107,47,26,38,24,14,17:41
,21,Tuomas Kiiskinen,19,Växjö,F,45,14,18,32,6,4,3,73,7,6,40,17,23,16:45
,22,Fredrik Händemark,63,Malmö,F,47,13,19,32,8,5,5,85,20,16,30,21,9,16:08
,23,Pär Lindholm,17,Skellefteå,F,38,15,16,31,39,3,5,79,40,26,25,24,1,17:02
,24,Mattias Tedenby,21,HV71,F,49,15,16,31,14,6,0,112,18,10,40,18,22,15:44
,25,Ludvig Rensfeldt,29,Rögle,F,48,13,18,31,10,2,3,93,12,45,23,34,-11,17:58
,26,Magnus Nygren,32,Färjestad,D,49,11,20,31,26,2,4,153,44,39,44,33,11,22:46
,27,Ted Brithén,90,HV71,F,49,6,25,31,14,0,3,99,40,28,28,19,9,16:16
,28,Joel Kellman,11,Karlskrona,F,52,15,15,30,20,3,7,91,14,25,34,30,4,17:56
,29,Sebastian Aho,63,Skellefteå,D,50,10,20,30,10,5,2,68,5,32,28,34,-6,19:53
,30,Milan Gulas,44,Färjestad,F,47,8,22,30,30,1,3,127,59,19,29,19,10,17:01
,31,Marcus Weinstock,20,Örebro,F,52,7,23,30,30,1,1,91,14,15,30,35,-5,16:37
,32,Cade Fairchild,28,Rögle,D,50,6,24,30,14,1,3,87,3,72,28,45,-17,21:01
,33,Joakim Nygård,11,Färjestad,F,52,16,13,29,26,3,0,95,36,29,40,25,15,16:38
,34,Simon Önerud,11,HV71,F,37,14,15,29,33,2,2,118,10,12,28,15,13,17:18
,35,Pathrik Westerholm,7,Brynäs,F,47,12,17,29,12,0,2,84,4,19,26,21,5,16:07
,36,Pär Arlbrandt,40,HV71,F,47,11,18,29,4,1,1,95,5,22,29,14,15,14:07
,37,Jack Connolly,20,Rögle,F,52,4,24,28,16,1,2,68,10,23,23,39,-16,18:18
,38,Martin Thörnberg,10,HV71,F,47,17,10,27,14,3,5,128,47,18,22,22,0,16:43
,39,Rhett Rakhshani,49,Malmö,F,41,15,12,27,22,3,7,88,9,9,18,25,-7,14:50
,40,Greg Squires,26,Örebro,F,48,13,14,27,10,2,1,97,10,20,30,39,-9,16:18
,41,Robert Rosén,87,Växjö,F,45,11,16,27,10,4,3,71,10,28,34,20,14,16:08
,42,Victor Olofsson,11,Frölunda,F,51,9,18,27,2,1,6,91,7,10,19,15,4,14:11
,43,Ryan Gunderson,13,Brynäs,D,52,4,23,27,8,2,2,94,8,40,43,42,1,23:18
,44,Mattias Guter,44,Karlskrona,F,45,15,11,26,6,1,4,76,14,10,20,22,-2,15:42
,45,Robin Alvarez,27,Malmö,F,46,11,15,26,14,2,5,100,27,19,19,22,-3,16:16
,46,Joel Lundqvist,20,Frölunda,F,51,9,17,26,24,3,3,67,108,17,20,19,1,17:12
,47,Johan Harju,24,Luleå,F,52,8,18,26,10,2,2,105,10,20,22,31,-9,16:26
,48,Daniel Paille,16,Brynäs,F,45,12,13,25,22,4,2,90,23,15,26,29,-3,16:59
,49,Ponthus Westerholm,27,Brynäs,F,51,9,16,25,28,2,2,85,7,22,27,22,5,14:56
,50,Filip Sandberg,16,HV71,F,52,8,17,25,16,1,2,90,44,24,30,13,17,14:18
,51,Erik Forssell,20,Malmö,F,45,14,10,24,10,1,0,64,4,33,22,20,2,16:01
,52,Patrik Carlsson,72,Frölunda,F,44,11,13,24,8,3,1,57,11,18,29,10,19,14:22
,53,Frederik Storm,9,Malmö,F,45,8,16,24,37,1,3,81,13,11,29,13,16,14:52
,54,Andrew Gordon,13,Linköping,F,50,8,16,24,16,1,4,93,84,26,21,28,-7,16:00
,55,André Benoit,3,Malmö,D,52,6,18,24,22,2,2,67,13,74,26,33,-7,20:27
,56,Ville Leino,23,Växjö,F,44,8,15,23,14,1,2,34,10,11,26,19,7,14:17
,57,Markus Ljungh,16,Djurgården,F,49,8,15,23,14,1,3,103,36,21,20,26,-6,18:20
,58,Kristian Näkyvä,51,Linköping,D,50,8,15,23,38,3,3,104,48,27,31,34,-3,20:30
,59,Nils Andersson,8,Malmö,D,46,7,16,23,18,3,4,84,11,53,25,25,0,18:59
,60,Bill Sweatt,96,Luleå,F,49,15,7,22,43,2,5,119,40,22,20,18,2,17:44
,61,Bud Holloway,4,Skellefteå,F,26,11,11,22,0,2,6,62,15,16,17,16,1,17:31
,62,Ken Andre Olimb,40,Linköping,F,39,9,13,22,4,4,1,78,5,16,24,18,6,16:26
,63,Anton Hedman,8,Luleå,F,48,8,14,22,22,1,0,82,101,12,31,23,8,15:02
,64,Felix Schütz,72,Rögle,F,50,8,14,22,28,0,2,67,12,17,20,39,-19,16:10
,65,Niklas Persson,23,Linköping,F,50,7,15,22,16,1,3,62,34,41,17,29,-12,15:40
,66,Éric Castonguay,27,Leksand,F,52,7,15,22,4,0,2,118,6,42,24,37,-13,18:20
,67,Patrik Lundh,79,Djurgården,F,46,6,16,22,6,1,2,93,42,13,29,31,-2,17:59
,68,Erik Christensen,24,HV71,F,45,15,6,21,16,6,3,107,10,2,30,24,6,15:31
,69,Robin Figren,23,Frölunda,F,48,11,10,21,33,5,0,129,9,23,32,21,11,14:57
,70,Daniel Brodin,34,Djurgården,F,49,11,10,21,34,3,1,108,86,26,28,31,-3,15:23
,71,Jimmie Ericsson,21,Skellefteå,F,42,10,11,21,47,2,4,65,22,15,23,23,0,15:29
,72,Mathis Olimb,46,Linköping,F,40,8,13,21,35,3,3,47,3,13,17,25,-8,16:12
,73,Marcus Nilsson,10,Färjestad,F,52,7,14,21,0,2,1,50,7,8,16,23,-7,12:27
,74,Philip Holm,25,Växjö,D,52,4,17,21,30,1,0,70,18,36,52,28,24,18:49
,75,Petter Emanuelsson,11,Luleå,F,41,15,5,20,8,2,4,101,7,10,23,18,5,14:52
,76,Carl Grundström,3,Frölunda,F,45,14,6,20,6,3,2,95,58,15,28,22,6,13:37
,77,Kevin Stenlund,82,HV71,F,48,13,7,20,16,2,2,75,15,7,24,15,9,13:22
,78,Johan Porsberger,15,Leksand,F,51,13,7,20,12,4,6,115,25,12,13,31,-18,15:36
,79,Jacob Blomqvist,44,Brynäs,F,51,11,9,20,59,2,0,96,7,22,29,18,11,14:36
,80,Martin Johansson,25,Örebro,F,44,10,10,20,2,4,3,64,31,21,19,22,-3,17:02
,81,Emil Larsson,,Karlskrona,F,50,8,12,20,14,3,1,51,32,36,19,22,-3,16:44
,82,Per Åslund,22,Färjestad,F,39,7,13,20,16,4,3,63,23,17,14,6,8,16:49
,83,Linus Hultström,33,Djurgården,D,44,7,13,20,24,1,3,124,15,26,19,25,-6,19:06
,84,Adam Pettersson,12,Skellefteå,F,51,7,13,20,22,2,2,62,21,32,25,26,-1,16:42
,85,Lias Andersson,23,HV71,F,42,9,10,19,18,1,2,72,30,9,29,8,21,13:37
,86,Rasmus Asplund,74,Färjestad,F,39,6,13,19,10,1,0,45,26,14,22,19,3,16:52
,87,Calle Rosén,39,Växjö,D,41,6,13,19,10,0,1,80,19,26,40,21,19,18:44
,88,Jonathan Pudas,64,Brynäs,D,52,6,13,19,32,2,2,64,6,40,38,32,6,16:48
,89,Adam Brodecki,68,Växjö,F,52,5,14,19,12,0,0,58,19,15,27,19,8,12:42
,90,Christopher Liljewall,52,Rögle,F,43,4,15,19,10,0,1,36,15,49,19,26,-7,16:39
,91,Mikael Wikstrand,6,Färjestad,D,48,4,15,19,12,0,2,79,12,25,32,24,8,21:29
,92,Cory Murphy,,Växjö,D,48,3,16,19,28,1,2,80,15,50,30,21,9,18:15
,93,Marcus Paulsson,53,Karlskrona,F,37,11,7,18,10,2,0,69,21,13,25,18,7,15:31
,94,Erik Josefsson,60,Växjö,F,49,10,8,18,12,2,0,54,24,33,32,16,16,14:48
,95,Sebastian Wännström,22,Rögle,F,20,9,9,18,8,1,3,67,5,7,13,18,-5,17:35
,96,Joachim Rohdin,72,Karlskrona,F,52,9,9,18,36,4,3,98,51,27,24,20,4,17:18
,96,Oscar Sundh,13,HV71,F,52,9,9,18,16,1,0,73,38,34,32,17,15,15:03
,98,Pontus Netterberg,14,Växjö,F,48,8,10,18,4,0,0,47,25,11,25,11,14,10:04
,99,Nick Johnson,32,Brynäs,F,39,7,11,18,16,2,1,70,7,9,20,15,5,15:13
,100,Anssi Salmela,14,Linköping,D,32,4,14,18,28,1,3,65,15,15,20,20,0,21:20
,101,Andreas Falk,19,Luleå,F,49,4,14,18,53,1,0,61,19,24,26,16,10,16:25
,102,Adam Almquist,5,HV71,D,52,4,14,18,24,1,0,109,29,24,28,20,8,18:42
,103,Johan Forsberg,9,Luleå,F,52,12,5,17,6,6,1,70,26,13,16,24,-8,13:13
,104,Sebastian Stålberg,17,Frölunda,F,49,8,9,17,6,1,1,80,8,23,23,22,1,13:37
,105,Jonas Holös,6,Färjestad,D,51,8,9,17,8,5,1,87,7,34,40,28,12,21:37
,106,Jonathan Granström,31,Brynäs,F,46,7,10,17,38,1,3,58,41,35,27,34,-7,16:27
,107,Emil Johansson,17,Djurgården,D,49,7,10,17,26,1,1,70,15,33,33,34,-1,22:08
,108,Calle Ridderwall,81,Djurgården,F,52,7,10,17,14,1,1,122,32,16,20,21,-1,16:11
,109,Andrew Calof,18,Skellefteå,F,52,6,11,17,8,1,1,106,4,17,24,17,7,14:45
,110,Christoffer Törngren,67,HV71,F,47,5,12,17,12,1,0,54,11,7,22,6,16,10:08
,111,Janos Hari,16,Leksand,F,51,5,12,17,14,0,0,57,10,13,15,38,-23,15:40
,112,Jimmy Andersson,84,Karlskrona,F,49,4,13,17,30,1,0,58,48,26,22,16,6,14:15
,113,Filip Karlsson,26,Rögle,F,52,4,13,17,8,1,1,59,15,31,22,30,-8,14:46
,114,Ben Youds,55,Leksand,D,44,3,14,17,24,0,2,74,17,52,15,35,-20,21:21
,115,Jakob Lilja,15,Linköping,F,49,11,5,16,31,1,0,76,10,38,18,23,-5,14:50
,116,Jesper Olofsson,92,Skellefteå,F,48,10,6,16,12,5,6,134,19,13,11,23,-12,13:50
,117,Johan Olofsson,8,Leksand,F,50,9,7,16,12,0,0,75,20,15,14,36,-22,14:33
,118,Linus Fröberg,71,Växjö,F,52,9,7,16,8,0,1,70,5,30,30,21,9,15:02
,119,Joel Eriksson Ek,20,Färjestad,F,26,8,8,16,12,0,5,74,42,15,14,10,4,17:46
,120,Joel Mustonen,40,Örebro,F,44,7,9,16,22,3,2,70,9,15,15,21,-6,15:21
,121,Oskar Lang,14,Leksand,F,45,7,9,16,16,1,3,52,4,38,19,20,-1,13:41
,122,Konstantin Komarek,67,Malmö,F,36,6,10,16,2,1,1,50,6,20,14,12,2,14:58
,123,Kalle Olsson,85,Örebro,F,45,6,10,16,8,1,3,61,4,38,11,18,-7,14:49
,124,Petr Zámorský,24,Örebro,D,46,6,10,16,24,0,0,97,9,60,27,49,-22,20:41
,125,Ilari Melart,11,Luleå,D,47,6,10,16,32,2,1,63,73,32,28,32,-4,18:52
,126,Jesper Ollas,17,Leksand,F,51,6,10,16,20,1,0,64,16,24,17,27,-10,17:25
,127,Simon Hjalmarsson,59,Frölunda,F,51,5,11,16,8,2,2,79,19,27,18,20,-2,14:36
,128,Daniel Gunnarsson,16,Karlskrona,D,52,3,13,16,26,0,1,83,29,71,28,30,-2,21:25
,129,Geoff Platt,16,Växjö,F,25,10,5,15,12,2,2,89,11,10,16,16,0,16:42
,130,Linus Johansson,59,Djurgården,F,46,9,6,15,18,0,2,71,23,21,18,17,1,14:46
,131,Linus Ölund,36,Brynäs,F,39,8,7,15,2,0,2,42,11,16,17,8,9,9:56
,132,Mikael Ahlén,13,Djurgården,F,49,8,7,15,20,1,2,66,49,16,14,10,4,12:26
,133,John Nyberg,8,Frölunda,D,49,7,8,15,32,1,0,69,19,39,33,25,8,17:08
,134,Craig Schira,6,Luleå,D,42,6,9,15,43,2,3,102,73,49,24,23,1,20:23
,135,Emil Sylvegård,51,Linköping,F,49,6,9,15,76,1,0,68,95,39,23,18,5,14:00
,136,Nichlas Hardt,43,Malmö,F,45,5,10,15,16,1,2,65,83,31,20,11,9,14:31
,136,Andreas Borgman,,HV71,D,45,5,10,15,26,3,1,101,80,40,42,19,23,18:31
,138,Daine Todd,57,Luleå,D,36,4,11,15,12,0,3,58,8,46,16,25,-9,19:59
,139,Eric Martinsson,64,Växjö,D,41,4,11,15,30,1,1,80,1,38,37,24,13,21:06
,140,Mattias Karlsson,20,Karlskrona,D,49,4,11,15,16,0,3,70,38,86,27,37,-10,23:26
,141,Arvid Lundberg,52,Växjö,D,50,3,12,15,10,0,0,71,16,42,38,27,11,19:25
,142,Jacob Lagacé,91,Luleå,F,49,2,13,15,34,0,0,69,42,20,19,19,0,13:35
,143,Matt Donovan,15,Frölunda,D,50,1,14,15,74,0,1,80,42,57,37,32,5,19:50
,144,Morten Madsen,29,Karlskrona,F,52,1,14,15,12,0,1,53,34,36,21,19,2,16:30
,145,Sebastian Karlsson,12,Linköping,F,48,8,6,14,18,3,2,57,45,39,18,15,3,15:13
,146,Mats Rosseli Olsen,51,Frölunda,F,50,7,7,14,30,1,0,62,19,30,17,24,-7,15:19
,147,Filip Cruseman,48,Karlskrona,F,39,6,8,14,22,1,1,61,18,13,17,16,1,16:02
,148,Nicklas Lasu,31,Frölunda,F,48,6,8,14,28,2,0,55,38,24,22,24,-2,14:02
,149,Sean Bergenheim,10,Frölunda,F,32,5,9,14,39,1,2,77,46,10,22,14,8,13:57
,150,Nicholas Bailen,55,Växjö,D,20,4,10,14,12,2,1,48,11,11,17,10,7,20:52
,151,Kael Mouillierat,40,Luleå,F,47,4,10,14,57,0,0,65,23,30,20,22,-2,15:25
,152,Eddie Larsson,53,Linköping,D,50,2,12,14,24,0,0,45,39,39,35,24,11,20:24
,153,Oscar Möller,45,Skellefteå,F,16,10,3,13,8,3,3,54,9,10,13,16,-3,17:02
,154,Daniel Viksten,13,Örebro,F,31,7,6,13,4,1,1,73,9,12,10,13,-3,17:34
,155,Liam Reddox,85,Växjö,F,41,7,6,13,6,3,0,71,22,16,22,11,11,14:19
,156,Henrik Törnqvist,11,Linköping,F,50,7,6,13,33,1,1,79,20,29,15,13,2,11:59
,157,Sebastian Collberg,49,Rögle,F,45,6,7,13,10,2,0,63,24,16,15,18,-3,12:32
,158,Niklas Fogström,36,Linköping,F,52,6,7,13,22,1,2,62,29,34,24,23,1,15:57
,158,John Persson,67,Färjestad,F,52,6,7,13,28,2,0,87,49,18,15,22,-7,13:18
,160,Lars Bryggman,22,Malmö,F,29,5,8,13,10,1,0,35,30,24,22,14,8,13:47
,161,Christian Jaros,15,Luleå,D,36,5,8,13,22,2,1,60,57,36,20,12,8,18:18
,162,Brendan Mikkelson,27,Luleå,D,42,5,8,13,10,0,0,79,20,44,22,20,2,22:35
,163,Tom Wandell,14,Örebro,F,52,5,8,13,16,0,1,81,10,28,19,28,-9,18:19
,164,Markus Lauridsen,3,Leksand,D,48,4,9,13,2,1,2,70,20,39,21,33,-12,18:30
,165,Emil Djuse,57,Skellefteå,D,50,4,9,13,59,1,0,79,57,48,34,30,4,21:20
,166,Christoffer Ehn,21,Frölunda,F,52,4,9,13,10,0,0,48,18,28,20,17,3,11:20
,167,Kristofer Berglund,2,HV71,D,51,3,10,13,20,0,1,39,49,29,36,13,23,16:43
,168,Linus Persson,25,Färjestad,F,49,8,4,12,6,2,1,68,19,40,21,23,-2,15:01
,169,Johan Wiklander,56,Örebro,F,48,7,5,12,20,1,1,38,61,31,16,21,-5,13:32
,170,Karl Fabricius,52,Luleå,F,52,6,6,12,2,1,0,76,16,26,15,20,-5,12:10
,171,Henrik Hetta,20,Skellefteå,F,44,5,7,12,10,1,1,66,81,46,10,16,-6,13:44
,172,Jonathan Davidsson,71,Djurgården,F,44,3,9,12,16,2,0,67,38,18,16,22,-6,12:10
,173,Alexander Ytterell,66,Leksand,D,48,3,9,12,14,2,3,70,11,22,15,31,-16,14:19
,173,Lawrence Pilut,20,HV71,D,48,3,9,12,20,1,0,66,13,25,33,13,20,18:56
,175,Josh Hennessy,9,Växjö,F,51,3,9,12,16,1,0,43,21,28,21,18,3,12:17
,176,Dylan Reese,42,HV71,D,24,2,10,12,25,0,2,42,8,14,21,13,8,19:45
,177,Niclas Burström,3,Skellefteå,D,29,2,10,12,18,0,2,36,6,12,15,16,-1,20:16
,178,Lukas Kilström,5,Brynäs,D,48,2,10,12,14,0,1,82,41,77,41,25,16,18:50
,179,Jens Olsson,28,Malmö,D,47,1,11,12,26,0,0,66,35,25,26,34,-8,18:12
,180,Martin Karlsson,100,Leksand,F,50,8,3,11,14,0,1,81,73,31,12,45,-33,16:11
,181,Daniel Widing,41,Rögle,F,19,7,4,11,10,1,2,45,7,6,11,11,0,16:02
,182,David Åslin,29,Rögle,F,35,5,6,11,62,1,0,28,26,8,13,13,0,9:31
,183,Juuso Ikonen,61,/,F,36,3,8,11,0,0,2,44,13,4,10,12,-2,11:52
,184,Lucas Carlsson,23,Brynäs,D,41,3,8,11,16,0,0,52,12,29,26,21,5,15:54
,185,Niklas Arell,42,Karlskrona,D,43,3,8,11,18,0,0,40,30,63,36,18,18,20:31
,186,Jonathan Sigalet,56,Frölunda,D,45,3,8,11,43,0,1,43,45,48,21,17,4,18:28
,187,Marcus Högström,4,Djurgården,D,21,2,9,11,0,1,0,37,12,5,14,10,4,21:36
,188,Elias Fälth,33,Brynäs,D,35,2,9,11,12,0,0,59,20,22,22,17,5,17:05
,189,Anton Karlsson,47,Linköping,D,48,2,9,11,8,0,0,67,36,40,28,21,7,17:52
,190,Noah Welch,5,Malmö,D,51,2,9,11,79,2,0,69,76,72,33,31,2,21:38
,191,Niklas Hansson,33,HV71,D,46,1,10,11,12,1,0,46,7,24,20,24,-4,14:35
,192,Niclas Bergfors,10,/,F,47,5,5,10,12,0,1,111,18,11,13,21,-8,13:28
,193,Julius Junttila,13,Luleå,F,35,3,7,10,4,0,1,44,12,17,15,21,-6,15:27
,194,Jon Knuts,13,Leksand,F,42,3,7,10,14,1,1,67,55,18,13,27,-14,13:41
,195,Pontus Petterström,18,Skellefteå,F,49,2,8,10,14,0,0,55,16,58,19,26,-7,14:20
,196,Lukas Ericsson,53,Leksand,F,47,1,9,10,10,0,0,34,27,31,14,26,-12,13:13
,197,Niclas Lundgren,8,Linköping,D,52,1,9,10,10,0,0,45,4,60,30,24,6,18:43
,198,Henrik Nilsson,27,Karlskrona,D,45,0,10,10,8,0,0,26,8,56,28,17,11,16:49
,199,Alexander Urbom,55,Djurgården,D,51,0,10,10,95,0,0,46,49,51,35,35,0,19:15
,200,Patrick Cehlin,71,Rögle,F,17,6,3,9,4,0,2,52,10,17,7,17,-10,19:06
,201,Marcus Davidsson,9,Djurgården,F,45,5,4,9,6,0,0,40,18,5,16,20,-4,11:12
,202,Simon Ryfors,15,Rögle,F,46,5,4,9,6,1,1,30,5,22,12,11,1,10:48
,203,Jeff Tambellini,7,/,F,51,4,5,9,20,1,0,92,25,27,9,19,-10,14:14
,203,Emil Lundberg,79,Karlskrona,F,51,4,5,9,10,1,1,55,15,10,16,20,-4,11:21
,205,Lukas Haudum,21,Malmö,F,21,3,6,9,2,0,1,16,10,8,7,7,0,8:26
,206,Joakim Hillding,24,/,F,44,3,6,9,16,0,0,52,23,9,13,19,-6,12:13
,207,Bobbo Petersson,53,Örebro,D,47,3,6,9,18,0,1,37,16,29,20,29,-9,17:41
,208,Vilmos Gallo,55,Linköping,F,50,3,6,9,6,0,0,48,34,16,15,11,4,8:47
,209,Kevin Marshall,46,Rögle,D,52,3,6,9,79,0,0,53,48,40,27,35,-8,17:42
,210,Marcus Pettersson,8,Skellefteå,D,41,2,7,9,49,0,0,49,41,40,22,25,-3,17:39
,211,Johan Alm,,Skellefteå,D,48,1,8,9,18,0,0,34,60,66,17,27,-10,18:13
,212,Joe Piskula,6,Leksand,D,51,1,8,9,47,0,0,45,55,82,28,44,-16,19:47
,213,Filip Berglund,6,Skellefteå,D,47,0,9,9,10,0,0,35,9,13,18,16,2,9:30
,214,Anton Bengtsson,28,HV71,F,32,5,3,8,8,0,0,38,46,9,13,7,6,14:03
,215,Samuel Asklöf,12,Brynäs,F,20,4,4,8,2,1,0,19,11,9,9,4,5,7:49
,216,Tobias Forsberg,19,Leksand,F,44,4,4,8,12,1,0,53,67,15,10,18,-8,12:34
,217,Lukas Vejdemo,44,Djurgården,F,48,4,4,8,8,2,0,49,33,18,16,17,-1,13:08
,218,Siim Liivik,72,Örebro,F,21,2,6,8,14,0,0,18,19,10,5,12,-7,12:36
,219,Christopher Mastomäki,33,Luleå,F,43,2,6,8,14,0,0,39,17,20,15,19,-4,12:39
,219,Mattias Nörstebö,18,Frölunda,D,43,2,6,8,4,1,0,36,6,46,30,23,7,17:24
,221,Erik Andersson,38,HV71,F,51,2,6,8,4,1,0,63,37,18,17,9,8,11:22
,222,Patrik Norén,26,Leksand,D,43,1,7,8,20,1,0,27,20,40,16,30,-14,17:39
,223,Olle Alsing,38,Leksand,D,45,1,7,8,10,0,0,42,4,23,15,24,-9,13:20
,224,Jan Sandström,7,Luleå,D,48,0,8,8,20,0,0,52,30,80,28,30,-2,19:04
,225,Johan Alcén,14,Brynäs,F,48,5,2,7,4,1,0,40,56,15,14,13,1,11:07
,226,Einar Emanuelsson,10,Luleå,F,34,4,3,7,0,1,1,32,2,8,12,18,-6,10:51
,227,Sondre Olden,23,Leksand,F,46,4,3,7,6,0,1,61,14,8,14,22,-8,12:13
,228,Christoffer Forsberg,23,Malmö,F,52,4,3,7,22,0,0,59,19,30,9,20,-11,11:49
,229,Tim Söderlund,9,Skellefteå,F,39,3,4,7,8,1,0,30,18,5,8,10,-2,9:55
,230,David Bernhardt,49,Djurgården,D,27,2,5,7,4,0,0,21,3,7,14,7,7,9:45
,231,Robin Gartner,2,Karlskrona,D,49,2,5,7,12,2,0,45,11,33,16,23,-7,15:13
,232,Mattias Ritola,21,Leksand,F,16,1,6,7,6,0,0,39,7,4,7,11,-4,17:41
,233,Johan Motin,57,Örebro,D,43,1,6,7,43,0,0,32,34,51,23,24,-1,17:56
,234,Michael Haga,85,Örebro,F,45,1,6,7,14,0,0,41,39,20,11,23,-12,12:47
,235,Mathias Tjärnqvist,71,Malmö,F,39,0,7,7,12,0,0,16,24,37,9,12,-3,10:56
,236,Tomas Skogs,23,Färjestad,D,41,0,7,7,24,0,0,33,20,36,23,19,4,16:44
,237,Christoffer Persson,6,HV71,D,48,0,7,7,28,0,0,38,27,50,33,11,22,16:50
,238,Isac Skedung,24,Leksand,F,27,5,1,6,0,1,0,31,3,5,8,9,-1,8:22
,239,Emil Kristensen,28,Linköping,D,23,3,3,6,6,0,1,58,24,9,9,14,-5,14:43
,240,John Henrion,16,Karlskrona,F,29,3,3,6,6,1,1,45,9,11,4,7,-3,11:34
,241,Björn Svensson,26,Färjestad,F,31,3,3,6,4,0,0,33,24,4,10,17,-7,11:00
,242,Daniel Mannberg,79,Brynäs,F,40,3,3,6,10,0,0,35,16,15,10,10,0,11:24
,242,Ole-Kristian Tollefsen,55,Färjestad,D,40,3,3,6,76,0,0,48,80,31,19,26,-7,17:28
,244,Isac Lundeström,37,Luleå,F,45,3,3,6,0,0,1,14,19,17,8,13,-5,9:20
,245,Nils Carnbäck,20,Växjö,F,15,2,4,6,10,0,0,5,8,0,10,4,6,7:56
,246,Edwin Hedberg,20,Rögle,F,21,2,4,6,6,0,2,49,4,4,5,14,-9,15:18
,247,Simon Bertilsson,15,Brynäs,D,37,2,4,6,8,2,0,39,59,72,27,19,8,18:26
,248,Linus Lindström,16,Skellefteå,F,50,2,4,6,8,0,0,42,12,15,12,14,-2,11:22
,249,Oliver Bohm,3,Växjö,D,51,2,4,6,16,0,0,53,23,38,34,20,14,16:55
,250,Kristian Vesalainen,78,Frölunda,F,26,1,5,6,2,1,0,20,15,13,7,8,-1,9:11
,251,Chris Abbott,29,HV71,F,28,1,5,6,12,0,0,17,13,6,7,10,-3,13:20
,252,Erik Brännström,26,HV71,D,35,1,5,6,2,1,0,34,5,12,18,8,10,11:51
,253,Martin Grönberg,22,Leksand,F,51,1,5,6,2,0,0,45,28,26,17,27,-10,11:28
,254,Kristoffer Söder,19,Karlskrona,F,52,1,5,6,6,0,0,19,31,8,12,20,-8,11:24
,255,Jesper Boqvist,90,Brynäs,F,16,0,6,6,2,0,0,17,4,1,10,4,6,8:15
,256,Erik Andersson,2,Malmö,D,40,0,6,6,6,0,0,32,0,34,25,10,15,16:58
,257,Marc Zanetti,51,Brynäs,D,52,0,6,6,12,0,0,44,39,67,33,22,11,16:58
,258,William Wikman,28,Leksand,F,15,4,1,5,2,0,0,14,8,6,5,8,-3,8:54
,259,Dominique Heinrich,91,Örebro,D,22,3,2,5,4,2,2,23,4,9,8,15,-7,17:30
,260,Anton Grundel,73,Färjestad,D,34,2,3,5,16,0,0,34,20,23,11,15,-4,16:15
,261,Glenn Gustafsson,37,Örebro,F,39,2,3,5,8,0,0,22,37,34,5,21,-16,10:11
,262,Daniel Sylwander,23,Rögle,F,44,2,3,5,33,0,0,68,64,14,7,15,-8,11:29
,262,Peter Andersson,44,Örebro,D,44,2,3,5,20,1,0,47,16,57,19,17,2,16:37
,264,Oscar Engsund,32,/,D,46,2,3,5,41,1,0,48,72,50,19,29,-10,15:51
,265,Timothy Liljegren,18,Rögle,D,19,1,4,5,4,0,1,20,0,6,7,10,-3,10:02
,266,Jacob Larsson,4,Frölunda,D,29,1,4,5,16,0,0,48,4,17,9,16,-7,17:07
,267,Viktor Ekbom,8,Örebro,D,34,1,4,5,20,0,0,36,27,85,18,22,-4,19:42
,268,Jesper Williamsson,34,Rögle,D,39,1,4,5,14,1,0,34,36,49,24,23,1,18:14
,269,Ludvig Claesson,4,Rögle,D,44,1,4,5,8,0,1,30,18,37,22,32,-10,14:58
,270,Ville Varakas,8,Djurgården,D,41,0,5,5,32,0,0,33,42,62,17,25,-8,20:44
,271,Dominik Granak,51,Rögle,D,49,0,5,5,24,0,0,53,19,49,18,33,-15,17:57
,272,Fredrik Lindgren,61,Skellefteå,D,50,0,5,5,14,0,0,50,61,38,23,30,-7,19:27
,273,Henrik Eriksson,17,Djurgården,F,52,0,5,5,12,0,0,63,89,22,13,13,0,11:32
,274,Alexander Wiklund,29,Karlskrona,F,47,4,0,4,16,1,0,51,49,14,5,17,-12,10:37
,275,Mathias From,20,Rögle,F,33,3,1,4,12,0,0,24,8,12,6,15,-9,8:03
,276,Tomas Zaborsky,67,Brynäs,F,12,2,2,4,2,0,1,30,2,2,5,9,-4,15:04
,277,Tim Kennedy,10,Luleå,F,18,2,2,4,12,1,1,15,19,6,7,9,-2,16:05
,278,Gustav Possler,80,Djurgården,F,21,2,2,4,4,0,0,22,10,11,6,4,2,11:21
,279,Kim Rosdahl,96,Malmö,F,31,2,2,4,12,0,0,24,36,26,6,7,-1,12:20
,280,Gabriel Carlsson,29,Linköping,D,40,2,2,4,6,1,0,36,9,32,20,12,8,15:18
,281,Carl-Johan Lerby,14,Malmö,D,45,2,2,4,2,0,0,43,9,39,13,17,-4,12:13
,282,Alen Bibic,5,Rögle,D,50,2,2,4,46,0,0,51,89,63,21,25,-4,17:37
,283,Kyle Cumiskey,15,Skellefteå,D,12,1,3,4,4,0,0,10,1,14,4,6,-2,13:54
,284,Tim Stapleton,23,Färjestad,F,20,1,3,4,4,0,1,23,4,8,4,8,-4,13:21
,285,Andreas Wingerli,24,Skellefteå,F,44,1,3,4,16,0,0,32,17,20,7,14,-7,11:26
,286,Andreas Jämtin,18,Färjestad,F,46,1,3,4,32,0,0,45,33,22,9,22,-13,10:47
,287,Adam Ollas Mattsson,73,Djurgården,D,52,1,3,4,29,0,0,33,80,31,19,16,3,13:45
,288,Filip Westerlund,85,Frölunda,D,33,0,4,4,6,0,0,26,5,25,13,10,3,11:03
,289,Linus Högberg,6,Växjö,D,35,0,4,4,6,0,0,11,5,10,8,8,0,9:17
,290,Alexander Falk,41,Djurgården,D,42,0,4,4,45,0,0,25,28,21,11,12,-1,15:19
,291,David Printz,55,Karlskrona,D,44,0,4,4,20,0,0,26,35,56,15,22,-7,16:58
,292,Alexander Hellström,7,Örebro,D,51,0,4,4,40,0,0,29,90,63,11,27,-16,13:42
,293,Marcel Müller,41,Linköping,F,9,2,1,3,4,1,1,8,7,1,3,4,-1,11:11
,294,Alexander Deilert,54,Karlskrona,D,12,2,1,3,0,0,1,12,2,9,3,7,-4,15:42
,295,Teemu Laine,92,HV71,F,15,2,1,3,22,1,1,30,15,1,3,6,-3,13:55
,296,Kalle Jellvert,42,Örebro,F,30,2,1,3,2,0,0,10,8,6,6,8,-2,6:07
,297,Johannes Johannesen,2,Frölunda,D,10,1,2,3,2,0,0,9,1,6,5,2,3,10:34
,298,Rasmus Dahlin,26,Frölunda,D,26,1,2,3,6,1,0,21,11,12,14,10,4,12:03
,299,Taylor Matson,17,Rögle,F,31,1,2,3,10,0,0,42,21,18,7,12,-5,16:31
,300,Sebastian Ohlsson,72,Skellefteå,F,42,1,2,3,10,0,0,61,26,23,6,14,-8,10:50
,301,Oskar Steen,29,Färjestad,F,47,1,2,3,8,0,0,38,28,5,4,9,-5,7:58
,302,Sebastian Erixon,50,Färjestad,D,36,0,3,3,10,0,0,32,20,45,19,17,2,18:09
,303,Johan Adolfsson,15,Örebro,F,37,0,3,3,12,0,0,30,13,25,6,18,-12,11:02
,304,Stefan Warg,6,Malmö,D,45,0,3,3,6,0,0,28,46,32,22,18,4,16:58
,305,Lucas Lessio,38,Örebro,F,8,2,0,2,14,0,1,27,7,0,2,10,-8,15:54
,306,Albin Lundin,25,Djurgården,F,19,2,0,2,0,1,0,10,5,1,4,4,0,6:28
,307,Johan Ivarsson,7,Malmö,D,21,2,0,2,4,0,0,12,18,5,6,4,2,8:26
,308,Sam Marklund,11,/,F,27,2,0,2,10,1,0,26,10,12,6,11,-5,9:43
,309,Almen Bibic,3,Rögle,D,43,2,0,2,69,0,0,32,109,41,9,17,-8,15:10
,310,Gustaf Thorell,12,/,F,47,2,0,2,4,1,0,42,13,27,13,11,2,9:21
,311,David Ullström,29,HV71,F,5,1,1,2,0,0,0,9,1,5,3,0,3,12:18
,312,Axel Holmström,25,Skellefteå,F,16,1,1,2,0,1,0,17,5,7,3,8,-5,12:12
,313,Linus Nässén,25,Luleå,D,21,1,1,2,2,0,0,4,1,8,4,5,-1,8:43
,314,Gustaf Franzén,13,Örebro,F,31,1,1,2,4,0,0,24,1,22,3,9,-6,10:54
,315,Hugo Enock,23,Färjestad,D,33,1,1,2,6,0,0,15,16,4,3,6,-3,6:29
,316,Daniel Bertov,3,Leksand,D,46,1,1,2,20,0,0,60,57,28,19,37,-18,15:52
,317,Mark Katic,23,Skellefteå,D,4,0,2,2,25,0,0,0,0,2,2,3,-1,12:54
,318,Adam Ginning,37,Linköping,D,12,0,2,2,6,0,0,6,5,4,3,4,-1,7:34
,319,Mikko Kousa,48,Djurgården,D,16,0,2,2,4,0,0,19,8,7,6,16,-10,15:10
,320,Anders Lindbäck,39,Rögle,Gk,26,0,2,2,4,0,0,1,0,0,28,45,-17,0:00
,321,Nicklas Grossmann,8,Örebro,D,28,0,2,2,10,0,0,14,18,28,10,13,-3,16:46
,321,Anton Björkman,2,Linköping,D,28,0,2,2,0,0,0,5,13,11,5,9,-4,7:38
,323,Victor Aronsson,7,Karlskrona,D,47,0,2,2,8,0,0,13,6,10,11,14,-3,9:08
,324,Mikael Tellqvist,32,Djurgården,Gk,50,0,2,2,0,0,0,0,0,0,47,54,-7,0:00
,325,Jonathan Rodensjö,16,Linköping,F,5,1,0,1,0,1,0,1,2,0,1,1,0,2:01
,326,Sebastian Enterfeldt,59,Brynäs,F,6,1,0,1,2,0,1,6,4,1,0,1,-1,9:48
,327,Oliwer Fjellström,46,Frölunda,F,8,1,0,1,0,1,0,3,0,3,1,0,1,3:49
,328,Fredrik Forsberg,12,Leksand,F,9,1,0,1,2,0,1,6,2,3,3,3,0,10:31
,329,Anders Eriksson,40,Örebro,F,12,1,0,1,0,0,0,9,11,11,2,4,-2,13:46
,330,Gustav Rydahl,15,Luleå,F,25,1,0,1,20,0,0,19,14,8,3,4,-1,8:57
,331,Pontus Själin,39,Luleå,D,35,1,0,1,4,0,0,27,1,14,10,6,4,9:19
,332,Nicklas Jadeland,55,Malmö,F,46,1,0,1,28,0,0,34,58,19,3,12,-9,9:53
,333,Daniel Bernhardt,21,Djurgården,F,4,0,1,1,0,0,0,2,1,0,1,1,0,7:38
,334,Kim Johansson,8,Luleå,D,9,0,1,1,2,0,0,1,1,6,2,2,0,6:51
,335,Gustav Olhaver,21,Rögle,F,10,0,1,1,0,0,0,11,7,1,1,2,-1,5:49
,336,Rickard Hugg,96,Leksand,F,11,0,1,1,2,0,0,2,0,3,1,1,0,5:24
,336,Robin Press,8,Djurgården,D,11,0,1,1,2,0,0,7,2,1,2,1,1,8:06
,338,Isac Brännström,17,HV71,F,13,0,1,1,0,0,0,3,2,4,3,0,3,4:58
,338,Fredric Andersson,13,Örebro,F,13,0,1,1,8,0,0,20,6,2,2,6,-4,13:34
,340,Viktor Amnér,4,/,D,16,0,1,1,0,0,0,7,3,6,4,5,-1,9:12
,341,Erik Broman,9,Brynäs,F,18,0,1,1,0,0,0,1,0,1,2,1,1,2:35
,342,Lukas Enqvist,39,Färjestad,F,19,0,1,1,4,0,0,3,5,2,3,5,-2,5:51
,343,Marcus Ersson,10,Brynäs,D,20,0,1,1,4,0,0,5,10,3,3,3,0,3:43
,343,Anton Öhman,36,Skellefteå,D,20,0,1,1,0,0,0,15,4,9,2,6,-4,5:58
,345,Petter Hansson,18,Linköping,D,22,0,1,1,2,0,0,21,5,6,3,10,-7,11:01
,346,Axel Jonsson-Fjällby,91,Djurgården,F,24,0,1,1,0,0,0,9,11,3,2,4,-2,4:29
,347,Magnus Häggström,17,Malmö,F,28,0,1,1,6,0,0,20,15,16,3,6,-3,10:36
,348,Joacim Eriksson,30,Växjö,Gk,47,0,1,1,0,0,0,0,0,0,81,51,30,0:00
,348,Oscar Alsenfelt,69,Malmö,Gk,47,0,1,1,4,0,0,0,0,0,54,34,20,0:00
,350,Johan Holmqvist,40,Karlskrona,Gk,49,0,1,1,0,0,0,0,0,0,50,50,0,0:00
,351,Joel Lassinantti,34,Luleå,Gk,50,0,1,1,4,0,0,0,0,0,63,59,4,0:00
,352,Joni Ortio,31,Skellefteå,Gk,51,0,1,1,4,0,0,1,0,0,66,76,-10,0:00
,353,Stefan Steen,26,Färjestad,Gk,52,0,1,1,0,0,0,0,0,0,42,34,8,0:00
,353,Lars Haugen,30,Färjestad,Gk,52,0,1,1,6,0,0,0,0,0,54,49,5,0:00
,353,Oscar Dansk,35,Rögle,Gk,52,0,1,1,2,0,0,0,0,0,33,47,-14,0:00
,356,Jacob Nordqvist,13,Frölunda,D,1,0,0,0,0,0,0,0,0,0,0,0,0,1:55
,356,Daniel Lindberg,,Örebro,F,1,0,0,0,0,0,0,0,0,0,0,0,0,0:00
,356,Oscar Walldén,30,Djurgården,Gk,1,0,0,0,0,0,0,0,0,0,0,0,0,0:00
,356,Daniel Rosengren,53,Djurgården,Gk,1,0,0,0,0,0,0,0,0,0,0,0,0,0:00
,356,Jesper Frisell,5,Karlskrona,D,1,0,0,0,0,0,0,0,0,0,0,0,0,0:00
,356,André Nordstrand,8,Karlskrona,F,1,0,0,0,0,0,0,0,0,0,0,0,0,0:00
,356,Tony Pappila,8,Malmö,F,1,0,0,0,0,0,0,0,0,0,0,0,0,6:56
,356,Viktor Andersson,35,Karlskrona,Gk,1,0,0,0,0,0,0,0,0,0,0,0,0,0:00
,356,Johan Södergran,38,Linköping,F,1,0,0,0,0,0,0,0,0,0,0,0,0,0:04
,356,Oliver Kandergård,,Leksand,F,1,0,0,0,0,0,0,0,0,0,0,0,0,0:00
,356,Jonas Arntzen,31,Leksand,Gk,1,0,0,0,0,0,0,0,0,0,0,1,-1,0:00
,356,Pontus Eltonius,31,Växjö,Gk,1,0,0,0,0,0,0,0,0,0,0,0,0,0:00
,356,Johan Malmborg,,HV71,D,1,0,0,0,0,0,0,0,0,0,0,0,0,0:00
,356,Matias Lassen,16,Leksand,D,1,0,0,0,0,0,0,0,0,0,0,0,0,0:00
,356,Christian Mieritz,12,Leksand,D,1,0,0,0,0,0,0,0,0,0,0,0,0,0:00
,356,Jonathan Stålberg,50,Skellefteå,Gk,1,0,0,0,0,0,0,0,0,0,0,0,0,0:00
,356,Hugo Danielsson,7,Skellefteå,D,1,0,0,0,2,0,0,1,1,1,0,0,0,5:57
,356,William Lindgren,4,Örebro,D,1,0,0,0,0,0,0,0,0,0,0,0,0,0:00
,356,Oliver Henriksson,28,Örebro,F,1,0,0,0,0,0,0,0,0,0,0,0,0,0:00
,356,Kalle Miketinac,13,Frölunda,F,1,0,0,0,0,0,0,0,0,0,0,1,-1,2:39
,356,Tex Williamsson,66,Malmö,Gk,1,0,0,0,0,0,0,0,0,0,0,0,0,0:00
,356,Didrik Henbrant,,Linköping,F,1,0,0,0,0,0,0,0,0,0,0,0,0,0:00
,378,Teemu Laakso,2,Växjö,D,2,0,0,0,2,0,0,0,1,3,1,0,1,9:03
,378,Markus Christensson,10,Frölunda,D,2,0,0,0,0,0,0,0,0,0,0,1,-1,0:30
,378,Melker Persson,14,Karlskrona,D,2,0,0,0,0,0,0,0,0,0,0,0,0,0:10
,378,Rasmus Hedström,1,Linköping,Gk,2,0,0,0,0,0,0,0,0,0,0,0,0,0:00
,378,Måns Hansson,22,Malmö,D,2,0,0,0,0,0,0,0,0,1,0,0,0,9:50
,378,Alexander Bjurström,17,Brynäs,F,2,0,0,0,0,0,0,0,0,0,0,0,0,0:43
,378,William Romfors,25,HV71,F,2,0,0,0,0,0,0,1,0,0,0,0,0,4:50
,378,Ludvig Collberg,4,Växjö,D,2,0,0,0,0,0,0,2,0,0,0,1,-1,4:56
,378,Arvid Holm,75,Karlskrona,Gk,2,0,0,0,0,0,0,0,0,0,0,0,0,0:00
,378,Maximilian Eisenmenger,6,Djurgården,F,2,0,0,0,0,0,0,0,0,0,0,0,0,0:00
,378,Albin Sethsson,61,Frölunda,F,2,0,0,0,0,0,0,0,0,0,0,0,0,1:26
,378,Oliver Olsson,3,Malmö,F,2,0,0,0,0,0,0,1,1,0,0,2,-2,5:37
,378,Filip Sveningsson,71,HV71,F,2,0,0,0,0,0,0,2,2,0,0,0,0,5:04
,378,Hugo Leufvenius,6,Linköping,F,2,0,0,0,0,0,0,0,0,0,0,0,0,0:04
,378,Marcus Collin,23,Luleå,F,2,0,0,0,0,0,0,0,0,0,0,0,0,1:19
,378,Livio Stadler,26,Luleå,D,2,0,0,0,0,0,0,0,0,0,0,0,0,2:28
,394,Oscar Eklind,12,Malmö,F,3,0,0,0,0,0,0,7,6,2,0,3,-3,11:51
,394,Oliver Dackell,35,Brynäs,Gk,3,0,0,0,0,0,0,0,0,0,0,0,0,0:00
,394,Anton Malmborg,69,Malmö,Gk,3,0,0,0,0,0,0,0,0,0,0,0,0,0:00
,394,Anton Johansson,14,Örebro,F,3,0,0,0,0,0,0,0,0,0,0,0,0,0:11
,394,Oliver Horrsell,37,Linköping,D,3,0,0,0,0,0,0,2,1,0,0,0,0,2:26
,394,Linus Björk,6,Linköping,D,3,0,0,0,0,0,0,0,0,0,0,0,0,0:09
,394,Anton Sandberg,5,Karlskrona,D,3,0,0,0,0,0,0,0,0,0,0,0,0,0:00
,401,Mattias Elfström,20,Malmö,F,4,0,0,0,0,0,0,2,1,1,1,0,1,5:06
,401,Johan Zarwel,4,Rögle,F,4,0,0,0,0,0,0,0,0,0,0,1,-1,2:34
,401,Alexander Johansson,,HV71,Gk,4,0,0,0,0,0,0,0,0,0,0,0,0,0:00
,401,Filip Engarås,8,Skellefteå,F,4,0,0,0,0,0,0,2,1,1,0,0,0,4:21
,401,Jesper Mångs,53,Malmö,D,4,0,0,0,0,0,0,0,0,0,0,0,0,0:00
,401,Wilhelm Westlund,28,Djurgården,D,4,0,0,0,2,0,0,1,1,1,0,1,-1,7:42
,401,Andreas Röykås Marthinsen,,Djurgården,D,4,0,0,0,0,0,0,1,0,0,0,0,0,0:02
,401,Johan Lindholm,62,Frölunda,F,4,0,0,0,0,0,0,0,0,0,0,0,0,1:33
,401,Rupert Swärd,1,Växjö,Gk,4,0,0,0,0,0,0,0,0,0,0,0,0,0:00
,401,Matt Fraser,44,Rögle,F,4,0,0,0,0,0,0,2,4,0,0,1,-1,8:22
,401,Gustav Ahnelöv,13,Karlskrona,D,4,0,0,0,0,0,0,0,0,0,0,0,0,0:20
,412,Jacob Cederholm,3,HV71,D,5,0,0,0,0,0,0,0,1,2,2,1,1,5:44
,412,Jonathan Frykholm,55,Örebro,Gk,5,0,0,0,0,0,0,0,0,0,0,0,0,0:00
,412,Alexander Leandersson,4,Färjestad,D,5,0,0,0,0,0,0,4,1,5,4,0,4,10:04
,412,Jonas Johansson,25,Brynäs,Gk,5,0,0,0,0,0,0,0,0,0,2,2,0,0:00
,412,Rasmus Andersson,,HV71,F,5,0,0,0,0,0,0,1,0,1,0,0,0,1:41
,412,Jonas Röndbjerg,17,Växjö,F,5,0,0,0,0,0,0,0,0,1,0,0,0,2:41
,412,Nikolaj Krag-Christensen,27,Rögle,F,5,0,0,0,0,0,0,0,0,0,0,0,0,0:30
,412,Emil Bemström,72,Leksand,F,5,0,0,0,0,0,0,0,1,0,0,1,-1,3:45
,412,Arvid Söderblom,1,Frölunda,Gk,5,0,0,0,0,0,0,0,0,0,0,0,0,0:00
,421,Khalid Ibrahim,74,Skellefteå,F,6,0,0,0,0,0,0,3,3,1,0,0,0,3:00
,421,Anton Karlsson,27,Frölunda,F,6,0,0,0,0,0,0,2,2,2,0,1,-1,4:36
,421,Adam Åhman,70,HV71,Gk,6,0,0,0,0,0,0,0,0,0,0,0,0,0:00
,421,Lucas Nordsäter,7,Växjö,D,6,0,0,0,0,0,0,2,1,2,1,2,-1,6:08
,421,Henrik Neubauer,25,Färjestad,F,6,0,0,0,0,0,0,2,2,0,0,0,0,2:41
,421,Pontus Widerström,67,Frölunda,F,6,0,0,0,2,0,0,3,12,0,1,1,0,8:21
,427,Anton Cederholm,2,Rögle,D,8,0,0,0,4,0,0,0,5,4,1,2,-1,6:42
,427,Tommi Paakkolanvaara,20,Leksand,F,8,0,0,0,2,0,0,5,0,0,0,6,-6,11:30
,427,Linus Andersson,19,Skellefteå,F,8,0,0,0,0,0,0,6,4,0,0,3,-3,5:11
,427,Ludvig Carlsson,10,Örebro,D,8,0,0,0,0,0,0,1,6,2,1,2,-1,4:48
,427,Albin Storm,15,Växjö,F,8,0,0,0,0,0,0,0,1,0,0,1,-1,0:31
,427,Oscar Masiello,31,Luleå,Gk,8,0,0,0,0,0,0,0,0,0,0,0,0,0:00
,427,Pontus Eklöf,14,Linköping,F,8,0,0,0,0,0,0,2,0,0,0,0,0,2:00
,427,Jörgen Sundqvist,22,Brynäs,D,8,0,0,0,2,0,0,2,5,7,7,6,1,13:44
,435,Mikko Lehtonen,44,HV71,D,9,0,0,0,0,0,0,22,4,7,5,5,0,20:30
,435,Martin Fehervary,5,Malmö,D,9,0,0,0,0,0,0,2,2,0,0,2,-2,3:47
,435,Simon Krekula,74,Skellefteå,F,9,0,0,0,4,0,0,2,0,2,0,1,-1,5:37
,435,Anton Danielsson,5,Skellefteå,D,9,0,0,0,0,0,0,1,1,7,1,4,-3,6:26
,439,Kristoffer Gunnarsson,14,Frölunda,D,10,0,0,0,29,0,0,2,9,3,3,1,2,8:36
,439,Joni Ikonen,12,Frölunda,F,10,0,0,0,0,0,0,4,0,1,1,0,1,4:26
,439,Viktor Grahn,6,Luleå,D,10,0,0,0,0,0,0,6,1,1,1,4,-3,7:08
,439,Tim Hultstrand,60,Malmö,Gk,10,0,0,0,0,0,0,0,0,0,0,0,0,0:00
,443,Sebastian Björnstad,20,Leksand,D,11,0,0,0,0,0,0,4,0,0,5,1,4,4:56
,443,Carl Ernstig,5,Växjö,D,11,0,0,0,2,0,0,1,0,2,3,2,1,5:25
,445,Lucas Elvenes,75,Rögle,F,12,0,0,0,0,0,0,3,0,1,1,2,-1,3:01
,445,Morten Jensen,33,Rögle,D,12,0,0,0,0,0,0,0,0,1,0,0,0,1:06
,445,Jörgen Karterud,28,Linköping,F,12,0,0,0,2,0,0,8,6,0,0,1,-1,5:00
,445,Jacob Bjerselius,28,Örebro,F,12,0,0,0,0,0,0,0,1,2,0,0,0,2:29
,449,Alexander Heiver,92,Karlskrona,F,13,0,0,0,0,0,0,5,1,1,1,0,1,3:16
,450,Fabian Zetterlund,28,Färjestad,F,14,0,0,0,2,0,0,7,5,4,0,1,-1,3:23
,450,Marcus Sylvegård,18,Malmö,F,14,0,0,0,0,0,0,8,6,4,0,6,-6,6:51
,452,Ludwig Wistén,20,Växjö,F,15,0,0,0,2,0,0,4,2,4,2,3,-1,2:57
,453,Anton Toolanen,14,Luleå,F,16,0,0,0,0,0,0,2,1,1,2,2,0,2:52
,454,Simon Hellholm,35,Linköping,F,17,0,0,0,2,0,0,4,6,3,0,1,-1,3:47
,455,Johannes Kinnvall,28,Brynäs,D,18,0,0,0,4,0,0,1,3,3,2,4,-2,5:00
,455,Anton Gustafsson,58,Färjestad,F,18,0,0,0,2,0,0,12,11,2,1,4,-3,7:27
,457,Anton Brandhammar,19,Färjestad,D,21,0,0,0,0,0,0,6,2,1,0,5,-5,3:04
,458,Lars Volden,31,Rögle,Gk,26,0,0,0,0,0,0,0,0,0,17,16,1,0:00
,458,Ludvig Elvenes,25,Rögle,F,26,0,0,0,8,0,0,7,7,7,3,7,-4,6:30
,460,Nichlas Torp,38,Leksand,D,28,0,0,0,53,0,0,20,37,28,7,17,-10,13:33
,461,Gustav Backström,5,Örebro,D,37,0,0,0,18,0,0,29,10,23,10,13,-3,13:25
,462,Joseph Jonsson,39,Karlskrona,F,39,0,0,0,0,0,0,11,24,7,1,3,-2,5:21
,463,Linus Söderström,30,HV71,Gk,43,0,0,0,0,0,0,0,0,0,55,22,33,0:00
,463,Cristopher Nihlstorp,41,Malmö,Gk,43,0,0,0,0,0,0,0,0,0,34,50,-16,0:00
,465,Filip Gustavsson,30,Luleå,Gk,46,0,0,0,0,0,0,0,0,0,23,31,-8,0:00
,465,Felix Sandström,25,Brynäs,Gk,46,0,0,0,0,0,0,0,0,0,56,39,17,0:00
,467,Julius Hudacek,33,Örebro,Gk,48,0,0,0,6,0,0,0,0,0,54,76,-22,0:00
,468,Johan Gustafsson,37,Frölunda,Gk,49,0,0,0,0,0,0,0,0,0,57,54,3,0:00
,469,Dan Bakala,35,Frölunda,Gk,50,0,0,0,12,0,0,0,0,0,41,31,10,0:00
,469,David Rautio,30,Brynäs,Gk,50,0,0,0,2,0,0,0,0,0,63,50,13,0:00
,469,Marcus Högberg,1,Linköping,Gk,50,0,0,0,4,0,0,0,0,0,58,50,8,0:00
,472,Fredrik Pettersson-Wentzel,53,HV71,Gk,51,0,0,0,2,0,0,0,0,0,64,42,22,0:00
,472,Henrik Haukeland,30,Leksand,Gk,51,0,0,0,0,0,0,0,0,0,26,46,-20,0:00
,472,Axel Brage,33,Örebro,Gk,51,0,0,0,0,0,0,0,0,0,20,30,-10,0:00
,475,Gustaf Lindvall,30,Skellefteå,Gk,52,0,0,0,2,0,0,0,0,0,17,23,-6,0:00
,475,Jacob Johansson,30,Linköping,Gk,52,0,0,0,2,0,0,0,0,0,33,28,5,0:00
,475,Johannes Jönsson,38,Karlskrona,Gk,52,0,0,0,0,0,0,0,0,0,33,30,3,0:00
,475,Viktor Andrén,45,Växjö,Gk,52,0,0,0,0,0,0,0,0,0,51,29,22,0:00
,475,Adam Reideborn,39,Djurgården,Gk,52,0,0,0,0,0,0,0,0,0,34,34,0,0:00
,475,Atte Engren,35,Leksand,Gk,52,0,0,0,0,0,0,0,0,0,44,78,-34,0:00
,1,Ryan Lasch,81,Frölunda,F,51,15,36,51,20,3,3,82,14,9,33,23,10,17:46
,2,Patrick Thoresen,41,Djurgården,F,49,15,33,48,34,5,2,101,52,11,39,27,12,18:33
,3,Patrik Zackrisson,26,Skellefteå,F,52,15,33,48,68,5,9,85,22,21,41,16,25,17:36
,4,Milan Gulas,44,Färjestad,F,51,20,25,45,20,6,5,130,73,17,38,42,-4,17:15
,5,Richard Gynge,10,Växjö,F,46,21,23,44,24,5,4,163,10,12,43,20,23,17:36
,6,Andreas Johnson,88,Frölunda,F,52,19,25,44,18,5,9,105,17,15,28,20,8,16:05
,7,Andrew Gordon,13,Linköping,F,52,18,26,44,30,5,6,122,100,14,48,30,18,16:52
,8,John Norman,37,Skellefteå,F,47,17,25,42,18,6,6,101,12,17,32,27,5,16:57
,9,Garrett Roe,11,Linköping,F,41,14,27,41,28,3,2,89,44,24,37,23,14,17:44
,10,Matt Anderson,29,Djurgården,F,52,18,22,40,30,3,5,107,9,29,32,25,7,17:37
,11,Mikael Johansson,85,Färjestad,F,51,12,28,40,18,3,5,91,11,26,36,30,6,18:40
,12,Robert Rosén,87,Växjö,F,52,17,22,39,22,4,4,129,11,25,49,22,27,17:13
,13,Greg Scott,41,Brynäs,F,52,16,23,39,16,5,2,173,58,23,37,36,1,19:06
,14,Joel Lundqvist,20,Frölunda,F,45,19,19,38,22,2,6,85,112,17,31,22,9,18:18
,15,Daniel Viksten,13,Örebro,F,49,17,20,37,4,5,3,113,9,14,36,36,0,16:42
,16,Anton Rödin,18,Brynäs,F,33,16,21,37,18,5,4,91,13,12,29,22,7,19:47
,17,Jack Connolly,20,Rögle,F,50,9,28,37,14,2,0,64,15,29,35,35,0,17:25
,18,Patrick Cehlin,71,Rögle,F,52,20,16,36,52,4,3,137,39,33,33,35,-2,17:43
,19,Johan Sundström,28,Frölunda,F,51,17,19,36,16,3,7,129,26,21,37,16,21,17:22
,20,Markus Ljungh,16,Djurgården,F,48,13,23,36,12,2,3,69,24,17,36,22,14,18:28
,21,Broc Little,41,Linköping,F,43,21,14,35,24,2,3,114,5,14,32,25,7,17:24
,22,Spencer Abbott,77,Frölunda,F,42,14,21,35,4,3,5,112,8,6,26,18,8,15:43
,23,Nick Johnson,32,Brynäs,F,52,22,12,34,16,5,14,128,20,18,22,38,-16,18:08
,24,Andrew Calof,18,Skellefteå,F,52,19,15,34,45,4,5,104,2,10,32,21,11,14:42
,25,Marcus Sörensen,66,Djurgården,F,47,15,19,34,34,2,1,114,30,9,40,28,12,17:30
,26,Martin Johansson,25,Örebro,F,48,15,19,34,8,1,2,76,27,25,39,34,5,16:28
,27,Jacob Micflikier,7,Luleå,F,52,19,14,33,34,3,4,137,29,24,39,31,8,16:57
,28,Artturi Lehkonen,62,Frölunda,F,49,16,17,33,12,6,2,111,28,26,35,29,6,15:24
,29,Martin Thörnberg,10,HV71,F,49,11,22,33,20,1,5,144,72,15,33,30,3,17:42
,30,Pathrik Westerholm,7,Brynäs,F,52,7,26,33,18,3,0,102,14,31,36,30,6,16:26
,31,Mattias Guter,44,Karlskrona,F,48,19,13,32,10,3,5,118,34,17,21,38,-17,15:04
,32,Toni Rajala,10,Luleå,F,52,17,15,32,8,4,3,114,19,7,31,30,1,15:08
,33,Mattias Tedenby,21,HV71,F,47,13,19,32,41,2,5,98,20,8,28,32,-4,16:25
,34,Mattias Ritola,21,Skellefteå,F,33,9,23,32,16,3,4,74,21,16,20,11,9,15:34
,35,Tomi Sallinen,51,Djurgården,F,46,8,24,32,30,0,4,112,15,13,30,32,-2,18:29
,36,Lucas Wallmark,23,Luleå,F,48,8,24,32,20,2,0,101,17,19,37,32,5,17:18
,37,Linus Hultström,33,Djurgården,D,52,12,19,31,16,5,4,143,19,26,51,34,17,20:00
,38,Chad Billins,4,Linköping,D,50,7,24,31,14,3,5,90,6,33,51,24,27,21:15
,39,Tuomas Kiiskinen,19,Växjö,F,45,16,14,30,10,4,2,75,17,31,43,23,20,16:38
,40,Nils Andersson,8,Malmö,D,49,6,24,30,37,1,1,115,15,55,35,39,-4,21:18
,41,Jonas Junland,44,Linköping,D,51,5,25,30,36,1,3,136,9,48,36,38,-2,22:13
,42,Rhett Rakhshani,49,Linköping,F,33,14,15,29,14,4,3,73,11,9,28,18,10,15:08
,43,Victor Olofsson,11,MODO,F,49,14,15,29,6,3,0,98,15,14,35,36,-1,15:20
,44,Henrik Tömmernes,7,Frölunda,D,50,10,19,29,14,1,9,116,10,48,33,21,12,20:27
,45,Simon Önerud,11,HV71,F,48,17,11,28,26,6,5,124,27,25,34,36,-2,17:21
,46,Libor Hudacek,79,Örebro,F,48,14,14,28,42,3,2,72,26,8,33,26,7,13:49
,47,Johan Harju,24,Luleå,F,49,11,17,28,16,3,2,96,18,23,25,25,0,15:55
,48,Niclas Burström,3,Skellefteå,D,50,9,19,28,42,2,1,75,14,45,41,21,20,20:19
,49,Marcus Högström,4,Djurgården,D,50,8,20,28,56,2,3,95,32,34,48,36,12,23:00
,50,Ludvig Rensfeldt,29,Rögle,F,52,15,12,27,16,5,3,118,29,29,32,36,-4,17:48
,51,Jesper Olofsson,92,Karlskrona,F,52,13,13,26,6,1,3,118,8,8,24,35,-11,13:40
,52,Emil Pettersson,14,MODO,F,52,12,14,26,28,0,3,131,21,25,26,35,-9,18:39
,53,Magnus Nygren,32,Färjestad,D,47,8,18,26,24,0,4,147,35,22,42,28,14,23:34
,54,Joel Mustonen,40,Örebro,F,46,15,10,25,41,4,2,70,15,18,30,23,7,15:32
,55,Peter Mueller,88,Malmö,F,43,13,12,25,16,2,2,105,19,14,18,29,-11,17:17
,56,Alexander Bergström,26,Karlskrona,F,37,10,15,25,10,0,3,79,13,14,22,28,-6,16:28
,57,Riley Holzapfel,21,Karlskrona,F,48,9,16,25,24,0,5,54,35,23,27,35,-8,16:34
,58,Oskar Lindblom,96,Brynäs,F,48,8,17,25,14,1,3,91,21,20,34,31,3,16:20
,59,Niklas Persson,23,Linköping,F,50,8,17,25,16,2,5,59,22,42,34,23,11,17:14
,60,Cory Murphy,,Växjö,D,52,3,22,25,45,2,0,101,22,66,39,43,-4,21:33
,61,Andreas Thuresson,12,Malmö,F,42,14,10,24,55,2,4,146,47,9,29,29,0,17:22
,62,Robin Alvarez,27,Djurgården,F,49,14,10,24,34,5,3,106,28,30,32,21,11,16:54
,63,Greg Squires,26,Örebro,F,48,13,11,24,18,1,1,65,10,8,26,25,1,12:37
,64,Daniel Brodin,34,Djurgården,F,50,13,11,24,42,0,6,119,105,31,25,27,-2,16:18
,65,Frederik Storm,9,Malmö,F,46,12,12,24,8,2,1,105,23,21,26,32,-6,16:15
,66,Erik Christensen,24,HV71,F,42,9,15,24,28,2,1,73,9,6,29,31,-2,16:08
,67,Gustav Possler,80,MODO,F,52,9,15,24,6,3,1,101,15,57,28,36,-8,17:43
,68,Chris Abbott,29,HV71,F,50,8,16,24,41,0,2,46,29,23,35,30,5,18:41
,69,Ilkka Heikkinen,49,Växjö,D,49,7,17,24,14,1,3,82,37,36,48,24,24,19:26
,70,Jacob Lagacé,91,Luleå,F,50,7,17,24,26,4,3,70,54,11,24,22,2,14:14
,71,Patrik Carlsson,72,Frölunda,F,51,6,18,24,12,2,0,61,27,29,34,24,10,14:37
,72,Jonathan Granström,31,Luleå,F,49,13,10,23,30,2,6,58,26,19,25,25,0,16:46
,73,Linus Persson,25,Färjestad,F,51,13,10,23,12,7,1,56,6,41,21,19,2,15:49
,74,Jakob Lilja,15,Linköping,F,52,12,11,23,8,2,1,86,16,44,30,21,9,15:31
,75,Nick Sörensen,10,Linköping,F,37,10,13,23,37,2,2,72,31,27,25,20,5,15:00
,76,Patrik Lundh,79,Växjö,F,47,10,13,23,8,1,0,71,21,17,27,22,5,15:00
,77,Joachim Rohdin,72,Karlskrona,F,52,9,14,23,18,0,3,95,45,21,16,35,-19,16:16
,78,Jimmie Ericsson,21,Skellefteå,F,37,8,15,23,59,2,1,95,24,22,22,14,8,16:56
,79,Axel Holmström,25,Skellefteå,F,48,8,15,23,20,1,4,64,17,11,17,20,-3,13:16
,80,Tim Heed,4,Skellefteå,D,52,8,15,23,2,1,6,130,9,32,30,24,6,19:50
,81,Bill Thomas,13,MODO,F,48,12,10,22,18,1,1,103,40,35,32,41,-9,17:25
,82,Janne Pesonen,22,Skellefteå,F,21,11,11,22,2,2,3,58,16,10,16,7,9,15:30
,83,Jens Olsson,28,Malmö,D,51,9,13,22,16,3,2,90,18,12,27,45,-18,22:17
,84,Robin Figren,23,Frölunda,F,52,9,13,22,26,2,0,112,21,17,29,23,6,13:41
,85,Adam Pettersson,12,Skellefteå,F,52,8,14,22,12,2,0,73,16,20,29,17,12,14:56
,85,Christopher Liljewall,52,Rögle,F,52,8,14,22,20,1,1,42,46,34,28,20,8,15:07
,87,Niklas Hansson,33,HV71,D,44,7,15,22,14,2,1,55,21,21,20,32,-12,19:09
,88,Sebastian Wännström,22,Rögle,F,50,14,7,21,24,1,7,132,13,13,15,34,-19,14:38
,89,Martin Lundberg,27,Skellefteå,F,44,13,8,21,22,3,4,84,46,47,24,16,8,15:30
,90,Anton Hedman,8,Luleå,F,49,9,12,21,54,2,2,70,130,15,28,23,5,13:08
,91,Filip Sandberg,16,HV71,F,52,9,12,21,14,1,2,89,67,33,19,28,-9,15:40
,92,Nicklas Lasu,31,Frölunda,F,51,8,13,21,30,3,0,50,40,42,29,16,13,14:55
,93,Robbie Earl,10,Färjestad,F,33,6,15,21,18,0,2,50,18,13,19,20,-1,17:01
,94,Gustav Forsling,8,Linköping,D,48,6,15,21,4,0,2,100,9,12,43,22,21,16:12
,95,Dominik Granak,51,Rögle,D,52,6,15,21,40,0,1,69,42,39,32,40,-8,19:42
,96,Joey Tenute,11,Malmö,F,46,5,16,21,26,2,1,72,46,13,23,31,-8,15:19
,97,Erik Forssell,20,Skellefteå,F,48,5,16,21,10,0,1,66,6,44,24,18,6,14:46
,98,Marcus Weinstock,20,Örebro,F,52,5,16,21,16,1,1,59,27,18,22,30,-8,14:34
,99,Oscar Sundh,13,HV71,F,52,15,5,20,18,3,3,83,24,24,24,24,0,16:16
,100,Filip Cruseman,48,Karlskrona,F,45,13,7,20,8,0,6,68,14,16,16,29,-13,13:35
,101,Peter Cehlarik,26,Luleå,F,46,11,9,20,4,4,2,62,21,12,27,20,7,13:32
,102,Liam Reddox,85,Växjö,F,45,9,11,20,14,1,0,80,41,22,24,25,-1,14:35
,103,Mats Rosseli Olsen,51,Frölunda,F,47,4,16,20,55,0,0,72,27,26,29,20,9,15:47
,104,Taylor Matson,17,Rögle,F,52,3,17,20,28,0,1,54,34,40,28,38,-10,18:24
,105,Jonathan Pudas,64,Brynäs,D,51,2,18,20,14,1,1,68,10,41,36,42,-6,20:22
,106,Jordan Smotherman,44,Rögle,F,52,14,5,19,16,1,3,155,46,33,23,31,-8,17:02
,107,Joakim Nygård,11,Färjestad,F,47,12,7,19,16,1,2,92,25,14,21,23,-2,15:09
,108,Bobby Butler,15,MODO,F,49,10,9,19,16,1,1,88,36,15,20,35,-15,16:11
,109,Per-Åge Skröder,10,MODO,F,50,10,9,19,14,1,2,93,54,30,26,47,-21,16:11
,110,Nichlas Hardt,43,Linköping,F,30,9,10,19,33,4,3,67,73,26,20,14,6,15:39
,111,Joakim Hillding,24,Växjö,F,45,9,10,19,10,4,2,76,27,11,25,22,3,13:31
,112,Maxim Lapierre,40,MODO,F,34,8,11,19,34,1,3,91,71,10,20,37,-17,19:12
,113,John Henrion,16,Karlskrona,F,46,7,12,19,20,0,2,136,28,18,13,25,-12,13:55
,114,Adam Almquist,5,HV71,D,47,6,13,19,30,2,2,67,19,29,34,38,-4,20:15
,115,Johan Wiklander,56,Örebro,F,48,6,13,19,36,1,2,56,59,19,24,31,-7,14:20
,116,Mikko Lehtonen,8,/,F,50,6,13,19,20,2,1,112,30,8,17,35,-18,13:58
,117,Kent McDonell,3,Malmö,F,49,11,7,18,16,1,3,122,38,31,22,21,1,15:36
,118,Alexander Johansson,16,Växjö,F,43,9,9,18,18,1,4,72,38,30,21,22,-1,15:05
,119,Ponthus Westerholm,27,Brynäs,F,48,9,9,18,45,1,0,87,9,18,25,21,4,12:56
,120,Jakub Krejcik,91,Örebro,D,50,5,13,18,16,0,3,55,22,34,18,38,-20,17:08
,121,Chris Campoli,41,HV71,D,32,3,15,18,39,0,2,60,53,46,26,26,0,21:02
,122,Björn Svensson,26,Malmö,F,47,14,3,17,10,2,5,70,42,10,25,31,-6,15:21
,123,Jonas Holös,6,Färjestad,D,40,5,12,17,6,0,1,62,13,36,26,36,-10,22:50
,124,Johan Ryno,61,Färjestad,F,44,5,12,17,12,3,1,69,16,24,19,22,-3,15:13
,125,Julien Brouillette,59,Karlskrona,D,52,5,12,17,32,1,2,80,60,57,31,48,-17,23:02
,125,Lukas Vejdemo,44,Djurgården,F,52,5,12,17,12,0,0,63,20,17,28,18,10,12:27
,127,Petr Zámorský,24,Örebro,D,30,4,13,17,14,2,0,57,15,24,29,25,4,19:22
,128,Oscar Fantenberg,66,Frölunda,D,43,4,13,17,14,1,2,88,62,28,25,18,7,20:16
,129,Niklas Fogström,36,Linköping,F,51,4,13,17,14,0,0,46,14,31,30,24,6,15:40
,130,John Persson,67,Färjestad,F,52,12,4,16,22,2,6,73,45,14,17,21,-4,13:56
,131,Jesper Ollas,17,Brynäs,F,45,9,7,16,8,0,1,69,25,19,16,29,-13,16:41
,132,Josh Hennessy,9,Växjö,F,52,8,8,16,40,0,1,71,24,29,24,28,-4,15:01
,133,Carl Grundström,3,MODO,F,49,7,9,16,53,0,0,86,75,19,21,23,-2,13:50
,134,Craig Schira,6,Luleå,D,51,4,12,16,16,0,2,118,69,78,41,33,8,21:49
,135,Noah Welch,5,MODO,D,32,3,13,16,56,0,1,70,55,47,23,24,-1,0:52
,136,Sebastian Aho,63,Skellefteå,D,39,3,13,16,12,1,1,35,5,19,20,15,5,15:16
,137,Joel Kellman,11,Karlskrona,F,47,3,13,16,22,0,0,78,11,19,22,34,-12,16:37
,138,Emil Sylvegård,51,Luleå,F,50,3,13,16,20,1,0,45,76,22,20,19,1,11:13
,139,Joel Eriksson Ek,20,Färjestad,F,41,9,6,15,18,4,1,77,51,10,20,13,7,12:43
,140,Jens Jakobs,26,/,F,38,7,8,15,4,0,0,54,4,17,18,10,8,12:47
,141,Emil Larsson,,Karlskrona,F,49,7,8,15,14,2,2,41,38,41,14,33,-19,15:22
,142,Kalle Olsson,85,Örebro,F,46,6,9,15,12,2,0,43,19,48,21,17,4,15:31
,143,Pär Lindholm,17,Skellefteå,F,52,6,9,15,26,0,0,61,43,21,24,15,9,13:53
,143,Marc Zanetti,51,Brynäs,D,52,6,9,15,32,1,0,63,50,52,34,34,0,18:00
,145,Anssi Salmela,14,Brynäs,D,24,4,11,15,47,0,3,63,7,12,16,11,5,20:26
,146,Lukas Kilström,5,Brynäs,D,45,4,11,15,67,0,1,63,56,82,30,23,7,18:32
,147,Emil Djuse,57,MODO,D,46,4,11,15,4,0,1,54,21,45,32,38,-6,18:57
,148,Sebastian Erixon,50,Färjestad,D,50,4,11,15,20,0,2,72,19,73,32,28,4,20:52
,149,T.J. Galiardi,72,Malmö,F,29,3,12,15,42,0,0,66,14,10,15,15,0,20:01
,150,Filip Karlsson,26,Rögle,F,47,2,13,15,2,0,2,29,26,15,14,23,-9,12:30
,151,Sebastian Stålberg,17,Frölunda,F,51,10,4,14,8,2,0,72,28,28,20,10,10,12:27
,152,Marko Anttila,12,Örebro,F,49,8,6,14,28,1,0,92,94,12,18,17,1,12:11
,153,Lukas Bengtsson,32,Frölunda,D,30,7,7,14,12,2,2,43,8,21,25,8,17,18:31
,154,Terry Broadhurst,37,/,F,48,6,8,14,10,1,2,70,14,7,14,16,-2,12:04
,155,Brendan Mikkelson,27,Luleå,D,51,6,8,14,22,2,0,94,21,62,40,31,9,21:46
,156,Joey Crabb,15,/,F,41,5,9,14,62,2,0,50,64,18,25,23,2,15:57
,157,Jacob Larsson,4,Frölunda,D,47,5,9,14,10,0,1,58,16,31,35,24,11,16:35
,158,Jacob Blomqvist,44,Brynäs,F,52,4,10,14,24,1,0,71,32,19,16,25,-9,12:01
,159,Ville Viitaluoma,39,Örebro,F,51,3,11,14,16,0,1,63,18,11,23,21,2,13:22
,159,Daniel Rahimi,48,Linköping,D,51,3,11,14,84,0,0,67,132,47,33,29,4,19:49
,161,Calle Rosén,39,Växjö,D,52,3,11,14,4,1,0,62,5,20,25,23,2,11:21
,162,Ville Leino,23,Växjö,F,17,2,12,14,2,0,0,15,5,3,12,7,5,16:06
,163,Jonathan Sigalet,56,Luleå,D,46,2,12,14,22,0,1,49,79,50,36,34,2,22:54
,164,Martin Röymark,27,Färjestad,F,52,2,12,14,6,0,0,73,58,24,24,15,9,13:18
,165,Ville Varakas,8,Växjö,D,51,1,13,14,34,0,0,48,67,71,42,23,19,19:38
,166,Anton Bengtsson,28,HV71,F,50,7,6,13,14,0,0,65,75,24,25,26,-1,15:58
,167,Kyle Wilson,18,MODO,F,22,5,8,13,41,1,0,41,7,9,14,20,-6,16:56
,168,Rickard Wallin,51,Färjestad,F,49,4,9,13,28,0,0,51,18,28,18,17,1,13:03
,169,Linus Fröberg,71,Växjö,F,52,3,10,13,4,0,2,43,13,28,13,20,-7,11:29
,169,Oscar Hedman,41,MODO,D,52,3,10,13,12,0,1,46,25,49,30,37,-7,17:59
,171,Mathias Porseland,8,Brynäs,D,50,2,11,13,18,0,0,71,15,29,20,32,-12,13:47
,172,Anton Grundel,73,Karlskrona,D,37,1,12,13,14,0,1,50,26,23,21,36,-15,19:17
,173,Kristofer Berglund,2,HV71,D,40,1,12,13,10,0,0,45,39,54,25,23,2,19:31
,174,Teemu Laine,92,HV71,F,15,7,5,12,22,1,3,40,28,3,12,3,9,15:10
,175,Johan Forsberg,9,Luleå,F,52,7,5,12,12,1,0,49,29,21,20,12,8,13:32
,176,Jimmy Andersson,84,Karlskrona,F,50,6,6,12,14,2,1,64,40,15,13,29,-16,13:02
,177,Erik Josefsson,60,Växjö,F,52,6,6,12,12,1,0,48,18,32,23,25,-2,14:45
,177,Henrik Törnqvist,11,Linköping,F,52,6,6,12,10,0,0,67,48,25,12,19,-7,11:31
,179,Travis Turnbull,71,Färjestad,F,23,5,7,12,18,0,3,62,32,10,10,10,0,16:40
,180,Rasmus Asplund,74,Färjestad,F,46,4,8,12,16,0,0,41,23,14,21,11,10,13:40
,181,Karl Fabricius,52,Luleå,F,47,4,8,12,6,1,0,49,12,30,15,11,4,12:18
,182,Jere Karalahti,8,HV71,D,36,3,9,12,72,1,2,40,46,32,29,28,1,20:31
,183,Derek Meech,,Malmö,D,37,3,9,12,14,0,0,42,22,43,21,25,-4,19:41
,184,Eric Himelfarb,39,Malmö,F,38,2,10,12,20,1,0,46,28,18,19,23,-4,15:20
,184,Tomas Skogs,23,Färjestad,D,38,2,10,12,24,1,0,32,23,56,29,19,10,20:00
,186,Eric Martinsson,64,Växjö,D,50,2,10,12,57,0,0,54,11,36,24,25,-1,15:29
,187,Daniel Mannberg,79,Brynäs,F,42,7,4,11,20,1,0,63,17,20,22,12,10,14:07
,188,Christoffer Törngren,67,HV71,F,46,5,6,11,16,1,0,53,18,5,16,16,0,12:32
,189,Anders Eriksson,40,Örebro,F,49,5,6,11,28,1,0,52,54,34,20,22,-2,15:31
,190,Ilari Melart,11,Luleå,D,48,4,7,11,79,0,0,60,88,37,28,24,4,17:03
,191,Jan Sandström,7,Luleå,D,51,4,7,11,24,0,0,64,18,75,37,29,8,18:49
,192,Pär Arlbrandt,40,HV71,F,15,3,8,11,8,0,0,30,4,6,12,13,-1,17:01
,193,Toni Kähkönen,85,Karlskrona,F,46,0,11,11,16,0,0,48,23,31,27,29,-2,18:29
,194,Erik Andersson,2,Malmö,D,36,3,7,10,4,1,0,25,4,28,22,20,2,16:23
,195,Henrik Hetta,20,Malmö,F,40,3,7,10,31,0,2,71,65,34,19,23,-4,14:53
,196,Almen Bibic,3,Rögle,D,45,2,8,10,61,0,0,34,124,39,24,21,3,16:27
,197,Johan Ivarsson,7,Malmö,D,46,2,8,10,20,0,0,42,57,24,16,28,-12,12:06
,198,Emil Johansson,17,HV71,D,50,2,8,10,12,0,0,42,14,24,24,22,2,15:00
,199,Magnus Häggström,17,Malmö,F,51,2,8,10,8,0,0,51,30,34,11,20,-9,11:28
,200,Robin Gartner,2,Karlskrona,D,52,2,8,10,10,0,0,52,20,38,25,45,-20,18:34
,201,Shaun Heshka,26,MODO,D,50,1,9,10,14,0,0,36,27,52,33,36,-3,19:30
,202,Gustav Rydahl,15,Växjö,F,51,7,2,9,10,1,0,51,39,23,16,14,2,9:54
,203,Vilmos Gallo,55,Linköping,F,41,5,4,9,12,2,0,48,18,18,14,4,10,8:12
,204,Emil Lundberg,79,Djurgården,F,46,5,4,9,4,2,0,31,20,14,20,17,3,9:35
,205,Lucas Carlsson,23,Brynäs,D,35,4,5,9,8,0,1,36,18,19,16,20,-4,16:15
,206,Sondre Olden,23,Brynäs,F,37,4,5,9,4,1,0,43,14,3,12,12,0,6:29
,207,Daniel Sylwander,23,Rögle,F,47,4,5,9,22,1,0,84,58,26,15,14,1,13:34
,208,Teemu Laakso,2,Växjö,D,28,3,6,9,24,0,1,34,29,31,21,15,6,17:39
,209,Ivan Baranka,37,Rögle,D,40,3,6,9,20,1,2,55,30,29,22,38,-16,19:44
,210,Henrik Nilsson,27,Karlskrona,D,42,3,6,9,32,0,0,42,13,34,17,31,-14,17:08
,211,Bobbo Petersson,53,Örebro,D,37,2,7,9,10,0,1,22,21,34,24,20,4,13:42
,212,Mikael Wikstrand,6,Färjestad,D,17,1,8,9,6,0,0,26,2,19,14,7,7,23:18
,213,Fredrik Lindgren,61,Skellefteå,D,41,1,8,9,18,0,0,39,36,37,35,21,14,18:13
,214,Gabriel Carlsson,29,Linköping,D,45,1,8,9,2,0,0,39,6,19,21,17,4,11:59
,215,Viktor Ekbom,8,Örebro,D,48,1,8,9,16,1,0,51,37,92,35,33,2,19:46
,216,Axel Ottosson,18,MODO,F,49,1,8,9,12,1,0,49,17,11,12,19,-7,7:38
,217,Stefan Warg,6,Malmö,D,48,0,9,9,20,0,0,44,61,83,29,33,-4,19:25
,218,Antti Tyrväinen,89,Färjestad,F,19,5,3,8,22,1,0,27,30,4,11,8,3,14:42
,219,Kristoffer Söder,19,Karlskrona,F,52,5,3,8,10,0,0,29,19,18,15,29,-14,12:17
,220,Christopher Mastomäki,33,Luleå,F,47,4,4,8,12,1,0,46,14,24,18,6,12,10:44
,221,David Åslin,29,Rögle,F,50,4,4,8,18,0,2,33,49,9,13,16,-3,9:30
,221,Niklas Arell,42,Färjestad,D,50,4,4,8,22,0,0,39,34,46,30,23,7,15:33
,221,Anton Karlsson,47,Linköping,D,50,4,4,8,18,1,0,58,29,29,30,28,2,14:44
,224,Kristian Jakobsson,10,MODO,F,26,3,5,8,2,1,1,21,6,2,9,11,-2,8:42
,225,Erik Andersson,38,HV71,F,52,3,5,8,6,2,1,46,30,20,13,10,3,10:18
,226,Sebastian Ohlsson,72,Skellefteå,F,43,2,6,8,4,1,0,56,16,27,10,7,3,9:34
,227,Elias Fälth,33,Frölunda,D,47,2,6,8,40,1,0,77,35,33,33,24,9,17:40
,228,Pontus Petterström,18,Skellefteå,F,48,2,6,8,6,0,0,31,4,42,18,8,10,11:40
,229,Robin Norell,56,Djurgården,D,51,2,6,8,16,0,0,37,17,36,24,23,1,15:00
,230,Ilari Filppula,81,MODO,F,15,1,7,8,4,1,0,19,5,9,8,14,-6,17:32
,231,Petr Vrana,12,Brynäs,F,26,1,7,8,10,0,1,29,3,8,6,18,-12,14:27
,232,Carl Dahlström,32,Linköping,D,50,1,7,8,14,0,0,43,6,30,25,14,11,16:04
,232,Daniel Gunnarsson,16,/,D,50,1,7,8,14,0,1,51,10,28,12,18,-6,14:30
,234,Adam Brodecki,68,Brynäs,F,52,1,7,8,8,0,0,55,13,10,16,20,-4,10:44
,235,Marcus Oskarsson,7,Luleå,D,42,0,8,8,4,0,0,29,0,17,16,12,4,8:57
,236,Joonas Jalvanti,19,Örebro,D,49,0,8,8,6,0,0,33,14,41,32,32,0,17:56
,237,Peter Öberg,27,MODO,F,29,4,3,7,8,1,0,21,20,24,10,14,-4,12:02
,238,Arvid Lundberg,52,Skellefteå,D,46,4,3,7,4,2,0,48,20,32,28,17,11,14:36
,239,Sebastian Karlsson,12,Linköping,F,48,4,3,7,18,1,1,51,46,14,16,21,-5,14:58
,240,Mathias Tjärnqvist,71,Malmö,F,15,3,4,7,6,1,2,14,13,11,7,7,0,14:36
,241,Lennart Petrell,32,Luleå,F,32,3,4,7,8,0,0,31,58,19,12,12,0,10:37
,242,Johan Olofsson,8,Färjestad,F,40,3,4,7,6,2,0,32,13,13,11,8,3,8:41
,243,Mikael Ahlén,13,Djurgården,F,46,3,4,7,56,0,1,41,70,13,7,14,-7,9:52
,244,Christoffer Forsberg,23,Malmö,F,50,3,4,7,6,0,0,47,41,17,11,19,-8,11:11
,245,Alexander Wiklund,29,Karlskrona,F,52,3,4,7,22,0,0,49,57,26,12,34,-22,11:23
,246,Philip Holm,25,Djurgården,D,43,2,5,7,51,0,0,38,10,21,25,18,7,18:07
,247,Marcus Pettersson,8,Skellefteå,D,46,2,5,7,10,0,0,34,18,14,26,9,17,11:45
,248,Adam Burish,17,/,F,22,1,6,7,14,0,0,25,17,14,9,13,-4,13:30
,249,Tom Nilsson,43,Frölunda,D,37,1,6,7,34,0,0,22,31,32,28,19,9,16:34
,250,Johan Motin,57,Örebro,D,48,1,6,7,41,0,0,30,64,45,30,30,0,20:03
,251,Patrick Dwyer,17,MODO,F,33,0,7,7,6,0,0,42,44,17,12,22,-10,16:56
,252,Mattias Persson,90,Malmö,F,24,5,1,6,6,2,2,24,9,3,7,12,-5,10:24
,253,Felix Schütz,72,Rögle,F,11,4,2,6,0,1,1,21,1,3,6,9,-3,15:28
,254,Sakari Salminen,23,Växjö,F,12,4,2,6,6,1,1,33,3,0,6,6,0,16:56
,255,Bill Sweatt,96,Luleå,F,24,4,2,6,49,1,0,41,17,8,10,12,-2,14:35
,256,Anton Blomberg,21,Linköping,F,45,3,3,6,12,0,0,31,52,18,10,16,-6,9:08
,257,Ted Brithén,90,HV71,F,24,2,4,6,2,0,0,23,18,12,8,12,-4,14:23
,258,Henrik Löwdahl,15,Örebro,F,36,2,4,6,12,0,0,38,15,17,9,16,-7,10:26
,259,Andreas Englund,6,Djurgården,D,46,2,4,6,36,0,0,30,80,39,23,18,5,17:31
,260,Lawrence Pilut,20,HV71,D,21,1,5,6,4,0,0,24,3,16,17,12,5,20:31
,261,Oskar Steen,29,Färjestad,F,17,0,6,6,4,0,0,23,10,1,10,2,8,11:40
,262,Ole-Kristian Tollefsen,55,Färjestad,D,40,0,6,6,55,0,0,30,64,30,16,19,-3,14:19
,263,Alexander Urbom,55,Skellefteå,D,47,0,6,6,75,0,0,56,55,52,26,21,5,19:00
,263,Jörgen Sundqvist,22,Brynäs,D,47,0,6,6,20,0,0,36,52,55,21,28,-7,18:30
,265,Byron Ritchie,93,MODO,F,16,3,2,5,2,0,0,16,12,5,9,11,-2,14:26
,266,Johan Alcén,14,Brynäs,F,50,3,2,5,34,0,0,36,67,20,8,16,-8,9:53
,267,Ryan O´Byrne,44,HV71,D,28,2,3,5,78,0,0,24,26,19,10,13,-3,14:54
,268,Mattias Nörstebö,18,Brynäs,D,31,2,3,5,6,0,2,31,4,15,17,21,-4,16:03
,269,Niclas Lundgren,8,Växjö,D,35,2,3,5,2,0,0,24,2,27,21,18,3,15:02
,270,Joel Kwiatkowski,20,MODO,D,42,2,3,5,30,1,1,54,15,18,24,33,-9,17:34
,271,Peter Andersson,44,Örebro,D,44,2,3,5,18,0,0,37,28,43,22,20,2,12:39
,272,Timothy Liljegren,18,Rögle,D,19,1,4,5,4,0,1,15,4,8,4,11,-7,10:40
,273,Christoffer Persson,6,/,D,35,1,4,5,20,0,0,19,15,29,18,12,6,12:39
,274,Jens Hellgren,3,Rögle,D,36,1,4,5,6,0,0,23,26,34,14,18,-4,14:28
,275,Kevin Marshall,46,Rögle,D,50,1,4,5,72,0,0,62,56,35,31,31,0,19:08
,276,Christian Jaros,15,Luleå,D,25,0,5,5,45,0,0,32,31,14,16,10,6,14:40
,277,Albin Carlson,14,MODO,D,31,0,5,5,6,0,0,19,15,22,12,17,-5,14:10
,278,Oliver Bohm,3,/,D,35,0,5,5,2,0,0,25,12,41,20,23,-3,17:12
,279,Jesper Williamsson,34,Rögle,D,44,0,5,5,20,0,0,41,49,48,27,30,-3,17:54
,280,Eddie Larsson,53,Växjö,D,46,0,5,5,14,0,0,24,20,24,18,23,-5,15:48
,281,Jakub Petruzalek,88,Örebro,F,14,4,0,4,0,2,1,23,9,6,3,5,-2,15:09
,282,Mathias From,20,Rögle,F,16,2,2,4,0,2,0,14,2,0,5,5,0,7:15
,283,Dennis Persson,29,MODO,D,21,2,2,4,4,0,0,10,7,5,9,17,-8,10:02
,284,Mattias Granlund,20,Karlskrona,F,34,2,2,4,12,0,0,20,27,20,5,18,-13,8:34
,285,Viktor Lindgren,10,Rögle,F,50,2,2,4,6,0,0,35,15,19,8,17,-9,9:50
,286,Justin Hodgman,61,Örebro,F,11,1,3,4,2,0,0,14,7,4,5,11,-6,15:31
,287,Jesper Jensen,40,Rögle,F,17,1,3,4,2,0,0,15,10,13,3,8,-5,16:01
,288,Maksim Matushkin,52,Karlskrona,D,18,1,3,4,10,0,1,17,4,11,10,17,-7,14:57
,289,Adam Ollas Mattsson,73,Djurgården,D,22,1,3,4,2,0,0,13,11,8,8,5,3,8:40
,290,Alen Bibic,5,Rögle,D,26,1,3,4,47,0,0,21,49,19,15,14,1,14:07
,291,Tobias Hage,24,Djurgården,F,31,1,3,4,8,0,0,34,11,16,5,9,-4,11:58
,292,Oliver Lauridsen,25,Frölunda,D,42,1,3,4,67,1,0,36,59,39,24,18,6,14:52
,293,Nicklas Jadeland,55,Malmö,F,46,1,3,4,12,0,0,28,71,17,7,18,-11,8:16
,294,Otso Rantakari,6,MODO,D,17,0,4,4,2,0,0,23,7,8,7,11,-4,13:31
,295,Johan Adolfsson,15,Örebro,F,19,0,4,4,6,0,0,15,13,13,5,6,-1,10:37
,296,Anton Lindholm,54,Skellefteå,D,30,0,4,4,18,0,0,26,85,26,10,7,3,16:02
,297,Nichlas Torp,38,MODO,D,33,0,4,4,28,0,0,31,48,31,16,23,-7,14:52
,298,Vyacheslav Trukhno,9,Karlskrona,F,38,0,4,4,16,0,0,21,24,13,7,12,-5,10:04
,299,Björn Melin,9,HV71,F,9,2,1,3,2,0,1,16,6,2,3,5,-2,12:47
,300,Kelsey Tessier,90,Rögle,F,10,2,1,3,0,0,0,6,4,0,3,3,0,9:04
,300,Erik Brissle,65,Linköping,F,10,2,1,3,2,0,0,9,1,2,5,6,-1,9:21
,302,Emil Kristensen,28,Rögle,D,13,2,1,3,0,0,1,17,2,5,6,10,-4,13:00
,303,Jesper Lindgren,3,MODO,D,26,2,1,3,4,0,2,11,8,11,8,16,-8,11:19
,304,Sebastian Enterfeldt,59,Brynäs,F,29,2,1,3,8,0,2,40,46,10,7,16,-9,15:21
,305,Andreas Wingerli,24,Skellefteå,F,38,2,1,3,4,0,0,14,17,12,7,10,-3,8:02
,306,Fredrik Händemark,63,Malmö,F,23,1,2,3,8,0,1,32,15,16,8,17,-9,16:57
,307,Ludvig Nilsson,41,MODO,F,47,1,2,3,10,0,0,20,26,18,9,16,-7,9:17
,308,Robin Press,8,Djurgården,D,51,1,2,3,12,0,1,58,2,17,13,19,-6,10:20
,309,Fredric Andersson,13,Linköping,F,27,0,3,3,10,0,0,25,25,7,6,6,0,11:45
,310,Alexander Falk,41,Djurgården,D,46,0,3,3,20,0,0,41,51,20,19,29,-10,15:42
,311,Jeremias Augustin,22,Malmö,D,48,0,3,3,22,0,0,14,47,37,8,20,-12,11:24
,312,Victor Laz,89,Rögle,F,1,1,1,2,0,0,0,4,2,0,2,0,2,12:44
,313,Kalle Jellvert,42,Örebro,F,7,1,1,2,2,0,0,5,4,3,3,0,3,8:26
,314,Tim Wahlgren,50,MODO,F,10,1,1,2,0,0,0,5,3,1,2,1,1,4:40
,315,Kristian Vesalainen,78,Frölunda,F,19,1,1,2,0,0,0,5,5,8,4,1,3,7:33
,316,Alexander Lunsjö,21,Rögle,F,22,1,1,2,2,1,0,12,11,6,3,7,-4,6:47
,317,Kevin Stenlund,82,HV71,F,43,1,1,2,20,0,0,26,11,9,6,12,-6,8:27
,318,Robin Persson,11,Karlskrona,D,46,1,1,2,28,0,0,24,29,35,16,36,-20,17:36
,319,Henrik Eriksson,17,Djurgården,F,52,1,1,2,16,0,0,64,91,21,7,22,-15,13:29
,320,Per Savilahti-Nagander,,Luleå,D,14,0,2,2,4,0,0,12,4,13,7,6,1,11:46
,321,Anton Karlsson,27,Frölunda,F,19,0,2,2,2,0,0,4,16,1,4,1,3,4:37
,322,Victor Aronsson,7,Karlskrona,D,26,0,2,2,4,0,0,3,5,10,5,9,-4,7:46
,323,Ludvig Claesson,4,Rögle,D,33,0,2,2,18,0,0,21,9,31,9,18,-9,13:04
,324,Christoffer Ehn,21,Frölunda,F,37,0,2,2,2,0,0,27,9,3,4,8,-4,5:50
,325,Alexander Hellström,7,Örebro,D,49,0,2,2,67,0,0,31,133,67,24,17,7,15:25
,326,Markus Svensson,35,Skellefteå,Gk,50,0,2,2,2,0,0,0,0,0,78,49,29,0:00
,326,Bernhard Starkbaum,29,Brynäs,Gk,50,0,2,2,2,0,0,0,0,0,48,52,-4,0:00
,328,Mantas Armalis,50,Djurgården,Gk,52,0,2,2,4,0,0,0,0,0,69,54,15,0:00
,329,Marcus Davidsson,9,Djurgården,F,1,1,0,1,0,0,0,1,0,1,1,0,1,5:40
,330,Alexander Anderberg,69,Örebro,D,4,1,0,1,0,0,0,1,0,1,1,0,1,2:19
,330,Juha-Pekka Haataja,72,MODO,F,4,1,0,1,0,0,0,4,1,1,2,3,-1,10:06
,330,Linus Lindström,16,Skellefteå,F,4,1,0,1,0,0,0,4,2,0,1,0,1,5:42
,333,Erik Santesson,24,Rögle,F,5,1,0,1,0,0,0,1,1,0,1,1,0,2:01
,334,Victor Ejdsell,14,Färjestad,F,9,1,0,1,0,0,0,9,7,0,1,3,-2,5:40
,334,David Westlund,2,Karlskrona,D,9,1,0,1,4,0,0,6,2,3,4,7,-3,7:43
,336,Anton Öhman,36,Skellefteå,D,10,1,0,1,0,1,0,4,1,3,2,3,-1,4:34
,336,Daniel Bernhardt,21,Djurgården,F,10,1,0,1,0,0,0,5,0,0,1,2,-1,3:21
,338,Emil Eriksson,69,Örebro,F,14,1,0,1,0,0,0,5,2,4,3,3,0,5:57
,339,Ludvig Elvenes,25,Rögle,F,16,1,0,1,0,0,0,5,4,1,3,7,-4,5:19
,340,August Gunnarsson,51,Färjestad,F,18,1,0,1,0,0,0,2,2,0,2,2,0,2:33
,341,Johan Persson,10,Färjestad,F,22,1,0,1,0,0,0,13,2,0,2,1,1,4:23
,342,Axel Eidstedt,49,HV71,D,41,1,0,1,34,1,0,18,12,26,8,12,-4,12:58
,343,Anton Danielsson,5,Skellefteå,D,1,0,1,1,0,0,0,2,2,0,1,1,0,7:15
,344,Robin Kovacs,96,Rögle,F,4,0,1,1,0,0,0,6,4,3,1,8,-7,13:14
,345,Pontus Widerström,67,Frölunda,F,7,0,1,1,2,0,0,0,4,1,1,0,1,6:30
,346,Jesper Boqvist,90,Brynäs,F,8,0,1,1,2,0,0,6,1,1,2,0,2,10:06
,347,Victor Ekarv,55,Luleå,F,12,0,1,1,0,0,0,6,1,2,2,1,1,4:54
,348,John Dahlström,22,Frölunda,F,13,0,1,1,0,0,0,5,0,3,1,4,-3,3:07
,349,Mikael Johansson,95,Växjö,F,15,0,1,1,2,0,0,5,1,3,1,4,-3,5:24
,349,Alex Aleardi,24,Rögle,F,15,0,1,1,2,0,0,6,6,5,5,5,0,4:52
,351,Anton Axelsson,6,Frölunda,F,19,0,1,1,0,0,0,14,6,5,2,3,-1,8:49
,352,Johan Holmqvist,40,Karlskrona,Gk,22,0,1,1,0,0,0,0,0,0,32,42,-10,0:00
,353,Linus Ölund,36,Brynäs,F,23,0,1,1,0,0,0,8,0,2,1,6,-5,4:43
,354,Tom Linder,55,Karlskrona,D,27,0,1,1,0,0,0,8,8,15,3,12,-9,11:40
,355,Erik Ersberg,40,HV71,Gk,39,0,1,1,0,0,0,0,0,0,23,28,-5,0:00
,356,Kim Rosdahl,96,Malmö,F,40,0,1,1,58,0,0,46,89,29,8,25,-17,11:34
,357,Felix Sandström,25,Brynäs,Gk,46,0,1,1,0,0,0,0,0,0,47,53,-6,0:00
,358,Julius Hudacek,33,Örebro,Gk,47,0,1,1,26,0,0,0,0,0,93,82,11,0:00
,359,Erik Hanses,34,Skellefteå,Gk,48,0,1,1,0,0,0,0,0,0,29,18,11,0:00
,360,Jonas Gunnarsson,37,Malmö,Gk,50,0,1,1,2,0,0,0,0,0,67,86,-19,0:00
,360,Linus Fernström,39,Karlskrona,Gk,50,0,1,1,0,0,0,0,0,0,33,61,-28,0:00
,362,Stefan Steen,26,Växjö,Gk,51,0,1,1,0,0,0,0,0,0,40,22,18,0:00
,362,Fredrik Pettersson-Wentzel,53,HV71,Gk,51,0,1,1,0,0,0,0,0,0,76,73,3,0:00
,362,Justin Pogge,49,Färjestad,Gk,51,0,1,1,4,0,0,0,0,0,41,37,4,0:00
,362,Lars Johansson,1,Frölunda,Gk,51,0,1,1,0,0,0,0,0,0,80,40,40,0:00
,366,Lars Volden,31,Rögle,Gk,52,0,1,1,0,0,0,0,0,0,25,43,-18,0:00
,366,Adam Reideborn,39,MODO,Gk,52,0,1,1,0,0,0,0,0,0,60,72,-12,0:00
,366,Johan Gustafsson,37,Frölunda,Gk,52,0,1,1,0,0,0,0,0,0,38,36,2,0:00
,369,Jonas Fransson,32,HV71,Gk,1,0,0,0,0,0,0,0,0,0,0,0,0,0:00
,369,Adam Werner,35,Färjestad,Gk,1,0,0,0,0,0,0,0,0,0,0,0,0,0:00
,369,Michael Haga,85,Djurgården,F,1,0,0,0,0,0,0,1,0,0,0,0,0,11:16
,369,Tim Sandberg,31,Karlskrona,Gk,1,0,0,0,0,0,0,0,0,0,0,0,0,0:00
,369,Hampus Alexandersson,,Linköping,Gk,1,0,0,0,0,0,0,0,0,0,0,0,0,0:00
,369,Tony Pappila,8,Rögle,F,1,0,0,0,0,0,0,0,0,0,0,0,0,0:57
,369,Marcus Sylvegård,18,Malmö,F,1,0,0,0,0,0,0,0,0,0,0,0,0,2:02
,369,Magnus Molge,17,Malmö,F,1,0,0,0,0,0,0,0,3,4,0,2,-2,9:01
,369,Simon Lööf,12,Karlskrona,D,1,0,0,0,0,0,0,0,0,0,0,0,0,0:00
,369,Rupert Swärd,1,Växjö,Gk,1,0,0,0,0,0,0,0,0,0,0,0,0,0:00
,369,Marcus Jörgensen,38,Rögle,D,1,0,0,0,0,0,0,1,0,1,1,0,1,12:30
,369,Hampus Eriksson,28,Brynäs,F,1,0,0,0,0,0,0,0,0,0,0,0,0,0:00
,369,Simon Ryfors,15,Rögle,F,1,0,0,0,0,0,0,0,0,0,0,0,0,8:32
,369,Hugo Enock,23,Färjestad,D,1,0,0,0,0,0,0,1,2,2,0,0,0,13:58
,369,Morten Jensen,33,Rögle,D,1,0,0,0,0,0,0,0,1,0,2,0,2,10:32
,369,Hugo Danielsson,7,Skellefteå,D,1,0,0,0,0,0,0,0,1,1,0,0,0,9:18
,369,Jonathan Stålberg,50,Skellefteå,Gk,1,0,0,0,0,0,0,0,0,0,0,0,0,0:00
,369,Jesper Emanuelsson,43,Frölunda,F,1,0,0,0,0,0,0,0,0,0,0,0,0,0:23
,369,Fabian Zetterlund,28,Färjestad,F,1,0,0,0,0,0,0,0,0,0,0,0,0,5:22
,369,David Sätmark,17,Malmö,D,1,0,0,0,0,0,0,0,0,0,0,0,0,0:00
,369,Albin Enqvist,38,Luleå,Gk,1,0,0,0,0,0,0,0,0,0,0,0,0,0:00
,369,Joren Van Pottelberghe,35,Linköping,Gk,1,0,0,0,0,0,0,0,0,0,0,0,0,0:00
,369,Oscar Nord,62,Malmö,F,1,0,0,0,0,0,0,0,0,0,0,0,0,0:00
,369,Jesper Eriksson,,Skellefteå,Gk,1,0,0,0,0,0,0,0,0,0,0,0,0,0:00
,369,Oskar Stål-Lyrenäs,71,MODO,F,1,0,0,0,0,0,0,0,0,0,0,0,0,0:00
,369,Victor Brattström,1,Frölunda,Gk,1,0,0,0,0,0,0,0,0,0,0,0,0,0:00
,369,Oliver Horrsell,37,Linköping,D,1,0,0,0,0,0,0,0,0,0,0,0,0,0:00
,369,Oscar Fröberg,1,Örebro,Gk,1,0,0,0,0,0,0,0,0,0,0,0,0,0:00
,369,Axel Lindström,19,Karlskrona,F,1,0,0,0,0,0,0,3,0,0,0,0,0,9:11
,369,Alexander Leandersson,4,Färjestad,D,1,0,0,0,0,0,0,0,0,0,0,0,0,0:00
,369,Casper Andersson,33,Malmö,F,1,0,0,0,0,0,0,1,0,0,0,0,0,12:31
,369,Markus Nygren,,Djurgården,F,1,0,0,0,0,0,0,0,0,0,0,0,0,0:00
,369,Jesper Juntto,36,Luleå,F,1,0,0,0,0,0,0,0,0,0,0,0,0,2:58
,369,Carl Ernstig,5,Växjö,D,1,0,0,0,0,0,0,0,0,0,0,0,0,0:00
,369,Linus Weissbach,41,Frölunda,F,1,0,0,0,0,0,0,0,0,0,0,0,0,3:19
,369,Jacob Lundegård,66,Karlskrona,D,1,0,0,0,0,0,0,0,0,0,0,0,0,0:00
,369,Simon Hellholm,35,Linköping,F,1,0,0,0,0,0,0,0,0,0,0,0,0,0:00
,406,Isak Stenlund-Ädelgran,,Skellefteå,F,2,0,0,0,0,0,0,0,1,0,0,0,0,4:56
,406,Jakob Olsson,,Frölunda,F,2,0,0,0,0,0,0,0,0,0,0,0,0,0:00
,406,Oscar Karlsson,,Linköping,D,2,0,0,0,0,0,0,0,0,1,0,0,0,4:12
,406,Simon Morberg,,Frölunda,F,2,0,0,0,0,0,0,0,0,0,0,0,0,1:24
,406,Erik Borg,26,Frölunda,F,2,0,0,0,0,0,0,0,0,0,0,0,0,0:00
,406,Lukas Enqvist,39,Färjestad,F,2,0,0,0,0,0,0,0,0,1,0,0,0,2:08
,406,Ryan Whitney,19,MODO,D,2,0,0,0,0,0,0,0,0,3,0,4,-4,16:14
,406,Joseph Jonsson,39,HV71,F,2,0,0,0,0,0,0,0,0,0,0,0,0,2:34
,406,Glenn Gustafsson,37,Örebro,F,2,0,0,0,0,0,0,0,1,0,0,0,0,6:28
,406,Oliver Olsson,3,Malmö,F,2,0,0,0,0,0,0,1,0,0,0,1,-1,6:20
,406,Jesper Mångs,53,Malmö,D,2,0,0,0,0,0,0,1,0,1,1,0,1,5:45
,406,Samuel Ward,99,Luleå,Gk,2,0,0,0,0,0,0,0,0,0,4,4,0,0:00
,406,Linus Högberg,6,Växjö,D,2,0,0,0,0,0,0,0,0,2,0,1,-1,2:46
,406,Emil Larsson,27,Örebro,F,2,0,0,0,0,0,0,0,0,0,0,0,0,0:00
,420,Philip Alftberg,3,Brynäs,D,3,0,0,0,0,0,0,0,0,0,0,0,0,0:00
,420,Jesper Ylivainio,38,Luleå,F,3,0,0,0,0,0,0,0,0,0,0,0,0,1:22
,420,Albin Runesson,55,MODO,D,3,0,0,0,0,0,0,1,2,2,4,5,-1,14:24
,420,Erik Ullman,52,MODO,D,3,0,0,0,0,0,0,1,1,0,2,0,2,6:51
,420,Filip Ternbom,1,Rögle,Gk,3,0,0,0,0,0,0,0,0,0,0,0,0,0:00
,420,Anton Byström,,MODO,F,3,0,0,0,0,0,0,0,0,0,0,0,0,4:33
,420,Erik Brännström,26,HV71,D,3,0,0,0,0,0,0,0,0,0,0,1,-1,0:47
,420,Oscar Possler,58,MODO,F,3,0,0,0,0,0,0,0,0,0,0,1,-1,1:58
,420,Erik Lundblad,98,Malmö,D,3,0,0,0,0,0,0,0,0,0,1,0,1,0:48
,420,Arvid Aronsson,55,Frölunda,D,3,0,0,0,0,0,0,0,1,1,0,0,0,0:57
,430,Andreas Röykås Marthinsen,,Djurgården,D,4,0,0,0,0,0,0,0,1,0,0,0,0,1:13
,430,Martin Naenfeldt,28,Brynäs,F,4,0,0,0,0,0,0,0,0,0,0,0,0,2:04
,430,Jonas Johansson,25,Brynäs,Gk,4,0,0,0,0,0,0,0,0,0,0,0,0,0:00
,430,Emil Hedman,30,MODO,Gk,4,0,0,0,0,0,0,0,0,0,0,0,0,0:00
,430,John Morelius,30,Brynäs,D,4,0,0,0,0,0,0,0,0,0,0,0,0,0:00
,430,Martin Fehervary,5,Malmö,D,4,0,0,0,0,0,0,0,4,0,0,1,-1,3:32
,430,Jacob Moverare,3,HV71,D,4,0,0,0,0,0,0,0,0,0,2,2,0,3:58
,430,Isac Lundeström,37,Luleå,F,4,0,0,0,0,0,0,0,1,1,0,1,-1,3:33
,430,Johan Backlund,26,Skellefteå,Gk,4,0,0,0,0,0,0,0,0,0,2,2,0,0:00
,430,Alexander Fällström,14,Djurgården,F,4,0,0,0,0,0,0,7,7,1,1,2,-1,13:48
,430,Rasmus Bengtsson,27,Rögle,D,4,0,0,0,0,0,0,5,0,4,1,2,-1,14:32
,430,Filip Lennström,56,Malmö,F,4,0,0,0,0,0,0,0,0,0,0,0,0,2:30
,442,Mattias Elfström,20,Malmö,F,5,0,0,0,2,0,0,1,1,1,0,0,0,6:06
,442,Simon Bertilsson,15,Brynäs,D,5,0,0,0,4,0,0,5,10,10,2,4,-2,16:56
,442,Jens Lööke,,Brynäs,F,5,0,0,0,2,0,0,3,6,0,1,1,0,6:08
,442,Stefan Johansson,16,Örebro,D,5,0,0,0,2,0,0,1,2,1,0,2,-2,6:00
,442,Carl-Johan Lerby,14,Malmö,D,5,0,0,0,0,0,0,1,0,1,0,2,-2,5:29
,442,Thomas Lillie,,Växjö,Gk,5,0,0,0,0,0,0,0,0,0,0,0,0,0:00
,442,Nicklas Heinerö,10,Djurgården,F,5,0,0,0,0,0,0,0,0,0,0,0,0,0:14
,442,Filip Berglund,6,Skellefteå,D,5,0,0,0,0,0,0,3,0,3,1,0,1,10:00
,450,Daniel Marmenlind,50,Örebro,Gk,6,0,0,0,0,0,0,0,0,0,0,2,-2,0:00
,450,John Nyberg,8,Frölunda,D,6,0,0,0,2,0,0,4,0,2,0,1,-1,9:17
,450,Viktor Andersson,35,Karlskrona,Gk,6,0,0,0,0,0,0,0,0,0,0,0,0,0:00
,453,Anton Toolanen,14,Luleå,F,7,0,0,0,0,0,0,4,0,2,0,2,-2,4:27
,453,Daniel Håkansson,27,Linköping,F,7,0,0,0,0,0,0,0,0,0,0,0,0,0:28
,453,Johan Lindholm,62,MODO,F,7,0,0,0,0,0,0,2,0,0,1,1,0,2:24
,453,Calle Krantz,,Linköping,D,7,0,0,0,0,0,0,2,1,0,0,4,-4,9:22
,457,Tim Hultstrand,60,Malmö,Gk,8,0,0,0,0,0,0,0,0,0,0,0,0,0:00
,457,Tim Söderlund,9,Skellefteå,F,8,0,0,0,2,0,0,5,8,0,0,2,-2,5:33
,457,Petter Hansson,18,Linköping,D,8,0,0,0,0,0,0,3,4,2,3,2,1,10:04
,460,Adam Byström Johansson,87,Växjö,F,9,0,0,0,0,0,0,5,5,1,0,1,-1,2:36
,460,Oscar Masiello,31,Luleå,Gk,9,0,0,0,0,0,0,0,0,0,0,0,0,0:00
,460,Jacob Cederholm,3,HV71,D,9,0,0,0,0,0,0,3,2,10,0,5,-5,8:24
,460,Robin Jensen,35,Djurgården,Gk,9,0,0,0,0,0,0,0,0,0,0,0,0,0:00
,464,Oscar Alsenfelt,69,Malmö,Gk,10,0,0,0,0,0,0,0,0,0,16,13,3,0:00
,464,Linus Nässén,25,Luleå,D,10,0,0,0,0,0,0,0,1,0,0,0,0,0:56
,466,Gustav Ahnelöv,13,Karlskrona,D,11,0,0,0,0,0,0,2,2,5,3,8,-5,9:36
,466,Malte Sjögren,3,Malmö,F,11,0,0,0,0,0,0,1,4,3,0,3,-3,4:20
,466,Filip Lestan,,HV71,F,11,0,0,0,8,0,0,1,18,1,0,3,-3,5:06
,466,Albin Storm,15,Växjö,F,11,0,0,0,2,0,0,1,2,1,0,2,-2,2:02
,466,Wilhelm Westlund,28,Djurgården,D,11,0,0,0,4,0,0,3,0,1,0,1,-1,5:29
,466,Albin Lundin,25,Djurgården,F,11,0,0,0,2,0,0,8,4,0,1,3,-2,6:14
,472,Jonathan Davidsson,71,Djurgården,F,12,0,0,0,2,0,0,3,5,5,1,2,-1,2:43
,472,Mika Noronen,1,Malmö,Gk,12,0,0,0,0,0,0,0,0,0,0,3,-3,0:00
,474,Alexander Johansson,,HV71,Gk,13,0,0,0,0,0,0,0,0,0,0,0,0,0:00
,474,Kristoffer Gunnarsson,14,Frölunda,D,13,0,0,0,0,0,0,3,20,11,4,5,-1,8:12
,476,Fredrik Forsberg,12,Djurgården,F,14,0,0,0,0,0,0,10,14,3,1,2,-1,4:41
,477,Marcus Ersson,10,Brynäs,D,16,0,0,0,6,0,0,5,8,6,0,2,-2,6:04
,478,Filip Ahl,93,HV71,F,17,0,0,0,0,0,0,4,4,2,0,1,-1,2:36
,478,Philip Rondahl,24,Linköping,D,17,0,0,0,0,0,0,1,1,0,0,0,0,1:33
,480,Johan Björk,55,Malmö,D,19,0,0,0,2,0,0,6,7,18,3,9,-6,10:29
,481,Filip Gustavsson,30,Luleå,Gk,20,0,0,0,0,0,0,0,0,0,16,9,7,0:00
,482,Lias Andersson,23,HV71,F,22,0,0,0,6,0,0,14,10,2,1,8,-7,5:14
,483,Pontus Sjögren,87,Malmö,Gk,24,0,0,0,0,0,0,0,0,0,3,7,-4,0:00
,483,Robin Söderqvist,63,Växjö,F,24,0,0,0,0,0,0,4,5,1,1,3,-2,4:42
,485,Pontus Själin,39,Luleå,D,25,0,0,0,2,0,0,4,1,8,2,4,-2,6:43
,485,Patrick Galbraith,31,Karlskrona,Gk,25,0,0,0,25,0,0,0,0,0,11,28,-17,0:00
,485,Jesper Nordin,5,Färjestad,D,25,0,0,0,2,0,0,6,1,3,0,3,-3,2:49
,488,David Rundqvist,29,/,F,27,0,0,0,6,0,0,18,7,8,3,11,-8,9:31
,489,Daniel Larsson,,Luleå,Gk,32,0,0,0,0,0,0,0,0,0,17,23,-6,0:00
,490,Joel Lassinantti,34,Luleå,Gk,40,0,0,0,0,0,0,0,0,0,71,51,20,0:00
,491,Mikael Tellqvist,32,Djurgården,Gk,43,0,0,0,0,0,0,0,0,0,35,34,1,0:00
,492,Cristopher Nihlstorp,41,Växjö,Gk,47,0,0,0,4,0,0,0,0,0,78,74,4,0:00
,493,Jonatan Bjurö,41,MODO,Gk,48,0,0,0,0,0,0,0,0,0,38,54,-16,0:00
,494,Oscar Dansk,35,Rögle,Gk,49,0,0,0,2,0,0,0,0,0,68,69,-1,0:00
,495,Henrik Lundberg,1,Örebro,Gk,50,0,0,0,0,0,0,0,0,0,15,25,-10,0:00
,496,David Rautio,30,Linköping,Gk,52,0,0,0,0,0,0,0,0,0,60,41,19,0:00
,496,Lars Haugen,30,Färjestad,Gk,52,0,0,0,2,0,0,0,0,0,58,52,6,0:00
,496,Marcus Högberg,1,Linköping,Gk,52,0,0,0,4,0,0,0,0,0,62,46,16,0:00
,1,Derek Ryan,10,Örebro,F,55,15,45,60,18,1,3,131,6,39,53,35,18,18:25
,2,Jeff Taffe,20,Linköping,F,54,18,41,59,43,1,6,124,48,18,47,35,12,18:02
,3,Broc Little,41,Linköping,F,55,28,19,47,38,5,6,153,8,19,48,34,14,17:45
,4,Jacob Micflikier,7,Linköping,F,54,24,23,47,26,5,3,149,24,25,44,31,13,17:51
,5,Martin Johansson,25,Örebro,F,54,24,22,46,10,8,7,106,24,13,49,31,18,17:33
,6,Mathis Olimb,46,Frölunda,F,51,7,39,46,65,2,2,79,3,4,38,19,19,16:36
,7,Robert Rosén,87,Växjö,F,53,23,21,44,16,6,4,151,15,29,48,21,27,17:40
,8,Erik Christensen,24,HV71,F,46,13,31,44,14,3,3,108,21,4,34,27,7,18:16
,9,Greg Scott,41,Brynäs,F,47,18,24,42,20,2,7,109,51,21,37,33,4,19:11
,10,Bill Sweatt,96,Brynäs,F,54,19,22,41,36,2,7,142,79,28,38,35,3,19:10
,11,Milan Gulas,44,Färjestad,F,53,20,20,40,26,5,4,162,66,14,31,29,2,18:13
,12,Anton Rödin,18,Brynäs,F,54,19,21,40,32,2,4,113,40,24,35,38,-3,18:34
,13,Cory Murphy,,Växjö,D,55,9,30,39,18,1,4,154,23,54,54,33,21,21:33
,14,Nick Johnson,32,Växjö,F,55,17,21,38,14,5,4,126,8,15,53,23,30,17:34
,15,Johan Ryno,61,Leksand,F,49,14,24,38,36,2,4,123,51,21,27,48,-21,18:45
,16,Tim Heed,4,Skellefteå,D,50,10,27,37,10,3,5,131,10,25,37,21,16,18:43
,17,Tomi Sallinen,51,Leksand,F,54,19,17,36,4,4,8,149,54,19,33,46,-13,21:59
,18,Tuomas Kiiskinen,19,Växjö,F,46,17,19,36,8,1,3,80,21,19,42,15,27,16:39
,19,Mattias Janmark,10,Frölunda,F,55,13,23,36,30,1,2,103,9,23,36,27,9,17:17
,20,Mattias Ritola,21,/,F,52,12,24,36,28,2,2,112,63,33,38,46,-8,18:40
,21,Andreas Johnson,88,Frölunda,F,55,22,13,35,34,9,6,153,30,12,29,24,5,16:01
,22,Per Åslund,22,Färjestad,F,52,16,19,35,18,4,4,93,22,25,37,24,13,16:54
,23,Andrew Calof,18,Skellefteå,F,53,16,19,35,18,3,0,118,6,12,39,22,17,13:37
,24,Erik Forssell,20,Skellefteå,F,52,15,20,35,10,3,6,89,2,39,31,17,14,16:40
,25,Patrik Zackrisson,26,Skellefteå,F,52,10,25,35,20,3,2,61,28,29,36,23,13,17:06
,26,Linus Hultström,33,/,D,53,10,23,33,20,1,3,130,36,43,39,50,-11,20:14
,27,Marcus Sörensen,66,Djurgården,F,50,17,15,32,30,5,2,120,30,4,26,29,-3,18:05
,28,Liam Reddox,85,Växjö,F,55,21,10,31,6,7,3,134,40,24,36,26,10,16:16
,29,Robin Figren,23,Frölunda,F,49,16,15,31,26,3,7,140,25,16,35,19,16,16:15
,30,Jonas Junland,44,Linköping,D,55,9,22,31,32,2,3,152,19,79,44,30,14,23:49
,31,Calle Ridderwall,81,HV71,F,54,17,13,30,22,4,6,131,46,28,25,27,-2,18:51
,32,Ted Brithén,90,HV71,F,44,15,15,30,10,6,5,99,24,36,30,24,6,18:53
,33,Chris Abbott,29,Luleå,F,52,13,17,30,50,4,1,70,34,23,34,31,3,17:42
,34,Daniel Viksten,13,Örebro,F,43,14,15,29,4,6,3,92,11,7,30,22,8,15:46
,35,Kirill Kabanov,7,Skellefteå,F,43,11,18,29,20,2,2,101,11,15,30,10,20,14:40
,36,Kristian Näkyvä,51,Luleå,D,55,10,19,29,42,3,2,118,19,42,44,39,5,22:10
,37,Erik Gustafsson,56,Frölunda,D,55,4,25,29,22,0,1,131,44,19,33,31,2,19:15
,38,Max Görtz,17,Frölunda,F,53,14,14,28,6,5,4,115,8,21,28,20,8,14:08
,39,Cam Abbott,24,Luleå,F,50,11,17,28,42,1,1,82,26,11,29,28,1,15:36
,40,Noah Welch,5,Växjö,D,52,5,23,28,100,1,1,124,81,50,45,26,19,21:46
,41,Toni Rajala,10,Färjestad,F,31,14,13,27,12,4,4,102,11,9,25,20,5,17:58
,42,Ville Viitaluoma,39,Örebro,F,55,10,17,27,22,2,2,77,15,9,26,21,5,15:21
,43,Daniel Zaar,72,Luleå,F,55,9,18,27,18,1,3,147,39,8,29,33,-4,14:52
,44,Markus Ljungh,16,Djurgården,F,54,8,19,27,12,1,2,83,21,29,30,31,-1,18:02
,45,Janne Pesonen,22,Skellefteå,F,20,16,10,26,14,3,6,65,16,6,21,17,4,17:51
,46,Pär Lindholm,17,Skellefteå,F,54,14,12,26,55,0,1,79,28,23,39,24,15,14:47
,47,Mikael Samuelsson,37,Djurgården,F,37,13,13,26,34,4,5,115,29,6,18,21,-3,17:52
,48,Mattias Sjögren,11,Linköping,F,43,9,17,26,30,4,3,59,54,16,26,22,4,16:40
,49,Per-Åge Skröder,10,MODO,F,51,14,11,25,49,1,1,102,43,20,32,37,-5,17:18
,50,Tomi Kallio,71,Växjö,F,51,8,17,25,16,1,1,125,27,9,28,24,4,15:33
,51,Joakim Eriksson,10,Djurgården,F,53,7,18,25,32,2,4,77,7,36,20,39,-19,20:25
,52,Jakub Vrana,13,Linköping,F,44,12,12,24,12,2,2,108,7,13,27,24,3,14:58
,53,Teemu Laine,92,HV71,F,50,11,13,24,94,0,4,102,66,7,26,31,-5,16:30
,54,Elias Fälth,33,Frölunda,D,50,8,16,24,32,1,4,99,25,30,38,27,11,19:56
,55,Jared Aulin,18,Örebro,F,47,7,17,24,6,0,1,73,22,17,23,21,2,15:12
,56,Mattias Karlsson,20,HV71,D,54,3,21,24,14,0,0,106,62,55,43,29,14,20:57
,57,Nichlas Hardt,43,Linköping,F,47,8,15,23,18,2,3,93,73,22,28,18,10,15:32
,58,Marcus Weinstock,20,Örebro,F,55,8,15,23,20,1,3,73,22,14,22,17,5,13:42
,59,Anssi Salmela,14,Färjestad,D,42,6,17,23,28,0,3,125,28,47,27,23,4,0:03
,60,Toni Kähkönen,85,Leksand,F,47,6,17,23,4,0,0,84,59,35,25,32,-7,19:03
,61,Jens Bergenström,32,Leksand,F,53,15,7,22,10,4,5,127,6,36,26,44,-18,15:43
,62,Simon Önerud,11,MODO,F,54,15,7,22,8,1,1,146,27,46,26,35,-9,18:28
,63,Patrik Lundh,79,Växjö,F,53,9,13,22,26,0,0,87,30,13,28,21,7,16:17
,64,Adam Pettersson,12,Skellefteå,F,53,8,14,22,18,1,0,70,24,17,29,16,13,13:24
,65,Jonas Nordquist,39,Brynäs,F,53,6,16,22,8,0,5,66,6,31,21,30,-9,16:44
,66,Joakim Hillding,24,Färjestad,F,44,5,17,22,18,0,4,74,18,14,21,23,-2,15:25
,67,Niclas Andersén,9,Brynäs,D,54,5,17,22,32,1,1,64,31,98,50,47,3,22:57
,68,Joel Lundqvist,20,Frölunda,F,55,5,17,22,18,1,2,56,80,23,21,31,-10,17:08
,69,Chris Campoli,41,HV71,D,52,4,18,22,59,0,1,69,51,57,26,37,-11,20:51
,70,Mikko Lehtonen,8,/,F,44,10,11,21,14,1,5,130,20,5,19,22,-3,13:28
,71,Gustav Possler,80,MODO,F,47,9,12,21,8,0,2,109,11,43,30,30,0,16:41
,72,Brian Willsie,42,Örebro,F,55,9,12,21,16,3,0,106,18,23,23,27,-4,15:55
,73,Janos Hari,16,MODO,F,53,6,15,21,18,0,3,55,15,11,26,25,1,13:26
,74,Marko Anttila,12,Örebro,F,52,14,6,20,16,2,2,110,49,9,24,23,1,12:37
,75,Axel Holmström,25,Skellefteå,F,44,10,10,20,4,3,3,47,22,16,18,12,6,12:12
,76,Per Ledin,97,Luleå,F,41,9,11,20,34,6,1,48,30,6,24,17,7,15:07
,77,William Nylander,88,MODO,F,21,8,12,20,6,2,1,41,0,12,18,15,3,19:05
,78,Linus Persson,25,Färjestad,F,50,8,12,20,10,2,4,52,20,54,16,27,-11,17:48
,79,Rob Schremp,44,Skellefteå,F,42,6,14,20,16,4,3,100,8,8,11,15,-4,14:38
,80,Mikael Wikstrand,6,Frölunda,D,46,5,15,20,10,1,1,87,13,23,31,28,3,20:59
,81,Jani Lajunen,24,Växjö,F,48,5,15,20,35,1,0,30,52,44,30,19,11,13:57
,82,Jacob Blomqvist,44,Brynäs,F,55,4,16,20,16,1,2,102,37,25,29,41,-12,16:00
,83,Anton Bengtsson,28,HV71,F,52,13,6,19,4,4,3,60,71,11,23,19,4,11:22
,84,Mattias Tedenby,21,HV71,F,53,10,9,19,32,2,1,86,24,18,24,27,-3,14:33
,85,Oskar Sundqvist,29,Skellefteå,F,41,9,10,19,34,1,2,85,47,27,28,13,15,17:18
,86,Daniel Brodin,34,Brynäs,F,54,7,12,19,61,3,3,121,113,57,24,29,-5,16:13
,87,Jere Karalahti,8,HV71,D,30,6,13,19,57,2,4,39,38,21,11,20,-9,0:37
,88,Peter Cehlarik,26,Luleå,F,46,6,13,19,6,0,1,60,18,10,20,19,1,11:08
,89,Marcus Högström,4,Djurgården,D,53,6,13,19,30,0,3,93,17,28,28,36,-8,21:07
,90,Niklas Fogström,36,Luleå,F,53,5,14,19,26,0,1,39,24,36,27,21,6,15:18
,91,Anders Eriksson,40,Örebro,F,55,12,6,18,53,3,1,62,94,35,22,22,0,15:06
,92,Johan Forsberg,9,Luleå,F,51,11,7,18,33,2,2,57,18,13,27,20,7,13:51
,93,Victor Olofsson,11,MODO,F,39,10,8,18,4,5,4,47,4,10,19,20,-1,10:47
,94,Fabian Brunnström,54,Leksand,F,38,8,10,18,16,1,3,72,23,2,16,17,-1,14:38
,95,Adam Brodecki,68,Brynäs,F,47,8,10,18,10,1,1,81,23,13,17,21,-4,12:55
,96,Niklas Nordgren,13,MODO,F,51,8,10,18,18,0,0,46,17,9,23,25,-2,11:48
,96,Patrik Carlsson,72,HV71,F,51,8,10,18,12,2,3,85,24,41,25,32,-7,18:41
,98,Henrik Löwdahl,15,Örebro,F,46,7,11,18,22,0,3,47,12,25,19,12,7,14:10
,99,Tim Wallace,21,/,F,52,7,11,18,22,1,2,85,94,7,20,29,-9,14:48
,100,Joonas Nättinen,23,MODO,F,55,7,11,18,38,0,1,54,63,49,26,38,-12,15:06
,101,Rhett Rakhshani,49,Växjö,F,51,6,12,18,37,0,2,80,23,13,25,18,7,13:52
,102,Filip Sandberg,16,HV71,F,55,6,12,18,8,1,1,92,64,15,23,19,4,12:53
,103,Björn Melin,9,HV71,F,42,5,13,18,14,1,2,53,32,8,10,23,-13,10:17
,104,Lucas Wallmark,23,Luleå,F,50,5,13,18,14,0,2,82,17,10,19,27,-8,14:07
,105,Niclas Burström,3,Skellefteå,D,54,4,14,18,18,1,0,50,9,21,41,24,17,19:11
,106,Christian Djoos,,Brynäs,D,50,5,12,17,22,2,0,111,20,63,27,37,-10,20:39
,106,Adrian Kempe,51,MODO,F,50,5,12,17,42,1,0,84,34,11,23,31,-8,15:49
,108,Mattias Bäckman,5,Linköping,D,25,4,13,17,4,1,2,47,3,18,17,17,0,19:41
,109,Martin Sevc,55,Skellefteå,D,49,4,13,17,82,0,0,72,66,26,46,29,17,19:39
,110,Jan Sandström,7,Luleå,D,50,4,13,17,22,0,1,113,29,82,28,32,-4,20:52
,111,Kent McDonell,3,Linköping,F,54,3,14,17,40,1,1,126,50,13,22,22,0,13:26
,112,Mattias Guter,44,/,F,41,10,6,16,6,3,5,84,14,6,11,22,-11,13:51
,113,Daniel Widing,41,Skellefteå,F,53,9,7,16,20,4,2,131,30,19,21,24,-3,12:40
,114,Artturi Lehkonen,62,Frölunda,F,47,8,8,16,12,2,2,72,13,19,29,11,18,13:30
,115,Anton Hedman,8,Färjestad,F,52,5,11,16,58,1,3,67,141,24,12,17,-5,12:25
,116,Oskar Lindblom,96,Brynäs,F,37,8,7,15,16,1,1,58,17,19,15,13,2,12:19
,117,Martin Lundberg,27,Skellefteå,F,49,8,7,15,22,4,0,68,68,52,26,9,17,14:18
,118,Henrik Eriksson,17,Djurgården,F,55,8,7,15,12,0,2,110,83,33,21,29,-8,15:52
,119,Mats Rosseli Olsen,51,Frölunda,F,40,7,8,15,35,3,0,59,11,13,19,17,2,15:16
,120,Alexander Johansson,16,Växjö,F,51,7,8,15,61,1,1,87,45,32,20,20,0,16:34
,121,Jonathan Granström,31,Luleå,F,54,7,8,15,84,0,2,46,30,24,21,27,-6,15:35
,122,Kyle Flanagan,17,MODO,F,38,4,11,15,22,1,1,40,6,21,21,21,0,15:27
,123,Magnus Johansson,7,Linköping,D,48,4,11,15,10,0,1,80,12,33,36,36,0,17:37
,124,Jonas Almtorp,16,Linköping,F,51,3,12,15,24,0,0,66,19,23,21,28,-7,15:11
,125,Rickard Wallin,51,Färjestad,F,55,2,13,15,52,0,0,61,16,49,24,22,2,15:12
,126,Joakim Nygård,11,Färjestad,F,44,9,5,14,10,3,2,72,10,8,13,20,-7,14:23
,127,Steve Saviano,15,Djurgården,F,53,7,7,14,6,1,0,90,11,13,22,21,1,12:38
,128,Ryan Lasch,81,Frölunda,F,12,6,8,14,2,0,1,24,5,3,12,7,5,17:26
,129,David Åslin,29,/,F,47,6,8,14,14,0,1,35,27,12,18,26,-8,10:50
,130,Kevin Fiala,18,HV71,F,20,5,9,14,12,1,3,37,10,4,10,13,-3,16:06
,131,Nicklas Lasu,31,Frölunda,F,55,5,9,14,34,1,1,75,67,24,16,14,2,14:21
,132,Albin Carlson,14,MODO,D,37,4,10,14,8,0,0,35,10,20,20,26,-6,14:12
,133,Samuel Påhlsson,26,MODO,F,53,4,10,14,28,0,0,62,76,17,24,28,-4,16:50
,134,Robin Gartner,2,Leksand,D,52,2,12,14,12,1,0,41,12,57,35,33,2,18:35
,135,Daniel Rahimi,48,Linköping,D,54,2,12,14,38,0,1,59,118,86,40,23,17,20:50
,136,Marcus Fagerudd,29,Luleå,D,46,1,13,14,8,1,0,55,38,29,20,23,-3,13:24
,137,Niclas Lundgren,8,Växjö,D,55,1,13,14,8,1,0,40,5,57,46,23,23,17:22
,138,Riley Holzapfel,21,HV71,F,49,7,6,13,14,1,0,46,51,30,21,20,1,13:12
,139,Andreas Jämtin,18,HV71,F,50,7,6,13,64,1,1,72,61,27,18,26,-8,16:13
,140,Pathrik Westerholm,7,Brynäs,F,54,7,6,13,22,1,1,71,19,26,17,27,-10,12:33
,141,Sebastian Enterfeldt,59,Brynäs,F,23,6,7,13,6,2,1,54,50,22,15,15,0,17:26
,142,Sebastian Lauritzen,16,Djurgården,F,27,6,7,13,8,1,1,26,9,6,12,13,-1,11:53
,143,Martin Röymark,27,Färjestad,F,55,6,7,13,12,0,0,93,46,26,21,20,1,15:33
,144,Josh Hennessy,9,Växjö,F,20,5,8,13,12,2,0,37,9,4,14,4,10,14:09
,145,Christoffer Törngren,67,HV71,F,41,5,8,13,10,0,2,38,24,9,18,12,6,9:06
,146,Kalle Olsson,85,Örebro,F,43,5,8,13,8,0,0,44,18,17,20,9,11,12:56
,147,John Norman,37,Skellefteå,F,47,5,8,13,16,0,1,81,10,11,22,16,6,13:09
,148,Shawn Lalonde,10,Färjestad,D,50,5,8,13,82,1,2,85,65,30,20,25,-5,18:22
,149,Mikael Ahlén,13,Djurgården,F,54,5,8,13,65,0,0,52,78,27,18,30,-12,11:54
,150,Johan Motin,57,Örebro,D,51,4,9,13,51,1,0,45,55,38,39,22,17,19:30
,151,Kevin Kapstad,51,Leksand,D,47,3,10,13,26,0,0,111,34,31,29,51,-22,19:38
,152,Dean Kukan,,Luleå,D,52,3,10,13,14,2,0,47,13,28,31,29,2,16:53
,153,Travis Roche,77,MODO,D,37,2,11,13,30,0,0,45,25,48,15,26,-11,19:16
,154,Markus Nordlund,40,Djurgården,D,45,2,11,13,26,1,2,50,9,25,21,19,2,15:03
,155,Viktor Ekbom,8,Örebro,D,55,1,12,13,30,0,0,66,31,103,45,28,17,20:55
,156,Jakub Krejcik,91,Örebro,D,50,0,13,13,10,0,0,67,14,21,23,34,-11,17:24
,157,Johan Harju,24,Luleå,F,14,7,5,12,4,3,2,47,4,1,10,10,0,17:20
,158,Sebastian Karlsson,12,Linköping,F,49,6,6,12,18,2,2,57,43,25,14,17,-3,14:52
,159,Brian Connelly,10,Leksand,D,48,2,10,12,10,0,0,41,10,31,18,30,-12,14:48
,160,Jakub Klepis,20,Färjestad,F,21,6,5,11,18,2,1,44,8,9,12,12,0,18:09
,161,Fredric Andersson,13,Linköping,F,55,5,6,11,16,3,0,67,44,31,16,13,3,12:33
,162,David Rundqvist,29,Djurgården,F,42,4,7,11,4,0,0,28,9,21,16,15,1,11:17
,163,Tomas Skogs,23,Örebro,D,43,4,7,11,26,1,0,41,63,47,27,20,7,17:38
,164,Luciano Aquino,29,Färjestad,F,24,3,8,11,4,1,0,37,5,2,12,16,-4,14:12
,165,Jonas Ahnelöv,55,MODO,D,37,3,8,11,12,1,0,60,48,50,29,24,5,22:58
,166,Lawrence Pilut,20,HV71,D,48,3,8,11,10,1,0,46,6,36,29,17,12,16:13
,167,Erik Andersson,2,Skellefteå,D,50,3,8,11,16,0,0,41,14,43,33,15,18,16:45
,168,Christoffer Persson,6,Frölunda,D,51,3,8,11,52,0,1,43,50,40,20,16,4,15:31
,169,Damien Fleury,13,Djurgården,F,16,6,4,10,4,1,3,50,9,7,4,15,-11,16:20
,170,Veli-Matti Savinainen,86,Leksand,F,24,5,5,10,12,1,4,75,48,6,11,15,-4,19:15
,171,Robin Alvarez,27,Djurgården,F,42,5,5,10,14,1,0,55,23,18,12,24,-12,12:07
,172,Johan Adolfsson,15,Örebro,F,45,5,5,10,8,0,0,40,13,16,12,9,3,8:58
,173,Lennart Petrell,32,Luleå,F,50,5,5,10,16,1,1,71,130,40,17,22,-5,14:04
,174,Emil Sylvegård,51,Luleå,F,47,4,6,10,45,0,0,45,56,12,17,15,2,11:08
,175,Ponthus Westerholm,27,Brynäs,F,53,3,7,10,20,2,1,48,13,17,10,20,-10,9:24
,176,Sebastian Erixon,50,Växjö,D,40,0,10,10,8,0,0,70,16,46,28,19,9,16:59
,177,Jeff Tambellini,7,Växjö,F,20,6,3,9,2,2,2,36,25,7,10,6,4,14:02
,178,Alexander Fällström,14,Djurgården,F,22,6,3,9,10,1,3,56,27,15,9,8,1,15:48
,179,Johannes Salmonsson,25,Linköping,F,46,5,4,9,28,2,0,51,25,15,15,18,-3,13:30
,180,Radek Smolenak,70,MODO,F,23,4,5,9,12,0,0,55,8,5,9,21,-12,15:55
,181,Emil Djuse,57,/,D,39,4,5,9,12,1,0,49,18,31,23,26,-3,16:21
,182,Oscar Eklund,16,Brynäs,D,52,4,5,9,16,1,0,52,12,46,26,36,-10,18:42
,183,Jonathan Sigalet,56,Luleå,D,19,3,6,9,18,0,0,28,33,21,13,13,0,21:27
,184,Michael Holmqvist,18,Djurgården,F,43,3,6,9,14,0,1,60,9,13,15,22,-7,14:12
,185,Nichlas Torp,38,MODO,D,44,3,6,9,76,1,0,47,67,93,26,32,-6,17:44
,186,Robin Norell,56,Djurgården,D,48,3,6,9,12,1,0,31,28,29,20,33,-13,15:03
,187,Karl Fabricius,52,Luleå,F,54,3,6,9,4,1,0,74,14,29,21,18,3,13:11
,188,Teemu Laakso,2,Växjö,D,40,2,7,9,22,0,0,48,51,47,23,15,8,18:37
,189,Oscar Fantenberg,66,Frölunda,D,50,2,7,9,38,1,0,51,52,27,27,19,8,17:27
,190,Philip Holm,25,Djurgården,D,51,2,7,9,20,0,0,47,17,32,20,26,-6,15:01
,191,Sebastian Aho,63,Skellefteå,D,41,1,8,9,14,1,0,29,4,11,21,11,10,12:50
,192,Daniel Gunnarsson,16,Färjestad,D,53,1,8,9,26,0,0,68,18,54,25,29,-4,15:57
,193,Marcus Nilson,3,/,F,29,4,4,8,22,0,2,35,18,10,5,10,-5,12:51
,194,Nicklas Heinerö,10,Djurgården,F,43,3,5,8,2,0,1,37,8,17,11,16,-5,11:01
,195,Oscar Sundh,13,Linköping,F,53,3,5,8,10,0,0,46,26,19,13,20,-7,11:27
,196,Fredrik Lindgren,61,Skellefteå,D,46,1,7,8,40,0,0,39,26,21,30,18,12,18:29
,197,Malte Strömwall,91,/  /,F,47,6,1,7,47,2,0,45,17,7,10,9,1,7:44
,198,Joachim Rohdin,72,Färjestad,F,50,5,2,7,16,1,0,60,30,16,12,10,2,11:42
,199,Chad Kolarik,42,Linköping,F,11,4,3,7,4,0,3,32,5,2,8,10,-2,17:03
,200,Christian Bäckman,5,Frölunda,D,33,4,3,7,16,1,0,34,7,21,16,13,3,16:28
,201,Eric Himelfarb,39,Leksand,F,21,3,4,7,8,0,1,36,22,2,6,26,-20,14:20
,202,Oliver Bohm,3,Frölunda,D,46,3,4,7,24,0,0,42,24,35,23,23,0,15:58
,203,Johan Wiklander,56,Örebro,F,48,3,4,7,16,1,1,42,55,5,13,11,2,10:31
,204,Joonas Lehtivuori,3,MODO,D,52,3,4,7,40,1,0,42,44,83,28,34,-6,17:35
,205,Erik Josefsson,60,Växjö,F,55,3,4,7,18,0,2,53,26,23,12,19,-7,13:51
,206,Juha-Pekka Haataja,72,MODO,F,16,2,5,7,6,0,1,30,5,3,11,14,-3,16:30
,207,Vyacheslav Trukhno,9,Djurgården,F,25,2,5,7,12,1,0,19,10,7,10,6,4,12:39
,208,Pontus Petterström,18,Skellefteå,F,37,2,5,7,6,1,0,37,5,23,15,9,6,12:42
,209,Per Savilahti-Nagander,,Luleå,D,49,2,5,7,55,0,0,52,25,46,34,21,13,18:14
,210,Bobbo Petersson,53,Örebro,D,51,2,5,7,20,0,0,32,17,43,23,24,-1,14:50
,211,Ville Varakas,8,Växjö,D,53,1,6,7,36,1,0,73,49,64,30,21,9,18:47
,212,Oscar Hedman,41,MODO,D,55,1,6,7,30,0,0,42,32,60,29,43,-14,18:18
,213,Anton Lindholm,54,Skellefteå,D,35,0,7,7,35,0,0,30,87,25,25,13,12,14:31
,214,Kristofer Berglund,2,HV71,D,53,0,7,7,18,0,0,31,54,49,38,37,1,17:30
,215,Joel Eriksson Ek,20,Färjestad,F,34,4,2,6,4,0,1,41,12,7,7,7,0,8:54
,216,Marcel Hossa,81,MODO,F,11,3,3,6,0,0,0,29,4,4,6,7,-1,17:44
,217,Gustav Forsling,8,Linköping,D,38,3,3,6,8,0,0,60,6,29,25,22,3,17:24
,218,Carl Dahlström,32,Linköping,D,55,3,3,6,12,0,0,44,10,28,26,28,-2,13:58
,219,Simon Gysbers,67,Djurgården,D,10,2,4,6,0,1,2,12,1,13,6,7,-1,18:02
,220,Daniel Josefsson,12,Leksand,D,40,2,4,6,12,1,0,38,4,48,15,28,-13,18:00
,221,Jens Lööke,,Brynäs,F,43,2,4,6,2,0,0,43,16,4,8,13,-5,6:42
,222,Joonas Jalvanti,19,Örebro,D,52,2,4,6,20,0,0,48,11,45,33,24,9,16:27
,223,Chad Billins,4,Luleå,D,23,1,5,6,4,1,0,51,2,22,12,14,-2,21:20
,224,Lukas Kilström,5,Brynäs,D,50,0,6,6,28,0,0,51,33,84,29,35,-6,18:01
,224,Jesper Jensen,41,Färjestad,D,50,0,6,6,43,0,0,60,46,33,17,26,-9,16:30
,226,Gustav Rydahl,15,Växjö,F,44,5,0,5,43,1,0,43,28,8,9,7,2,8:04
,227,Anton Blidh,18,Frölunda,F,48,5,0,5,26,1,1,64,57,38,14,25,-11,12:54
,228,Andreas Hjelm,18,Luleå,D,32,3,2,5,2,1,0,31,6,18,10,12,-2,14:08
,229,Oliver Kylington,97,Färjestad,D,18,2,3,5,4,1,0,16,2,5,7,9,-2,11:48
,230,Carl Grundström,3,MODO,F,24,2,3,5,8,0,0,19,28,3,7,11,-4,7:45
,231,Anton Grundel,73,Färjestad,D,40,2,3,5,12,0,0,45,29,50,17,15,2,17:05
,232,Tobias Forsberg,19,Leksand,F,42,2,3,5,18,0,0,42,66,9,5,24,-19,8:44
,233,Ole-Kristian Tollefsen,55,Färjestad,D,47,2,3,5,90,0,0,49,72,57,22,25,-3,18:32
,234,Andreas Englund,6,Djurgården,D,49,2,3,5,32,0,0,19,57,33,18,31,-13,12:43
,235,Petr Zámorský,24,Örebro,D,10,1,4,5,8,0,0,21,5,7,8,4,4,19:17
,236,Tero Koskiranta,60,Färjestad,F,13,1,4,5,4,0,0,23,17,6,5,4,1,18:46
,237,Magnus Kahnberg,11,Frölunda,F,26,1,4,5,10,0,0,45,5,3,6,9,-3,13:06
,238,Ludwig Byström,,Färjestad,D,38,1,4,5,18,1,0,29,5,31,20,16,4,16:10
,239,Niklas Arell,42,Färjestad,D,43,1,4,5,16,0,0,38,25,28,22,16,6,14:18
,239,Simon Bertilsson,15,Brynäs,D,43,1,4,5,51,0,0,51,78,82,23,24,-1,18:57
,241,David Petrasek,22,HV71,D,34,0,5,5,36,0,0,20,11,12,12,22,-10,13:33
,242,Linus Arnesson,28,Djurgården,D,41,0,5,5,28,0,0,40,11,39,24,34,-10,20:55
,243,Dennis Persson,29,MODO,D,48,0,5,5,18,0,0,30,25,34,18,23,-5,13:01
,244,Stephen Dixon,14,Luleå,F,15,2,2,4,33,0,0,19,26,1,3,9,-6,14:02
,245,Robin Söderqvist,63,Växjö,F,35,2,2,4,8,1,0,19,18,6,7,10,-3,9:00
,246,Nick Sörensen,10,Skellefteå,F,14,1,3,4,4,0,0,15,18,8,7,2,5,10:40
,247,Marko Kauppinen,6,MODO,D,15,1,3,4,14,1,0,12,6,8,12,10,2,15:43
,248,Jon Knuts,13,Leksand,F,37,1,3,4,6,0,0,47,49,36,7,12,-5,12:29
,249,Alexander Falk,41,Djurgården,D,43,1,3,4,22,1,0,20,51,36,14,24,-10,17:53
,250,Peter Öberg,27,MODO,F,45,1,3,4,18,0,0,22,21,22,6,11,-5,9:14
,251,Eric Martinsson,64,Växjö,D,47,1,3,4,14,1,0,42,1,22,13,19,-6,9:34
,252,Henrik Törnqvist,11,Linköping,F,48,1,3,4,6,0,0,45,25,16,8,9,-1,7:02
,253,Martin Grönberg,22,Leksand,F,49,1,3,4,4,0,0,42,20,38,11,23,-12,11:05
,254,Joonas Rönnberg,29,Leksand,D,55,1,3,4,32,0,0,15,77,52,15,25,-10,13:54
,255,Albin Runesson,55,MODO,D,25,0,4,4,4,0,0,8,11,9,8,8,0,9:12
,256,Jesper Williamsson,34,HV71,D,40,0,4,4,16,0,0,23,28,15,13,15,-2,10:17
,257,Anton Karlsson,47,Linköping,D,50,0,4,4,28,0,0,35,10,42,15,16,-1,13:24
,258,Emil Lundberg,79,Djurgården,F,11,2,1,3,4,0,0,10,4,1,4,6,-2,11:58
,259,Marcus Oskarsson,7,Luleå,D,27,2,1,3,6,0,0,12,1,18,8,8,0,9:41
,260,Rasmus Asplund,74,Färjestad,F,35,2,1,3,4,1,1,16,15,4,5,5,0,9:14
,261,Dominik Granak,51,Linköping,D,16,1,2,3,8,0,0,11,8,14,10,10,0,17:27
,262,Jacob Larsson,4,Frölunda,D,20,1,2,3,6,0,0,14,7,7,12,8,4,10:38
,263,Tomas Slovak,54,Brynäs,D,21,1,2,3,6,0,0,36,12,21,13,12,1,20:44
,264,Alexander Lindgren,10,Brynäs,F,29,1,2,3,2,0,0,22,7,16,6,10,-4,9:32
,265,Daniel Mannberg,79,/,F,34,1,2,3,2,0,0,31,12,10,8,11,-3,10:34
,266,Eddie Larsson,53,Växjö,D,39,1,2,3,16,0,0,22,7,16,11,7,4,10:19
,267,Erik Karlsson,19,Frölunda,F,53,1,2,3,6,0,0,26,11,20,7,14,-7,8:24
,268,Fredrik Händemark,63,Leksand,F,54,1,2,3,22,0,0,63,42,31,7,30,-23,13:56
,269,Jesse Niinimäki,8,Brynäs,F,11,0,3,3,4,0,0,10,4,2,1,5,-4,17:43
,270,Simon Erlandsson,17,Leksand,D,22,0,3,3,0,0,0,11,17,14,4,15,-11,14:02
,271,Lars Bryggman,22,Luleå,F,31,0,3,3,8,0,0,34,17,8,5,5,0,8:28
,272,Arvid Lundberg,52,Skellefteå,D,47,0,3,3,30,0,0,31,23,32,14,15,-1,11:40
,273,Patrick Cehlin,71,Leksand,F,13,2,0,2,4,0,0,26,10,5,8,13,-5,17:33
,274,Anton Axelsson,6,Frölunda,F,38,2,0,2,6,1,0,31,18,20,7,9,-2,12:39
,275,Pontus Widerström,67,Frölunda,F,44,2,0,2,12,1,0,17,42,13,4,8,-4,7:00
,276,Sebastian Ohlsson,72,Skellefteå,F,10,1,1,2,0,0,0,10,3,2,3,3,0,6:39
,277,Mark Matheson,14,Linköping,D,11,1,1,2,4,0,0,5,3,10,8,8,0,14:15
,278,Tobias Hage,24,Djurgården,F,16,1,1,2,2,0,0,14,5,4,3,7,-4,10:21
,279,Sondre Olden,23,Brynäs,F,20,1,1,2,2,0,0,25,7,3,3,6,-3,10:23
,279,Jörgen Sundqvist,22,Brynäs,D,20,1,1,2,16,0,0,15,17,17,9,9,0,18:44
,281,Gabriel Carlsson,29,Linköping,D,7,0,2,2,0,0,0,8,0,1,3,0,3,12:18
,282,Anton Öhman,36,Skellefteå,D,9,0,2,2,6,0,0,10,0,3,5,3,2,9:19
,283,Luke Moffatt,81,Frölunda,F,10,0,2,2,0,0,0,12,5,3,3,7,-4,10:48
,284,Filip Ahl,93,HV71,F,15,0,2,2,2,0,0,2,6,4,3,5,-2,5:22
,284,Anton Karlsson,27,/,F,15,0,2,2,2,0,0,4,8,1,2,3,-1,7:02
,286,Axel Eidstedt,49,HV71,D,26,0,2,2,20,0,0,15,17,20,13,11,2,14:31
,287,Ryan Russell,20,Leksand,F,32,0,2,2,8,0,0,26,16,35,4,18,-14,13:01
,288,Adam Ollas Mattsson,73,Djurgården,D,34,0,2,2,4,0,0,16,35,8,11,19,-8,11:04
,289,Johan Olofsson,8,Färjestad,F,51,0,2,2,2,0,0,29,16,7,5,12,-7,7:08
,290,David Westlund,2,Brynäs,D,53,0,2,2,8,0,0,19,17,22,7,19,-12,6:54
,291,Emil Pettersson,14,MODO,F,2,1,0,1,2,0,1,5,0,1,0,2,-2,17:16
,292,Sebastian Stålberg,17,Frölunda,F,3,1,0,1,0,0,0,5,3,0,1,2,-1,10:28
,292,Jesper Ollas,17,Brynäs,F,3,1,0,1,0,0,0,3,3,1,1,0,1,7:42
,294,Axel Ottosson,18,MODO,F,11,1,0,1,2,0,0,4,5,0,1,4,-3,4:29
,295,Victor Ejdsell,14,Färjestad,F,12,1,0,1,0,0,0,3,5,0,2,1,1,4:30
,296,Kevin Stenlund,82,HV71,F,17,1,0,1,2,0,0,7,2,5,1,4,-3,6:41
,297,Mikael Johansson,95,Växjö,F,22,1,0,1,4,0,0,7,8,2,1,4,-3,5:18
,298,Christoffer Forsberg,23,Färjestad,F,32,1,0,1,6,0,0,14,7,4,4,8,-4,6:14
,299,Stefan Johansson,16,Örebro,D,46,1,0,1,14,1,0,48,28,29,22,27,-5,14:03
,300,Carl Persson,95,HV71,F,4,0,1,1,0,0,0,2,2,1,1,1,0,4:09
,300,Jesper Lindgren,3,MODO,D,4,0,1,1,0,0,0,0,1,1,1,1,0,3:23
,300,Tom Mäkitalo,,Leksand,F,4,0,1,1,0,0,0,2,0,2,1,1,0,5:57
,303,Victor Ekarv,55,Luleå,F,8,0,1,1,2,0,0,6,3,1,1,2,-1,10:55
,304,Daniel Fernholm,24,Djurgården,D,10,0,1,1,12,0,0,6,8,13,4,8,-4,16:02
,305,Petter Hansson,18,Linköping,D,15,0,1,1,2,0,0,0,0,0,4,4,0,2:56
,306,Lucas Carlsson,23,Brynäs,D,16,0,1,1,2,0,0,3,1,1,2,4,-2,3:00
,307,John Nyberg,8,Frölunda,D,17,0,1,1,2,0,0,8,2,5,2,2,0,7:58
,307,Mattias Karlsson,,Linköping,F,17,0,1,1,0,0,0,8,2,0,3,2,1,3:53
,309,Mattias Nörstebö,18,Brynäs,D,20,0,1,1,4,0,0,10,0,13,4,6,-2,10:05
,310,Christian Jaros,15,Luleå,D,25,0,1,1,6,0,0,16,17,10,5,8,-3,8:50
,311,Victor Öhman,12,MODO,F,29,0,1,1,6,0,0,18,9,7,3,5,-2,6:53
,312,Alexander Deilert,54,Djurgården,D,30,0,1,1,4,0,0,22,9,9,6,6,0,9:11
,313,Erik Ersberg,40,HV71,Gk,32,0,1,1,2,0,0,0,0,0,27,27,0,0:00
,314,Emil Johansson,17,HV71,D,35,0,1,1,12,0,0,13,11,22,8,17,-9,13:40
,315,Markus Svensson,35,Skellefteå,Gk,40,0,1,1,0,0,0,0,0,0,69,42,27,0:00
,316,Linus Ullmark,30,MODO,Gk,48,0,1,1,2,0,0,0,0,0,64,71,-7,0:00
,317,Julius Hudacek,33,Örebro,Gk,50,0,1,1,2,0,0,0,0,0,91,66,25,0:00
,318,Linus Fernström,39,Frölunda,Gk,51,0,1,1,2,0,0,0,0,0,60,44,16,0:00
,318,Cristopher Nihlstorp,41,Växjö,Gk,51,0,1,1,2,0,0,0,0,0,77,56,21,0:00
,320,Jonas Frögren,24,Leksand,D,53,0,1,1,59,0,0,18,89,65,7,35,-28,13:37
,321,Bernhard Starkbaum,29,Brynäs,Gk,54,0,1,1,0,0,0,0,0,0,75,89,-14,0:00
,321,Marcus Högberg,1,Linköping,Gk,54,0,1,1,0,0,0,0,0,0,48,45,3,0:00
,323,Mantas Armalis,50,Djurgården,Gk,55,0,1,1,2,0,0,0,0,0,26,43,-17,0:00
,324,Oscar Engsund,32,Frölunda,D,1,0,0,0,0,0,0,0,0,1,0,1,-1,14:23
,324,Jesper Ylivainio,38,Luleå,F,1,0,0,0,0,0,0,0,0,0,0,0,0,4:50
,324,Daniel Marmenlind,50,Örebro,Gk,1,0,0,0,0,0,0,0,0,0,0,0,0,0:00
,324,Tobias Sjökvist,,Färjestad,F,1,0,0,0,0,0,0,0,0,0,0,0,0,0:00
,324,August Gunnarsson,51,Färjestad,F,1,0,0,0,0,0,0,0,0,0,0,0,0,6:43
,324,Anton Blomberg,21,Linköping,F,1,0,0,0,0,0,0,2,0,0,0,0,0,3:26
,324,Adam Thilander,,Skellefteå,D,1,0,0,0,0,0,0,1,0,0,0,0,0,4:41
,324,Pavol Skalicky,28,Örebro,F,1,0,0,0,0,0,0,0,0,0,0,1,-1,3:57
,324,Nils Lagerlöf,,Frölunda,D,1,0,0,0,0,0,0,0,0,0,0,0,0,1:54
,324,Andreas Wingerli,24,Skellefteå,F,1,0,0,0,0,0,0,0,1,0,0,0,0,1:08
,324,Hugo Fagerblom,30,Frölunda,Gk,1,0,0,0,0,0,0,0,0,0,0,0,0,0:00
,324,Oscar Nord,62,Luleå,F,1,0,0,0,0,0,0,0,0,0,0,0,0,1:15
,324,Jakob Olsson,,Frölunda,F,1,0,0,0,0,0,0,0,0,0,0,0,0,0:31
,324,Jacob Johansson,30,Linköping,Gk,1,0,0,0,0,0,0,0,0,0,0,0,0,0:00
,324,Rasmus Fyrpihl,44,Örebro,F,1,0,0,0,0,0,0,0,0,0,0,0,0,0:00
,324,Kim Roussakoff,91,Frölunda,D,1,0,0,0,0,0,0,0,0,0,0,0,0,0:00
,324,Linus Söderström,30,Djurgården,Gk,1,0,0,0,0,0,0,0,0,0,0,0,0,0:00
,324,Einar Emanuelsson,10,Luleå,F,1,0,0,0,0,0,0,0,0,0,0,1,-1,0:20
,324,Kristian Jensen,,Luleå,F,1,0,0,0,0,0,0,1,0,0,0,0,0,0:48
,324,Daniel Norbe,27,HV71,D,1,0,0,0,0,0,0,0,0,0,1,0,1,9:05
,324,Adam Byström Johansson,87,Växjö,F,1,0,0,0,0,0,0,0,0,0,0,0,0,0:00
,324,Oscar Larsson,,Brynäs,F,1,0,0,0,0,0,0,0,0,0,0,0,0,0:00
,324,Hampus Eriksson,28,Brynäs,F,1,0,0,0,0,0,0,3,0,0,0,0,0,13:08
,324,Albin Lundin,25,Djurgården,F,1,0,0,0,0,0,0,1,0,0,0,1,-1,11:46
,324,Martin Karlsson,,Färjestad,F,1,0,0,0,0,0,0,0,0,0,0,1,-1,12:27
,349,Lukas Vopelka,26,Örebro,F,2,0,0,0,0,0,0,0,0,0,0,0,0,0:00
,349,Fabian Norberg,7,MODO,D,2,0,0,0,0,0,0,0,0,1,0,1,-1,2:26
,349,Jesper Mattson,26,Leksand,D,2,0,0,0,0,0,0,0,0,0,0,1,-1,0:12
,349,Christoffer Bengtsberg,,Brynäs,Gk,2,0,0,0,0,0,0,0,0,0,0,0,0,0:00
,349,Pierre Engvall,88,Frölunda,F,2,0,0,0,0,0,0,2,0,0,0,0,0,6:33
,349,Pontus Själin,39,Leksand,D,2,0,0,0,0,0,0,0,0,0,0,0,0,0:00
,349,Jesper Alasaari,33,Färjestad,D,2,0,0,0,0,0,0,0,0,0,0,0,0,1:18
,349,Philip Alftberg,3,Brynäs,D,2,0,0,0,0,0,0,0,0,0,0,0,0,0:00
,349,Adam Schultz,31,HV71,Gk,2,0,0,0,0,0,0,0,0,0,0,0,0,0:00
,349,Kristian Jakobsson,10,MODO,F,2,0,0,0,0,0,0,0,0,1,0,2,-2,3:16
,349,Anton Toolanen,14,Luleå,F,2,0,0,0,0,0,0,0,0,1,0,0,0,2:00
,349,John Dahlström,22,Frölunda,F,2,0,0,0,0,0,0,0,0,0,0,0,0,4:17
,349,Samuel Ward,99,Luleå,Gk,2,0,0,0,0,0,0,0,0,0,0,0,0,0:00
,349,Emil Hedman,30,MODO,Gk,2,0,0,0,0,0,0,0,0,0,0,0,0,0:00
,349,Kalle Hult,,HV71,F,2,0,0,0,0,0,0,1,1,0,0,1,-1,3:51
,349,Filip Gustavsson,30,Luleå,Gk,2,0,0,0,0,0,0,0,0,0,0,0,0,0:00
,349,Daniel Bernhardt,21,Djurgården,F,2,0,0,0,0,0,0,1,0,1,1,4,-3,15:26
,349,Jacob Andersson,23,Skellefteå,D,2,0,0,0,0,0,0,1,1,1,0,0,0,6:24
,367,Lukas Vejdemo,44,Djurgården,F,3,0,0,0,0,0,0,1,0,0,0,0,0,6:29
,367,Jacob Cederholm,3,HV71,D,3,0,0,0,0,0,0,0,0,1,0,0,0,2:17
,367,Sebastian Fakt,,Leksand,F,3,0,0,0,0,0,0,0,0,0,0,1,-1,3:27
,367,Jesper Åkerman,,Linköping,D,3,0,0,0,0,0,0,0,0,0,0,0,0,0:00
,367,Jonathan Léman,82,MODO,D,3,0,0,0,0,0,0,0,0,1,0,0,0,1:07
,367,Adam Deutsch,32,Brynäs,D,3,0,0,0,0,0,0,0,1,0,0,0,0,4:39
,367,Elias Edström,10,Skellefteå,F,3,0,0,0,0,0,0,0,0,0,0,1,-1,3:26
,367,Mark Owuya,30,Luleå,Gk,3,0,0,0,0,0,0,0,0,0,0,0,0,0:00
,367,Linus Ölund,36,Brynäs,F,3,0,0,0,0,0,0,3,0,0,0,0,0,7:50
,367,Adam Werner,35,Färjestad,Gk,3,0,0,0,0,0,0,0,0,0,0,0,0,0:00
,367,Daniel Muzito Bagenda,19,MODO,F,3,0,0,0,0,0,0,1,0,1,1,1,0,5:31
,367,Anton Brehmer,19,Örebro,F,3,0,0,0,0,0,0,1,0,0,1,1,0,4:52
,367,Calle Rosén,39,Växjö,D,3,0,0,0,2,0,0,2,0,0,1,1,0,4:55
,367,Filip Bergmark,52,Örebro,D,3,0,0,0,0,0,0,0,0,0,0,0,0,0:00
,367,Joren Van Pottelberghe,35,Linköping,Gk,3,0,0,0,0,0,0,0,0,0,0,0,0,0:00
,382,Fredrik Bergvik,1,Frölunda,Gk,4,0,0,0,0,0,0,0,0,0,0,0,0,0:00
,382,Robin Jensen,35,Djurgården,Gk,4,0,0,0,0,0,0,0,0,0,2,0,2,0:00
,382,Robin Jonsson,39,Luleå,D,4,0,0,0,2,0,0,4,1,1,0,0,0,13:44
,382,Marcus Lindblom,19,Brynäs,F,4,0,0,0,0,0,0,0,0,0,0,0,0,0:00
,382,Niko Hovinen,30,Luleå,Gk,4,0,0,0,0,0,0,0,0,0,0,4,-4,0:00
,382,Erik Andersson,38,HV71,F,4,0,0,0,0,0,0,0,1,0,0,0,0,1:05
,382,Christoffer Rifalk,65,Luleå,Gk,4,0,0,0,0,0,0,0,0,0,0,0,0,0:00
,382,Thomas Lillie,,Växjö,Gk,4,0,0,0,0,0,0,0,0,0,0,0,0,0:00
,390,Jens Högbom,,Luleå,D,5,0,0,0,0,0,0,0,0,0,0,0,0,0:05
,390,John Morelius,30,Brynäs,D,5,0,0,0,0,0,0,0,0,0,0,0,0,0:00
,390,Chris Connolly,71,Leksand,F,5,0,0,0,0,0,0,4,2,1,0,3,-3,9:39
,390,Simon Norberg,,Leksand,F,5,0,0,0,0,0,0,0,0,1,0,1,-1,1:52
,394,Emil Kruse,35,Brynäs,Gk,6,0,0,0,0,0,0,0,0,0,2,3,-1,0:00
,394,Johannes Nilsson,,Brynäs,F,6,0,0,0,0,0,0,0,1,0,0,0,0,2:43
,394,Christoffer Ehn,21,Frölunda,F,6,0,0,0,2,0,0,2,1,2,1,1,0,2:57
,394,Robin Jacobsson,5,Leksand,D,6,0,0,0,4,0,0,10,12,6,0,8,-8,16:59
,398,Robin Dahlström,29,Örebro,F,7,0,0,0,4,0,0,2,4,0,1,1,0,4:39
,398,Markus Olsson,35,MODO,Gk,7,0,0,0,0,0,0,0,0,0,0,0,0,0:00
,398,Daniel Håkansson,27,Linköping,F,7,0,0,0,0,0,0,0,0,0,1,0,1,1:07
,398,Fredrik Forsberg,12,Leksand,F,7,0,0,0,0,0,0,4,2,2,0,0,0,6:09
,402,Felix Sandström,25,Brynäs,Gk,8,0,0,0,0,0,0,0,0,0,3,1,2,0:00
,402,Jack Connolly,20,Leksand,F,8,0,0,0,2,0,0,10,5,7,1,3,-2,11:59
,402,Gustav Backström,5,Örebro,D,8,0,0,0,0,0,0,2,1,2,1,0,1,4:19
,402,Viktor Scherrieble,35,Leksand,Gk,8,0,0,0,0,0,0,0,0,0,0,0,0,0:00
,406,Claes Nordén,21,Linköping,F,11,0,0,0,2,0,0,1,6,2,0,4,-4,5:07
,406,Johan Holmqvist,40,Brynäs,Gk,11,0,0,0,0,0,0,0,0,0,9,6,3,0:00
,406,Emil Lundberg,51,Brynäs,F,11,0,0,0,4,0,0,5,8,9,1,4,-3,12:30
,406,Carl Ericson,14,Leksand,F,11,0,0,0,2,0,0,6,1,7,0,3,-3,6:43
,406,Albin Storm,15,Växjö,F,11,0,0,0,0,0,0,1,6,0,0,2,-2,3:46
,411,Donald Brashear,87,MODO,F,12,0,0,0,6,0,0,2,13,1,0,1,-1,2:49
,412,Christopher Bengtsson,40,MODO,F,13,0,0,0,6,0,0,9,6,6,1,1,0,6:29
,413,Marcus Pettersson,8,Skellefteå,D,14,0,0,0,0,0,0,3,1,1,3,4,-1,5:45
,414,Oskar Lang,14,Leksand,F,15,0,0,0,0,0,0,5,1,2,1,2,-1,6:00
,414,Jesper Eriksson,,Skellefteå,Gk,15,0,0,0,0,0,0,0,0,0,2,5,-3,0:00
,414,Kalle Jellvert,42,Örebro,F,15,0,0,0,0,0,0,2,3,0,0,0,0,1:46
,414,Jonas Johansson,25,Brynäs,Gk,15,0,0,0,0,0,0,0,0,0,2,6,-4,0:00
,414,Joel Gistedt,31,/,Gk,15,0,0,0,0,0,0,0,0,0,2,9,-7,0:00
,419,Johan Svedberg,7,Leksand,D,20,0,0,0,4,0,0,8,8,10,3,8,-5,7:39
,420,Viktor Kokman,99,HV71,Gk,22,0,0,0,0,0,0,0,0,0,0,0,0,0:00
,421,Sebastian Strandberg,29,HV71,F,24,0,0,0,0,0,0,9,6,1,1,4,-3,5:03
,422,Henrik Lundberg,1,Örebro,Gk,29,0,0,0,0,0,0,0,0,0,14,12,2,0:00
,423,Johannes Jönsson,38,Örebro,Gk,30,0,0,0,0,0,0,0,0,0,11,13,-2,0:00
,424,Daniel Larsson,,Luleå,Gk,44,0,0,0,0,0,0,0,0,0,34,37,-3,0:00
,425,Viktor Mårtensson,27,Leksand,F,46,0,0,0,55,0,0,15,57,6,0,9,-9,3:27
,425,Joakim Lundström,84,Leksand,Gk,46,0,0,0,0,0,0,0,0,0,19,29,-10,0:00
,427,Mikael Tellqvist,32,Djurgården,Gk,50,0,0,0,0,0,0,0,0,0,55,76,-21,0:00
,427,Oscar Alsenfelt,69,Leksand,Gk,50,0,0,0,8,0,0,0,0,0,63,103,-40,0:00
,429,Joel Lassinantti,34,Luleå,Gk,51,0,0,0,2,0,0,0,0,0,64,49,15,0:00
,430,David Rautio,30,Linköping,Gk,52,0,0,0,0,0,0,1,0,0,62,52,10,0:00
,431,Fredrik Pettersson-Wentzel,53,Färjestad,Gk,53,0,0,0,0,0,0,0,0,0,46,51,-5,0:00
,431,Adam Reideborn,39,MODO,Gk,53,0,0,0,0,0,0,0,0,0,42,54,-12,0:00
,433,Gustaf Wesslau,32,HV71,Gk,54,0,0,0,2,0,0,0,0,0,70,76,-6,0:00
,433,Lars Johansson,1,Frölunda,Gk,54,0,0,0,2,0,0,0,0,0,41,39,2,0:00
,433,Justin Pogge,49,Färjestad,Gk,54,0,0,0,6,0,0,0,0,0,43,39,4,0:00
,436,Stefan Steen,26,Växjö,Gk,55,0,0,0,0,0,0,0,0,0,46,26,20,0:00
,436,Erik Hanses,34,Skellefteå,Gk,55,0,0,0,4,0,0,0,0,0,54,29,25,0:00
,1,Pär Arlbrandt,40,Linköping,F,53,26,45,71,66,8,11,152,11,3,42,37,5,17:27
,2,Joakim Lindström,10,Skellefteå,F,55,23,40,63,72,7,10,170,19,12,44,29,15,19:46
,3,Linus Klasen,86,Luleå,F,54,28,29,57,45,9,9,166,8,6,40,27,13,18:20
,4,Simon Hjalmarsson,59,Linköping,F,55,27,30,57,87,4,13,174,41,20,40,40,0,19:14
,5,Chad Kolarik,42,Linköping,F,53,30,18,48,64,3,12,178,12,29,37,37,0,17:47
,6,Oscar Möller,45,Skellefteå,F,48,27,18,45,14,7,15,211,15,29,33,20,13,18:36
,7,Joakim Hillding,24,Färjestad,F,55,18,23,41,22,7,6,112,33,8,33,26,7,16:07
,8,Ryan Gunderson,13,Brynäs,D,54,8,33,41,14,2,3,127,9,58,54,41,13,0:26
,9,Viktor Arvidsson,9,Skellefteå,F,50,16,24,40,59,5,3,136,12,23,28,24,4,15:15
,10,Dennis Rasmussen,70,Växjö,F,52,16,24,40,20,2,1,109,17,24,36,30,6,18:26
,11,Jesper Ollas,17,Brynäs,F,53,17,22,39,28,2,7,119,54,27,36,19,17,16:35
,12,Mathis Olimb,46,Frölunda,F,52,11,28,39,28,3,4,83,4,2,31,28,3,17:07
,13,Mikael Johansson,85,Leksand,F,55,9,30,39,48,3,1,60,20,8,28,42,-14,19:03
,14,Rhett Rakhshani,49,Växjö,F,55,13,25,38,26,3,3,118,34,12,42,23,19,15:35
,15,Andreas Thuresson,12,Brynäs,F,52,17,20,37,61,5,5,165,56,10,34,28,6,17:22
,16,William Karlsson,71,HV71,F,55,15,22,37,14,3,6,132,40,33,33,33,0,19:48
,17,Ryan Lasch,81,Växjö,F,54,20,16,36,16,6,2,96,11,12,39,26,13,16:07
,18,Greg Scott,41,Brynäs,F,53,17,19,36,10,3,3,122,62,21,36,37,-1,17:45
,19,Patrik Hersley,6,Leksand,D,51,24,11,35,18,7,13,155,48,30,34,34,0,23:25
,20,Pierre-Edouard Bellemare,41,Skellefteå,F,52,20,15,35,32,1,2,132,49,24,40,19,21,15:26
,21,Jonas Nordquist,39,Brynäs,F,51,14,21,35,14,2,2,81,10,13,31,21,10,16:39
,22,Anton Rödin,18,Brynäs,F,47,12,23,35,38,0,5,81,36,18,32,41,-9,18:28
,23,Dick Axelsson,31,Frölunda,F,48,10,25,35,56,1,4,70,12,9,25,21,4,16:15
,24,Magnus Johansson,7,Linköping,D,49,7,28,35,12,1,2,111,19,37,46,39,7,21:05
,25,Mattias Sjögren,11,Linköping,F,54,6,29,35,44,3,2,90,97,20,37,32,5,17:59
,26,Cory Murphy,,Växjö,D,53,13,21,34,24,4,7,120,10,34,42,35,7,20:06
,27,Magnus Kahnberg,11,Frölunda,F,55,18,15,33,22,4,7,121,12,15,25,19,6,14:54
,28,Niklas Olausson,16,Luleå,F,49,11,22,33,60,0,1,80,8,11,34,21,13,18:04
,29,Tomi Kallio,71,Växjö,F,55,11,22,33,12,2,2,145,43,4,39,27,12,16:16
,30,Johan Ryno,61,Leksand,F,50,10,23,33,28,4,3,111,32,19,29,30,-1,17:53
,31,Bud Holloway,4,Skellefteå,F,53,10,23,33,26,3,4,143,62,18,37,15,22,17:01
,32,Tim Wallace,21,Örebro,F,55,15,17,32,30,2,4,136,109,12,30,29,1,18:14
,33,Pontus Åberg,46,Färjestad,F,52,15,16,31,41,1,5,146,12,8,25,23,2,16:13
,34,Mattias Janmark,10,AIK,F,45,18,12,30,56,4,5,99,19,22,29,35,-6,20:20
,35,Toni Rajala,10,HV71,F,37,13,17,30,12,5,0,98,27,13,32,28,4,17:58
,36,Bill Sweatt,96,Brynäs,F,55,16,13,29,26,3,2,125,50,24,35,28,7,16:56
,37,Jimmie Ericsson,21,Skellefteå,F,48,13,16,29,68,4,5,95,53,14,23,18,5,16:46
,38,Ted Brithén,90,HV71,F,49,11,18,29,0,1,2,87,22,25,40,32,8,14:33
,39,Johan Harju,24,Brynäs,F,55,19,9,28,20,2,6,136,17,10,32,26,6,14:39
,40,Cam Abbott,24,Luleå,F,52,14,14,28,40,2,3,100,27,11,27,20,7,15:19
,41,John Klingberg,15,Frölunda,D,50,11,17,28,12,4,9,99,10,35,35,27,8,21:47
,42,Kyle Cumiskey,15,MODO,D,45,4,24,28,16,0,1,56,15,43,34,38,-4,22:29
,43,Patrik Carlsson,72,HV71,F,52,15,12,27,18,5,7,103,24,31,31,39,-8,18:36
,44,Erik Christensen,24,HV71,F,38,13,14,27,22,0,2,101,13,6,31,27,4,16:17
,45,Per Ledin,97,Luleå,F,52,11,16,27,58,1,4,73,59,17,36,21,15,16:05
,46,Per Åslund,22,Färjestad,F,55,10,17,27,48,1,1,100,40,27,30,27,3,17:38
,47,Anssi Salmela,14,/,D,44,9,18,27,84,4,1,98,83,49,49,38,11,0:34
,48,Daniel Sondell,50,Örebro,D,47,8,19,27,14,3,2,116,13,25,27,33,-6,21:30
,49,Jared Aulin,18,Örebro,F,50,7,20,27,36,2,2,104,19,18,34,27,7,18:15
,50,Jacob Blomqvist,44,Leksand,F,55,14,12,26,22,2,9,126,50,13,24,37,-13,16:58
,51,Erik Forssell,20,Skellefteå,F,48,15,10,25,18,2,3,72,10,38,36,14,22,16:16
,52,Robert Rosén,87,Växjö,F,44,11,14,25,8,2,1,113,12,22,31,20,11,17:33
,53,Melker Karlsson,15,Skellefteå,F,48,9,16,25,14,2,4,65,36,25,19,22,-3,14:44
,54,Kevin Kapstad,51,Leksand,D,52,7,18,25,46,3,2,114,28,46,24,49,-25,23:03
,55,Jonas Liwing,23,AIK,D,53,5,20,25,12,1,3,66,14,45,35,47,-12,22:40
,56,Andreas Johnson,88,Frölunda,F,44,15,9,24,2,3,5,93,11,14,19,20,-1,14:48
,57,Esa Pirnes,10,AIK,F,43,10,14,24,38,2,3,81,68,16,21,30,-9,18:17
,58,Oscar Steen,45,AIK,F,52,8,16,24,34,1,0,69,8,14,27,33,-6,16:50
,59,Brett Sterling,21,/,F,48,12,11,23,32,2,2,111,28,10,30,30,0,14:39
,60,Jack Connolly,20,Färjestad,F,55,11,12,23,45,2,2,84,14,14,28,26,2,15:10
,61,Milan Gulas,44,Färjestad,F,26,10,13,23,36,1,3,70,44,5,16,16,0,16:58
,62,Robin Figren,23,Frölunda,F,43,9,14,23,54,2,2,144,16,15,20,24,-4,17:13
,63,Chris Abbott,29,Luleå,F,47,8,15,23,56,1,1,52,15,19,29,23,6,19:24
,64,Riley Holzapfel,21,HV71,F,48,10,12,22,49,1,0,60,54,13,29,27,2,13:50
,65,Sebastian Erixon,50,Växjö,D,49,7,15,22,55,1,4,97,24,56,30,28,2,20:41
,66,Richie Regehr,49,MODO,D,52,6,16,22,50,1,3,125,47,66,35,29,6,20:12
,67,Alexander Wennberg,10,Frölunda,F,50,16,5,21,8,3,9,76,14,17,18,23,-5,15:16
,68,Martin Johansson,25,Örebro,F,40,11,10,21,6,0,2,68,13,8,25,22,3,18:05
,69,Jonas Almtorp,16,Linköping,F,49,8,13,21,30,0,2,83,31,32,28,28,0,16:51
,70,Eric Himelfarb,39,Linköping,F,50,7,14,21,36,1,0,82,28,7,31,29,2,14:22
,71,Teemu Ramstedt,46,AIK,F,36,6,15,21,46,1,2,48,1,8,17,27,-10,19:01
,72,Mattias Bäckman,5,Linköping,D,54,6,15,21,16,2,0,68,4,44,55,29,26,18:53
,73,Patrik Lundh,79,Färjestad,F,55,6,15,21,38,1,2,95,25,21,27,23,4,15:44
,74,Simon Önerud,11,MODO,F,54,14,6,20,8,3,2,105,46,30,25,23,2,15:01
,75,Marko Anttila,12,Örebro,F,22,13,7,20,30,1,2,87,24,4,19,15,4,18:30
,76,Jeff Tambellini,7,MODO,F,45,13,7,20,32,5,1,89,45,14,23,29,-6,15:49
,77,Magnus Nygren,32,Färjestad,D,25,12,8,20,8,3,7,79,25,23,21,15,6,23:16
,78,Henrik Löwdahl,15,Örebro,F,42,10,10,20,14,2,1,75,17,27,21,21,0,15:29
,79,Jani Lajunen,24,Växjö,F,44,8,12,20,16,0,0,49,44,30,31,17,14,14:42
,80,Johannes Salmonsson,25,Linköping,F,54,7,13,20,34,1,1,81,20,11,30,25,5,16:03
,81,Niclas Burström,3,Skellefteå,D,55,6,14,20,32,1,1,67,13,62,41,29,12,21:09
,82,Erik Gustafsson,56,Frölunda,D,50,2,18,20,16,0,1,70,28,15,22,22,0,15:02
,83,Kent McDonell,3,Linköping,F,26,13,6,19,14,2,4,86,39,1,16,13,3,14:19
,84,Colby Armstrong,20,Växjö,F,37,12,7,19,26,5,5,46,35,8,14,16,-2,15:55
,85,Samuel Påhlsson,26,MODO,F,55,10,9,19,40,2,1,83,79,12,32,32,0,17:43
,86,Jens Bergenström,32,Leksand,F,47,8,11,19,16,1,0,99,13,26,24,27,-3,14:01
,87,Per-Åge Skröder,10,MODO,F,48,8,11,19,61,3,3,114,41,12,28,21,7,17:08
,88,Liam Reddox,85,Växjö,F,51,8,11,19,20,1,0,119,22,12,32,22,10,15:49
,89,Björn Melin,9,AIK,F,25,6,13,19,24,0,2,49,20,6,12,20,-8,18:18
,90,Marcus Weinstock,20,Örebro,F,54,6,13,19,35,2,3,104,20,10,21,26,-5,14:06
,91,Noah Welch,5,Växjö,D,43,2,17,19,82,0,0,101,52,40,34,22,12,19:05
,92,Anton Axelsson,6,Frölunda,F,55,12,6,18,33,1,0,77,21,30,29,19,10,14:17
,93,Fabian Brunnström,54,/,F,50,9,9,18,20,3,3,94,30,13,21,34,-13,14:49
,94,Christian Berglund,17,Färjestad,F,38,8,10,18,77,3,1,90,35,11,19,17,2,12:41
,95,Mattias Ritola,21,MODO,F,38,7,11,18,26,1,1,79,34,7,21,25,-4,17:47
,96,Evan McGrath,93,Frölunda,F,47,6,12,18,12,1,1,56,8,8,18,18,0,11:36
,97,Elias Fälth,33,HV71,D,52,6,12,18,30,1,1,109,31,45,35,48,-13,20:21
,98,Mark Hurtubise,14,AIK,F,54,13,4,17,30,0,1,114,43,18,21,41,-20,15:09
,99,Erik Josefsson,60,Växjö,F,55,11,6,17,28,1,4,61,24,25,19,21,-2,15:24
,100,Mario Kempe,70,MODO,F,54,9,8,17,18,2,2,140,29,22,26,30,-4,15:54
,101,Oscar Sundh,13,/,F,44,7,10,17,8,1,1,53,12,15,19,18,1,13:10
,102,Victor Ahlström,68,AIK,F,55,6,11,17,8,0,1,72,23,10,21,30,-9,13:59
,102,Oscar Ahlström,86,AIK,F,55,6,11,17,20,2,1,97,31,11,20,29,-9,14:48
,104,Derek Joslin,25,AIK,D,54,5,12,17,40,0,4,114,42,26,31,42,-11,20:52
,104,Marcus Nilson,3,HV71,F,54,5,12,17,22,0,3,85,43,6,16,35,-19,15:34
,106,Joel Lundqvist,20,Frölunda,F,46,3,14,17,59,2,1,58,88,27,22,21,1,17:25
,107,Jason Krog,9,HV71,F,48,8,8,16,30,2,1,59,32,23,23,37,-14,14:09
,108,Sebastian Karlsson,12,Linköping,F,50,8,8,16,22,0,4,85,24,18,17,25,-8,14:20
,109,Oskar Sundqvist,29,Skellefteå,F,51,6,10,16,16,0,2,77,45,25,20,14,6,12:09
,110,Nicklas Lasu,31,Frölunda,F,50,3,13,16,26,1,0,65,44,46,25,15,10,13:41
,111,Daniel Brodin,34,Brynäs,F,52,11,4,15,42,4,2,105,117,26,15,24,-9,13:25
,112,Anton Hedman,8,Luleå,F,47,10,5,15,84,3,4,89,132,4,14,10,4,12:40
,113,Linus Persson,25,Luleå,F,55,9,6,15,8,3,1,77,20,9,18,25,-7,14:12
,114,Gustav Possler,80,MODO,F,22,8,7,15,4,0,3,48,10,17,12,4,8,16:41
,115,Petter Emanuelsson,11,Skellefteå,F,44,6,9,15,2,2,0,79,19,18,15,14,1,11:16
,116,Mats Rosseli Olsen,51,Frölunda,F,48,6,9,15,40,2,0,56,8,33,22,17,5,13:25
,117,Alexander Johansson,16,Växjö,F,54,6,9,15,34,1,4,77,50,36,22,22,0,15:32
,118,Johan Fransson,10,Luleå,D,38,5,10,15,20,0,2,111,15,22,26,16,10,21:23
,119,T.J. Hensick,77,MODO,F,31,4,11,15,2,2,0,56,5,4,15,18,-3,14:40
,120,Ben Walter,17,Örebro,F,35,2,13,15,14,1,1,52,9,15,16,20,-4,17:25
,121,Sebastian Lauritzen,16,Brynäs,F,27,8,6,14,8,3,3,47,6,6,8,15,-7,12:14
,122,Niklas Fogström,36,Luleå,F,55,6,8,14,14,1,0,55,31,19,14,18,-4,14:48
,122,Joachim Rohdin,72,Linköping,F,55,6,8,14,30,0,1,70,36,14,19,26,-7,11:24
,124,Jonas Ahnelöv,55,Frölunda,D,52,5,9,14,61,2,0,61,74,47,30,29,1,18:46
,125,Joakim Nygård,11,Färjestad,F,50,3,11,14,12,3,0,65,23,9,16,19,-3,12:33
,125,Daniel Gunnarsson,16,Luleå,D,50,3,11,14,12,0,2,118,9,42,29,32,-3,18:08
,127,Martin Röymark,27,Färjestad,F,52,8,5,13,12,1,0,70,48,21,21,15,6,13:57
,128,Jacob de la Rose,9,Leksand,F,49,7,6,13,18,2,0,45,50,25,15,20,-5,14:22
,129,Jonas Junland,44,Linköping,D,44,6,7,13,46,0,3,98,24,35,23,20,3,18:43
,130,Conny Strömberg,24,Örebro,F,47,4,9,13,8,0,0,52,5,6,14,19,-5,10:12
,131,John Norman,37,Skellefteå,F,48,4,9,13,10,1,1,47,9,4,17,15,2,10:17
,131,Ville Lajunen,47,Färjestad,D,48,4,9,13,20,0,2,73,8,28,26,22,4,17:26
,133,Oscar Fantenberg,66,HV71,D,47,2,11,13,14,0,0,82,62,45,35,34,1,20:17
,134,Ville Varakas,8,Växjö,D,54,2,11,13,67,0,0,61,50,54,44,25,19,19:03
,135,Simon Bertilsson,15,Brynäs,D,38,1,12,13,34,1,0,46,63,55,28,23,5,21:28
,136,Christian Djoos,,Brynäs,D,47,1,12,13,4,1,0,63,12,39,35,30,5,17:16
,137,Justin DiBenedetto,9,Örebro,F,35,7,5,12,55,1,4,96,11,5,15,17,-2,15:38
,138,Johan Wiklander,56,Örebro,F,37,7,5,12,8,3,2,48,29,9,13,21,-8,12:51
,139,Fredrik Hynning,12,AIK,F,53,6,6,12,22,0,0,71,34,9,22,32,-10,15:11
,140,Andreas Jämtin,18,HV71,F,25,5,7,12,107,0,4,34,30,14,11,17,-6,14:16
,141,Pontus Petterström,18,Skellefteå,F,36,5,7,12,12,0,2,50,3,27,15,8,7,13:06
,142,Viktor Lööv,50,MODO,D,42,5,7,12,20,2,1,35,68,29,21,19,2,16:20
,143,Sebastian Enterfeldt,59,Brynäs,F,46,5,7,12,34,1,2,61,78,31,22,25,-3,15:19
,144,Pär Edblom,15,Leksand,F,53,5,7,12,52,0,1,77,36,20,22,30,-8,13:54
,145,Gabriel Karlsson,49,Leksand,F,54,5,7,12,6,0,2,57,5,31,14,26,-12,13:53
,145,Marcus Nilsson,10,AIK,F,54,5,7,12,4,1,1,46,5,4,16,27,-11,11:11
,147,Andreas Hjelm,18,Luleå,D,55,5,7,12,0,0,4,80,5,15,20,25,-5,16:01
,148,Erik Andersson,2,Skellefteå,D,53,4,8,12,18,1,0,44,7,38,39,17,22,16:45
,149,David Åslin,29,Växjö,F,54,4,8,12,28,1,0,39,36,16,17,17,0,10:17
,149,Dean Kukan,,Luleå,D,54,4,8,12,12,1,0,68,11,24,30,22,8,16:25
,151,Kalle Olsson,85,Örebro,F,51,2,10,12,12,0,0,62,29,24,16,20,-4,13:54
,152,Pavel Skrbek,11,Luleå,D,49,1,11,12,20,1,0,57,12,40,32,14,18,18:20
,153,Adrian Kempe,51,MODO,F,45,5,6,11,12,2,0,38,26,9,16,11,5,8:27
,154,Mikael Wikstrand,6,Frölunda,D,19,4,7,11,4,0,3,47,4,9,13,12,1,19:20
,155,Kevin Fiala,18,HV71,F,17,3,8,11,10,1,0,31,7,0,12,14,-2,12:28
,156,Ludwig Byström,,Färjestad,D,51,3,8,11,24,0,0,38,9,43,28,18,10,15:21
,157,Jonathan Granström,31,Brynäs,F,33,2,9,11,36,0,1,46,41,13,18,11,7,15:17
,158,Lukas Kilström,5,Brynäs,D,34,0,11,11,20,0,0,33,29,60,20,25,-5,19:46
,159,Max Görtz,17,/,F,40,8,2,10,4,1,1,76,11,12,14,12,2,11:16
,160,Patric Blomdahl,84,AIK,F,48,7,3,10,44,2,0,75,113,30,20,34,-14,13:47
,161,Christian Sandberg,21,AIK,F,41,5,5,10,24,2,1,51,29,13,14,20,-6,14:20
,162,Edwin Hedberg,20,MODO,F,51,5,5,10,50,1,1,67,31,13,11,19,-8,12:40
,163,Lucas Wallmark,23,Luleå,F,41,3,7,10,2,0,2,40,10,3,8,12,-4,10:02
,164,Michael Lindqvist,34,AIK,F,45,3,7,10,12,0,0,39,6,5,10,13,-3,7:58
,165,Adam Pettersson,12,Skellefteå,F,49,3,7,10,16,0,0,44,30,14,12,11,1,9:54
,165,Brett Carson,7,AIK,D,49,3,7,10,43,1,2,60,37,60,21,33,-12,17:23
,167,Jonas Frögren,24,Skellefteå,D,50,3,7,10,30,0,0,27,115,47,26,19,7,15:57
,168,Oscar Hedman,41,MODO,D,53,3,7,10,14,0,0,50,38,49,32,25,7,19:26
,169,Anders Eriksson,40,Örebro,F,55,3,7,10,36,0,0,75,81,22,11,25,-14,14:19
,170,Arvid Lundberg,52,Skellefteå,D,46,2,8,10,6,0,0,28,9,36,27,16,11,14:26
,171,Anton Grundel,73,Färjestad,D,51,1,9,10,14,1,0,72,28,47,24,28,-4,19:11
,172,Kristian Forsberg,28,MODO,F,48,6,3,9,20,1,0,57,51,27,18,11,7,14:21
,173,Daniel Mannberg,79,Luleå,F,48,5,4,9,6,2,0,52,19,15,13,15,-2,12:17
,174,Tomas Hyka,28,Färjestad,F,40,4,5,9,6,0,1,69,13,6,10,15,-5,11:12
,175,Chris Campoli,41,HV71,D,33,3,6,9,34,0,1,43,35,43,34,32,2,23:47
,176,Sebastian Collberg,49,Frölunda,F,40,3,6,9,8,0,0,61,17,11,14,16,-2,11:29
,177,Stefan Johansson,16,HV71,D,51,3,6,9,22,1,0,66,30,26,24,26,-2,14:00
,178,Dave Spina,12,MODO,F,37,2,7,9,18,0,1,52,17,5,12,21,-9,12:15
,179,Niklas Arell,42,Färjestad,D,51,2,7,9,18,0,1,55,31,43,21,25,-4,16:48
,180,Niklas Nordgren,13,MODO,F,28,1,8,9,28,1,0,29,14,5,12,15,-3,13:59
,181,David Petrasek,22,HV71,D,45,1,8,9,36,0,0,64,26,34,27,34,-7,20:20
,182,Daniel Rahimi,48,Linköping,D,48,1,8,9,48,0,0,67,87,37,18,29,-11,16:39
,183,Kirill Kabanov,7,MODO,F,12,6,2,8,2,0,2,33,6,7,7,8,-1,15:22
,184,Jens Jakobs,26,Leksand,F,28,5,3,8,8,1,1,38,2,7,7,10,-3,9:32
,185,Rickard Wallin,51,Färjestad,F,43,4,4,8,28,0,1,50,12,13,15,18,-3,15:42
,186,Jan Hlavac,27,Växjö,F,10,2,6,8,0,1,1,16,0,3,5,2,3,15:38
,187,Nick Plastino,8,Örebro,D,49,2,6,8,18,0,0,58,10,23,20,19,1,12:36
,188,Ryan Russell,20,Leksand,F,51,2,6,8,4,0,0,57,44,78,13,24,-11,15:32
,189,Tomas Skogs,23,Örebro,D,55,2,6,8,28,0,0,57,50,61,24,37,-13,22:10
,190,Daniel Grillfors,32,Linköping,D,44,1,7,8,16,0,0,31,22,34,19,19,0,15:33
,191,Peter Öberg,27,MODO,F,45,1,7,8,12,0,0,27,30,33,19,13,6,13:12
,192,Nichlas Torp,38,MODO,D,49,1,7,8,79,0,0,46,116,69,24,24,0,17:50
,193,Johan Motin,57,Örebro,D,54,1,7,8,42,0,0,54,71,34,31,22,9,18:19
,194,Jan Sandström,7,Luleå,D,45,0,8,8,16,0,0,106,32,54,25,22,3,20:54
,195,Marius Holtet,12,Färjestad,F,29,5,2,7,18,1,1,39,53,12,12,13,-1,15:47
,196,Petteri Nokelainen,16,Brynäs,F,19,4,3,7,12,0,1,39,13,4,15,8,7,16:28
,197,Martin Lundberg,27,Skellefteå,F,55,4,3,7,40,0,0,44,105,40,12,15,-3,12:58
,198,Malte Strömwall,91,Växjö,F,40,3,4,7,6,0,0,34,25,5,8,9,-1,6:39
,199,Anders Bastiansen,20,Färjestad,F,36,2,5,7,12,0,0,26,16,17,13,15,-2,14:51
,200,Erik Lindhagen,29,Linköping,F,47,2,5,7,18,1,0,50,12,13,10,21,-11,9:53
,201,Christian Bäckman,5,Frölunda,D,50,2,5,7,36,0,0,54,13,47,26,22,4,17:36
,202,Anton Bengtsson,28,HV71,F,51,2,5,7,6,0,0,40,26,13,10,23,-13,10:26
,203,William Nylander,88,MODO,F,22,1,6,7,6,0,1,23,3,1,10,13,-3,13:16
,204,Johan Alm,,Skellefteå,D,30,1,6,7,14,0,0,27,45,34,26,10,16,19:21
,205,Kristofer Berglund,2,Växjö,D,43,1,6,7,40,0,0,37,35,39,22,21,1,17:54
,206,Fredrik Lindgren,61,Skellefteå,D,51,0,7,7,28,0,0,51,46,23,42,26,16,19:35
,207,Ville Viitaluoma,39,Örebro,F,6,5,1,6,4,0,2,15,1,1,3,3,0,16:18
,208,Joonas Lehtivuori,3,MODO,D,38,5,1,6,18,0,0,48,28,32,17,21,-4,16:16
,209,Erik Karlsson,19,Frölunda,F,41,5,1,6,6,2,0,45,9,10,9,8,1,8:39
,210,Christoffer Forsberg,23,Färjestad,F,38,4,2,6,10,1,1,27,14,3,11,6,5,8:06
,211,Christopher Bengtsson,40,MODO,F,43,4,2,6,12,1,0,42,28,14,14,12,2,11:25
,212,Shawn Belle,7,Färjestad,D,39,3,3,6,62,0,0,46,28,19,24,15,9,16:23
,213,Jon Knuts,13,Leksand,F,47,3,3,6,18,0,0,50,50,31,10,19,-9,12:34
,214,Matt Fornataro,89,Leksand,F,29,2,4,6,26,1,0,35,18,7,6,18,-12,13:19
,215,Oliver Kylington,97,Färjestad,D,32,2,4,6,6,1,0,29,1,22,16,11,5,14:27
,216,Viktor Ekbom,8,Örebro,D,53,2,4,6,22,0,0,43,39,59,21,30,-9,17:40
,217,Karl Fabricius,52,Luleå,F,55,2,4,6,12,1,0,61,24,15,11,9,2,12:30
,218,Eddie Larsson,53,Växjö,D,42,1,5,6,8,0,0,24,22,22,23,15,8,12:25
,219,Ole-Kristian Tollefsen,55,Färjestad,D,45,1,5,6,104,0,0,41,61,55,31,22,9,20:15
,220,Daniel Josefsson,12,AIK,D,47,1,5,6,28,0,0,55,8,43,22,21,1,19:13
,221,Oliver Bohm,3,Frölunda,D,48,1,5,6,12,0,0,55,13,41,27,19,8,15:35
,222,Robert Hägg,14,MODO,D,50,1,5,6,49,0,0,44,77,30,21,21,0,13:07
,223,Fredrik Händemark,63,Leksand,F,52,1,5,6,18,0,0,27,20,21,10,9,1,9:22
,224,Jörgen Sundqvist,22,Brynäs,D,55,1,5,6,52,0,0,54,92,52,38,31,7,19:16
,225,Matt Lashoff,21,Leksand,D,40,0,6,6,58,0,0,52,36,72,20,42,-22,21:40
,226,Vyacheslav Trukhno,9,Luleå,F,48,0,6,6,40,0,0,30,36,9,8,14,-6,9:09
,227,Johan Forsberg,9,Luleå,F,31,3,2,5,20,2,2,33,39,7,10,13,-3,14:10
,228,Alexander Larsson,20,Brynäs,F,20,2,3,5,4,0,0,20,20,6,7,5,2,12:17
,229,Martin Grönberg,22,Leksand,F,29,2,3,5,4,0,0,18,14,10,6,7,-1,7:19
,230,Johan Markusson,38,Växjö,F,41,2,3,5,50,0,0,39,58,18,6,12,-6,11:33
,231,Sebastian Aho,63,Skellefteå,D,21,1,4,5,2,0,0,10,0,6,10,11,-1,9:18
,232,Filip Sandberg,16,HV71,F,30,1,4,5,8,0,0,24,19,8,6,7,-1,8:56
,233,Tim Heed,4,Skellefteå,D,40,1,4,5,2,0,1,36,5,17,19,12,7,12:55
,234,Joonas Rönnberg,29,Leksand,D,55,1,4,5,43,0,0,26,71,78,18,23,-5,16:43
,235,Emil Djuse,57,Frölunda,D,18,0,5,5,6,0,0,13,5,9,8,2,6,10:22
,236,Anton Blidh,18,Frölunda,F,24,0,5,5,2,0,0,31,23,14,8,8,0,11:15
,237,Robin Gartner,2,Örebro,D,36,0,5,5,6,0,0,25,7,14,13,12,1,11:59
,238,Tobias Forsberg,19,Leksand,F,49,3,1,4,40,1,1,54,89,20,7,17,-10,9:38
,239,Charles Bertrand,36,Färjestad,F,31,2,2,4,6,0,0,28,8,6,5,7,-2,6:38
,240,Peter Cehlarik,26,Luleå,F,32,2,2,4,4,1,0,29,4,6,6,10,-4,8:13
,241,Tom Nilsson,43,Frölunda,D,50,2,2,4,22,0,0,44,74,41,24,29,-5,18:30
,242,Christopher Aspeqvist,90,AIK,D,51,2,2,4,12,0,0,42,31,27,21,29,-8,13:24
,243,Robin Jacobsson,5,Brynäs,D,53,2,2,4,18,0,0,60,62,35,27,32,-5,15:58
,244,Linus Omark,67,Luleå,F,5,1,3,4,0,0,0,10,2,2,1,1,0,17:37
,245,Mark Matheson,14,Linköping,D,25,1,3,4,10,0,1,9,3,24,20,13,7,17:34
,246,Alexander Lindgren,10,Brynäs,F,33,1,3,4,0,1,0,13,4,12,5,11,-6,9:12
,247,Christoffer Norgren,29,Örebro,D,49,1,3,4,24,0,0,28,26,33,24,23,1,15:16
,248,Johan Svedberg,7,Leksand,D,53,1,3,4,22,0,0,67,36,67,29,29,0,20:06
,249,Lawrence Pilut,20,HV71,D,22,0,4,4,18,0,0,14,5,10,11,15,-4,12:02
,250,Jonathan Andersson,22,AIK,D,42,0,4,4,12,0,0,25,4,10,14,27,-13,10:32
,251,Robin Dahlström,29,Örebro,F,27,3,0,3,10,0,0,26,26,14,6,6,0,9:50
,252,Sebastian Strandberg,29,HV71,F,32,3,0,3,2,0,0,22,26,15,6,14,-8,12:25
,253,Jere Sallinen,76,Örebro,F,6,2,1,3,0,1,1,11,10,2,4,3,1,16:07
,254,Kyle Beach,8,HV71,F,7,2,1,3,35,0,0,14,7,1,3,7,-4,12:57
,255,Aaron Gagnon,11,HV71,F,9,2,1,3,4,0,0,8,4,5,4,4,0,11:37
,256,Garrett Stafford,57,Färjestad,D,12,2,1,3,6,1,0,25,8,8,9,9,0,17:45
,257,Johan Johnsson,41,HV71,F,24,2,1,3,2,0,0,7,3,4,3,5,-2,7:09
,257,Jakub Vrana,13,Linköping,F,24,2,1,3,2,0,0,22,4,5,6,9,-3,8:32
,259,Dennis Nordström,56,AIK,F,29,2,1,3,0,0,0,16,16,10,8,8,0,7:36
,260,Albin Lorentzon,27,Linköping,D,49,2,1,3,47,0,0,12,42,20,11,21,-10,9:27
,261,Marcus Fagerudd,29,Luleå,D,11,1,2,3,0,0,1,15,4,3,2,3,-1,8:39
,262,Theodor Lennström,34,AIK,D,26,1,2,3,2,1,0,12,13,5,7,10,-3,9:12
,263,Dennis Persson,29,Brynäs,D,34,1,2,3,10,0,0,12,7,11,9,14,-5,10:37
,264,Fredrik Svensson,4,AIK,D,38,1,2,3,48,0,0,14,34,25,18,26,-8,17:08
,265,Niclas Lundgren,8,Växjö,D,55,1,2,3,10,0,0,36,6,32,27,20,7,16:44
,266,Hannu Pikkarainen,48,Leksand,D,7,0,3,3,2,0,0,9,4,4,3,4,-1,15:35
,267,Emil Molin,24,Brynäs,F,21,0,3,3,0,0,0,9,3,4,4,7,-3,6:53
,268,Robin Jonsson,39,Luleå,D,41,0,3,3,18,0,0,49,24,28,14,16,-2,16:45
,269,Tom Linder,55,Leksand,D,55,0,3,3,48,0,0,32,38,35,18,18,0,13:53
,270,Fredrik Warg,29,Brynäs,F,17,2,0,2,8,0,0,13,18,4,3,2,1,12:10
,271,Pelle Prestberg,10,Färjestad,F,9,1,1,2,2,0,0,8,0,1,2,0,2,7:27
,272,Erik Andersson,38,HV71,F,21,1,1,2,2,0,0,11,4,3,4,10,-6,7:26
,273,Linus Hultström,33,Linköping,D,31,1,1,2,8,0,0,38,20,9,8,14,-6,13:12
,274,Jonas Karlsson,27,Örebro,F,37,1,1,2,8,0,0,25,12,9,4,11,-7,9:10
,275,Emil Kåberg,27,Örebro,F,39,1,1,2,126,0,1,46,68,55,1,16,-15,13:09
,276,Bobbo Petersson,53,Örebro,D,40,1,1,2,14,0,0,23,9,25,10,22,-12,12:17
,276,Marcus Oskarsson,7,Luleå,D,40,1,1,2,2,0,0,24,1,14,13,14,-1,11:37
,278,Joachim Nermark,80,Linköping,F,41,1,1,2,2,0,0,20,24,7,4,17,-13,8:28
,279,Christoffer Persson,6,Frölunda,D,48,1,1,2,32,0,0,33,35,27,23,13,10,12:31
,280,Johan Lindström,79,HV71,F,54,1,1,2,8,1,1,37,26,12,7,22,-15,8:07
,281,Mattias Karlsson,20,HV71,D,11,0,2,2,2,0,0,12,12,10,4,10,-6,18:57
,282,Pontus Widerström,67,Frölunda,F,13,0,2,2,2,0,0,12,9,8,5,5,0,9:28
,283,Simon Löf,14,Brynäs,D,27,0,2,2,6,0,0,11,16,29,10,15,-5,16:24
,284,Henrik Karlsson,1,Skellefteå,Gk,36,0,2,2,0,0,0,0,0,0,36,21,15,0:00
,285,Mattias Nilsson,4,Leksand,D,47,0,2,2,4,0,0,15,8,20,8,19,-11,7:33
,286,Markus Svensson,35,Skellefteå,Gk,49,0,2,2,0,0,0,0,0,0,66,49,17,0:00
,287,David Rautio,30,Luleå,Gk,51,0,2,2,0,0,0,0,0,0,58,47,11,0:00
,288,Jonathan Johnson,22,Frölunda,F,2,1,0,1,0,0,0,3,0,0,1,0,1,6:26
,288,Akim Aliu,,AIK,D,2,1,0,1,6,0,0,5,1,0,1,2,-1,14:24
,290,Martin Karlsson,100,AIK,F,4,1,0,1,0,0,1,3,3,3,0,2,-2,12:10
,291,Brian Willsie,42,Örebro,F,6,1,0,1,6,0,1,16,2,1,1,1,0,19:40
,292,Jacob Spångberg,77,AIK,D,7,1,0,1,0,0,0,4,1,2,2,2,0,8:50
,293,Victor Ekarv,55,AIK,F,12,1,0,1,0,0,0,3,1,1,1,1,0,3:45
,293,Nicklas Strid,10,Brynäs,F,12,1,0,1,2,0,0,6,4,1,1,2,-1,2:29
,295,Stefan Gråhns,41,Växjö,F,13,1,0,1,8,0,0,14,14,2,1,6,-5,8:56
,296,Guntis Galvins,52,AIK,D,15,1,0,1,2,0,0,15,7,9,6,11,-5,16:12
,297,Adam Brodecki,68,Brynäs,F,18,1,0,1,2,0,0,11,6,3,3,2,1,5:18
,297,Lars Bryggman,22,Luleå,F,18,1,0,1,2,0,0,19,0,3,4,4,0,7:21
,299,Christopher Fish,29,Linköping,F,21,1,0,1,8,0,0,9,17,3,1,5,-4,5:28
,300,Gustav Rydahl,15,Frölunda,F,22,1,0,1,14,1,0,10,19,17,2,5,-3,7:51
,301,Mikael Johansson,95,Växjö,F,27,1,0,1,2,0,0,8,19,12,4,4,0,5:20
,302,Thomas Enström,11,Örebro,F,40,1,0,1,4,0,0,16,23,15,4,5,-1,8:10
,303,Jesper Williamsson,34,HV71,D,52,1,0,1,16,0,0,44,31,18,11,25,-14,11:20
,304,Kevin Elgestål,21,Frölunda,F,2,0,1,1,0,0,0,1,3,0,1,1,0,10:16
,304,Carsen Germyn,82,AIK,F,2,0,1,1,2,0,0,2,1,2,0,2,-2,17:07
,306,Dmytro Timashov,23,MODO,F,3,0,1,1,0,0,0,1,0,0,1,2,-1,3:41
,307,Robin Söderqvist,63,Frölunda,F,5,0,1,1,0,0,0,6,0,1,1,0,1,6:18
,308,Michael Nylander,92,AIK,F,8,0,1,1,4,0,0,6,1,2,3,10,-7,16:27
,308,Johan Olofsson,8,Färjestad,F,8,0,1,1,2,0,0,4,1,0,3,0,3,4:42
,308,Linus Fröberg,71,Färjestad,F,8,0,1,1,0,0,0,3,0,4,2,2,0,10:09
,311,Axel Eidstedt,49,HV71,D,11,0,1,1,8,0,0,2,4,8,4,3,1,8:54
,311,Almen Bibic,3,Leksand,D,11,0,1,1,0,0,0,3,9,6,2,3,-1,7:01
,313,Carl Dahlström,32,Linköping,D,12,0,1,1,0,0,0,7,3,6,7,7,0,15:22
,314,David Liffiton,36,Färjestad,D,13,0,1,1,47,0,0,11,12,6,2,11,-9,13:18
,315,Johan Larsson,3,HV71,D,17,0,1,1,6,0,0,15,5,5,3,9,-6,8:59
,316,Joakim Hagelin,68,Linköping,F,19,0,1,1,4,0,0,8,5,3,1,4,-3,5:30
,317,David Westlund,2,Brynäs,D,21,0,1,1,0,0,0,1,1,4,2,2,0,2:24
,318,Teemu Lassila,35,Växjö,Gk,22,0,1,1,25,0,0,0,0,0,23,18,5,0:00
,319,Rasmus Edström,32,Skellefteå,D,23,0,1,1,2,0,0,11,2,10,5,5,0,7:18
,320,Mark Owuya,30,Luleå,Gk,25,0,1,1,0,0,0,0,0,0,21,13,8,0:00
,321,Daniel Ljunggren,90,Brynäs,F,28,0,1,1,2,0,0,9,4,3,3,7,-4,5:43
,322,Danny Taylor,41,Färjestad,Gk,39,0,1,1,0,0,0,0,0,0,20,25,-5,0:00
,323,Jesper Pettersson,37,Linköping,D,48,0,1,1,30,0,0,21,52,15,18,26,-8,13:09
,324,Oscar Alsenfelt,69,Leksand,Gk,51,0,1,1,0,0,0,0,0,0,69,77,-8,0:00
,324,Tim Sandberg,31,Örebro,Gk,51,0,1,1,4,0,0,0,0,0,57,64,-7,0:00
,324,Henrik Lundberg,1,Örebro,Gk,51,0,1,1,0,0,0,0,0,0,26,31,-5,0:00
,327,Gustaf Wesslau,32,HV71,Gk,52,0,1,1,0,0,0,0,0,0,93,101,-8,0:00
,328,Daniel Larsson,,AIK,Gk,53,0,1,1,2,0,0,0,0,0,66,87,-21,0:00
,328,Lars Johansson,1,Frölunda,Gk,53,0,1,1,0,0,0,0,0,0,45,39,6,0:00
,330,Christian Engstrand,1,Linköping,Gk,54,0,1,1,0,0,0,0,0,0,71,67,4,0:00
,330,Linus Fernström,39,Frölunda,Gk,54,0,1,1,0,0,0,0,0,0,59,46,13,0:00
,332,Linus Ullmark,30,MODO,Gk,55,0,1,1,4,0,0,0,0,0,59,54,5,0:00
,333,Joel Lassinantti,34,Luleå,Gk,1,0,0,0,0,0,0,0,0,0,0,0,0,0:00
,333,Filip Ahl,93,HV71,F,1,0,0,0,0,0,0,0,0,0,0,1,-1,5:25
,333,Julius Bergman,63,Frölunda,D,1,0,0,0,4,0,0,3,0,0,0,0,0,12:00
,333,Jens Högbom,,Luleå,D,1,0,0,0,2,0,0,0,0,0,0,0,0,6:47
,333,Juliuz Persson,20,Färjestad,F,1,0,0,0,0,0,0,0,0,0,0,0,0,1:04
,333,Marcus Karlström,28,AIK,D,1,0,0,0,0,0,0,0,0,0,0,0,0,4:34
,333,Olov Lundqvist,27,Luleå,D,1,0,0,0,0,0,0,0,0,1,0,0,0,11:46
,333,Daniel Muzito Bagenda,19,MODO,F,1,0,0,0,0,0,0,0,0,0,0,0,0,2:15
,333,Lukas Vopelka,26,Örebro,F,1,0,0,0,0,0,0,0,0,0,0,0,0,0:00
,333,Markus Söberg,93,Frölunda,F,1,0,0,0,0,0,0,1,0,0,0,0,0,2:05
,333,Emil Larsson,36,Brynäs,F,1,0,0,0,12,0,0,0,0,0,0,3,-3,3:17
,333,Marcus Fornell,9,Linköping,F,1,0,0,0,0,0,0,0,0,0,0,0,0,1:28
,333,Joel Kellman,11,HV71,F,1,0,0,0,0,0,0,0,0,0,0,2,-2,0:39
,333,Oskar Nilsson,,Luleå,F,1,0,0,0,0,0,0,0,0,0,0,0,0,1:09
,333,Fabian Norberg,7,MODO,D,1,0,0,0,0,0,0,0,0,0,0,0,0,0:00
,333,Oskar Niklasson,,Färjestad,D,1,0,0,0,0,0,0,0,0,0,0,0,0,0:08
,333,David Suvanto,33,Leksand,F,1,0,0,0,0,0,0,0,0,0,0,0,0,6:33
,333,Viktor Romfors,,HV71,F,1,0,0,0,0,0,0,2,1,0,0,0,0,7:34
,333,Fredric Anderberg,52,AIK,F,1,0,0,0,0,0,0,1,0,0,0,1,-1,6:37
,352,Carl-Johan Meyer,,Brynäs,D,2,0,0,0,0,0,0,0,0,0,0,0,0,0:00
,352,Pierre Johnsson,2,Frölunda,D,2,0,0,0,4,0,0,3,2,0,1,1,0,9:26
,352,Patrik Enberg,,Skellefteå,F,2,0,0,0,0,0,0,0,1,0,0,0,0,1:33
,352,Anton Hedberg,,Brynäs,Gk,2,0,0,0,0,0,0,0,0,0,0,0,0,0:00
,352,Christoffer Ehn,21,Frölunda,F,2,0,0,0,0,0,0,1,2,0,0,0,0,7:16
,352,Kalle Jellvert,42,Örebro,F,2,0,0,0,0,0,0,0,0,0,0,0,0,0:00
,352,Johan Sellerstrand,,AIK,F,2,0,0,0,0,0,0,1,1,1,0,2,-2,8:12
,352,Erik Hanses,34,Skellefteå,Gk,2,0,0,0,0,0,0,0,0,0,1,2,-1,0:00
,352,Anton Öhman,36,Skellefteå,D,2,0,0,0,0,0,0,1,2,0,1,0,1,10:28
,352,Per Svensson,5,AIK,D,2,0,0,0,2,0,0,1,5,0,0,1,-1,12:42
,352,Jimmie Jansson,,HV71,D,2,0,0,0,2,0,0,0,0,0,0,1,-1,2:50
,352,Daniel Sperrle,1,Linköping,Gk,2,0,0,0,0,0,0,0,0,0,0,0,0,0:00
,364,Sebastian Fakt,,Leksand,F,3,0,0,0,0,0,0,0,0,0,0,0,0,4:37
,364,Viktor Kokman,99,HV71,Gk,3,0,0,0,0,0,0,0,0,0,0,0,0,0:00
,364,David Selberg,,Luleå,D,3,0,0,0,0,0,0,0,0,0,0,0,0,0:00
,364,Niklas Lundström,,AIK,Gk,3,0,0,0,0,0,0,0,0,0,2,4,-2,0:00
,364,Jesper Åkerman,,Linköping,D,3,0,0,0,0,0,0,0,0,0,0,0,0,0:00
,364,Kim Lilja,,Luleå,F,3,0,0,0,2,0,0,0,0,0,1,0,1,2:10
,364,Rasmus Strindö,,HV71,D,3,0,0,0,0,0,0,0,0,0,0,0,0,0:00
,364,Robin Kovacs,96,AIK,F,3,0,0,0,0,0,0,1,6,1,0,0,0,7:32
,364,Fredrik Bergvik,1,Frölunda,Gk,3,0,0,0,0,0,0,0,0,0,0,2,-2,0:00
,364,Robin Byström,,MODO,F,3,0,0,0,0,0,0,1,0,1,0,0,0,6:24
,364,Fredric Andersson,13,Linköping,F,3,0,0,0,0,0,0,3,0,1,0,0,0,8:12
,364,Johan Kallio,,Skellefteå,Gk,3,0,0,0,0,0,0,0,0,0,0,0,0,0:00
,364,Oliver Källbom,,Linköping,Gk,3,0,0,0,0,0,0,0,0,0,0,0,0,0:00
,364,Alexander Lindqvist Hansen,64,Växjö,F,3,0,0,0,2,0,0,1,2,0,0,0,0,6:35
,378,Adam Byström Johansson,87,Växjö,F,4,0,0,0,0,0,0,0,0,0,0,0,0,0:00
,378,Gustav Backström,5,Örebro,D,4,0,0,0,0,0,0,0,0,0,0,1,-1,3:27
,378,Axel Holmström,25,Skellefteå,F,4,0,0,0,0,0,0,1,2,0,0,2,-2,6:14
,378,Jekabs Redlihs,40,MODO,D,4,0,0,0,2,0,0,1,2,3,2,0,2,10:58
,378,Oskar Lindblom,96,Brynäs,F,4,0,0,0,0,0,0,2,0,0,0,2,-2,3:09
,383,Samuel Ward,99,Luleå,Gk,5,0,0,0,0,0,0,0,0,0,0,0,0,0:00
,383,Viktor Andrén,45,Växjö,Gk,5,0,0,0,0,0,0,0,0,0,0,0,0,0:00
,383,Luca Boltshauser,,Färjestad,Gk,5,0,0,0,0,0,0,0,0,0,0,0,0,0:00
,383,Gustaf Franzén,13,HV71,F,5,0,0,0,0,0,0,1,0,0,2,3,-1,8:16
,383,Victor Rollin Karlsson,15,Brynäs,F,5,0,0,0,0,0,0,0,0,0,0,0,0,0:00
,388,Anthon Eriksson,53,Luleå,F,6,0,0,0,0,0,0,0,0,0,0,0,0,0:00
,388,Edgars Klavins,27,AIK,F,6,0,0,0,0,0,0,0,1,1,0,1,-1,2:34
,388,Henrik Rommel,54,AIK,F,6,0,0,0,0,0,0,1,4,0,1,1,0,5:37
,391,Stefan Warg,6,Skellefteå,D,7,0,0,0,4,0,0,2,5,2,2,3,-1,12:34
,391,Anton Lindholm,54,Skellefteå,D,7,0,0,0,4,0,0,1,12,3,0,4,-4,7:48
,393,Jonathan Björklund,28,Brynäs,F,8,0,0,0,0,0,0,2,2,2,0,1,-1,2:04
,393,Christoffer Törngren,67,HV71,F,8,0,0,0,2,0,0,5,4,1,2,2,0,7:01
,393,Johannes Jönsson,38,Örebro,Gk,8,0,0,0,0,0,0,0,0,0,2,1,1,0:00
,393,Henrik Marklund,,Skellefteå,D,8,0,0,0,0,0,0,6,1,0,2,1,1,5:50
,397,Jonas Johansson,25,Brynäs,Gk,9,0,0,0,0,0,0,0,0,0,10,9,1,0:00
,397,Marcus Högberg,1,Linköping,Gk,9,0,0,0,0,0,0,0,0,0,8,3,5,0:00
,397,Henrik Hjerpe,30,Leksand,Gk,9,0,0,0,0,0,0,0,0,0,0,0,0,0:00
,400,Marcus Pettersson,8,Skellefteå,D,10,0,0,0,2,0,0,4,3,3,4,2,2,9:30
,400,Sean Sullivan,37,MODO,D,10,0,0,0,2,0,0,5,7,2,2,6,-4,8:11
,402,Pekka Tuokkola,30,Färjestad,Gk,11,0,0,0,0,0,0,0,0,0,2,10,-8,0:00
,402,Wilhelm Westlund,28,Färjestad,D,11,0,0,0,0,0,0,2,1,3,1,4,-3,8:39
,402,David Gunnarsson,35,MODO,F,11,0,0,0,0,0,0,2,0,0,0,0,0,2:05
,402,Victor Olofsson,11,MODO,F,11,0,0,0,0,0,0,3,0,0,0,0,0,2:11
,406,Devin DiDiomete,27,Färjestad,F,12,0,0,0,32,0,0,4,9,2,1,0,1,5:58
,406,Fredrik Forsberg,12,Leksand,F,12,0,0,0,0,0,0,1,0,0,0,0,0,0:44
,408,Simon Erlandsson,17,Leksand,D,14,0,0,0,0,0,0,2,4,5,0,3,-3,4:36
,409,Fredrik Carlsson,17,AIK,D,16,0,0,0,22,0,0,3,2,16,6,8,-2,9:48
,410,Calle Åsell,58,Örebro,F,17,0,0,0,0,0,0,4,0,0,0,2,-2,3:18
,410,Mattias Nörstebö,18,Brynäs,D,17,0,0,0,0,0,0,2,0,4,4,3,1,4:12
,412,Stefan Steen,26,Skellefteå,Gk,20,0,0,0,0,0,0,0,0,0,14,5,9,0:00
,412,Iiro Tarkki,35,Linköping,Gk,20,0,0,0,0,0,0,0,0,0,20,22,-2,0:00
,414,Robin Rahm,35,Brynäs,Gk,21,0,0,0,0,0,0,0,0,0,13,16,-3,0:00
,415,Andreas Andersson,54,Linköping,Gk,22,0,0,0,0,0,0,0,0,0,10,13,-3,0:00
,416,Bernhard Starkbaum,29,Brynäs,Gk,25,0,0,0,2,0,0,0,0,0,45,29,16,0:00
,416,Albin Carlson,14,MODO,D,25,0,0,0,2,0,0,20,1,9,5,6,-1,9:09
,418,Daniel Bellissimo,30,Luleå,Gk,28,0,0,0,0,0,0,0,0,0,16,19,-3,0:00
,419,Mattias Modig,33,Växjö,Gk,34,0,0,0,2,0,0,0,0,0,15,17,-2,0:00
,420,Jeremias Augustin,22,Växjö,D,40,0,0,0,22,0,0,26,9,24,12,14,-2,11:08
,421,Scott Munroe,29,Växjö,Gk,49,0,0,0,0,0,0,0,0,0,77,52,25,0:00
,422,Joel Gistedt,31,Leksand,Gk,50,0,0,0,0,0,0,0,0,0,8,26,-18,0:00
,423,Johan Holmqvist,40,Brynäs,Gk,53,0,0,0,2,0,0,0,0,0,44,52,-8,0:00
,424,Alexander Hamberg,35,AIK,Gk,54,0,0,0,0,0,0,0,0,0,23,30,-7,0:00
,425,Anton Forsberg,48,MODO,Gk,55,0,0,0,0,0,0,0,0,0,41,43,-2,0:00
,425,Fredrik Pettersson-Wentzel,53,Färjestad,Gk,55,0,0,0,2,0,0,0,0,0,76,51,25,0:00
,425,Jonas Gunnarsson,37,HV71,Gk,55,0,0,0,0,0,0,0,0,0,16,25,-9,0:00
,1,Bud Holloway,4,Skellefteå,F,55,20,51,71,36,2,9,178,79,10,55,30,25,18:29
,2,Carl Söderberg,17,Linköping,F,54,31,29,60,48,2,6,158,41,16,55,37,18,19:54
,3,Joakim Lindström,10,Skellefteå,F,53,18,36,54,56,6,1,185,9,7,40,29,11,19:19
,4,Pär Arlbrandt,40,Linköping,F,54,21,32,53,28,5,5,160,5,17,52,27,25,17:05
,5,Broc Little,41,AIK,F,55,16,30,46,24,2,5,139,10,8,37,40,-3,19:05
,6,Jason Krog,9,HV71,F,55,17,26,43,18,8,3,97,32,11,48,32,16,17:46
,7,Simon Hjalmarsson,59,Linköping,F,55,12,31,43,10,6,2,130,19,20,52,31,21,18:41
,8,Oscar Lindberg,24,Skellefteå,F,55,17,25,42,54,4,5,149,51,11,36,35,1,16:40
,9,Calle Järnkrok,19,Brynäs,F,53,13,29,42,12,3,5,136,15,8,30,32,-2,18:43
,10,Chris Lee,4,Färjestad,D,54,12,29,41,30,3,5,143,2,26,44,24,20,0:22
,11,Per Åslund,22,Färjestad,F,55,19,20,39,18,4,4,101,29,21,37,20,17,17:22
,12,Rhett Rakhshani,49,HV71,F,52,14,25,39,46,3,5,128,33,7,43,26,17,16:58
,13,Rickard Wallin,51,Färjestad,F,48,11,27,38,42,2,3,96,12,14,36,24,12,18:15
,14,Marcus Paulsson,53,Färjestad,F,55,19,18,37,16,7,5,115,31,6,33,22,11,14:54
,15,Christian Berglund,17,Färjestad,F,51,15,22,37,103,2,6,162,59,4,35,20,15,16:49
,16,Niklas Olausson,16,Luleå,F,49,11,25,36,14,3,1,80,5,15,27,17,10,18:22
,17,Ryan Gunderson,13,Brynäs,D,55,9,27,36,16,3,4,153,2,47,41,48,-7,1:46
,18,Jesper Fasth,18,HV71,F,47,18,17,35,4,1,5,86,35,16,39,26,13,18:20
,19,Per-Åge Skröder,10,MODO,F,51,16,19,35,34,3,7,114,46,14,33,30,3,18:10
,20,Jimmie Ericsson,21,Skellefteå,F,45,8,27,35,22,3,3,103,41,12,32,21,11,18:11
,21,Marcus Nilson,3,HV71,F,53,18,16,34,37,4,6,120,27,7,35,22,13,16:50
,22,Joel Lundqvist,20,Frölunda,F,55,12,22,34,57,2,4,78,106,18,36,33,3,19:37
,23,Richie Regehr,49,MODO,D,53,8,25,33,44,3,5,175,30,57,37,26,11,0:44
,24,Magnus Nygren,32,Färjestad,D,51,13,19,32,49,4,9,157,32,22,36,25,11,23:17
,25,Kyle Cumiskey,15,MODO,D,46,7,25,32,30,4,4,86,9,53,36,40,-4,2:30
,26,Mattias Janmark,10,AIK,F,55,14,17,31,32,1,4,92,20,28,31,35,-4,18:07
,27,Juhamatti Aaltonen,71,Rögle,F,42,12,19,31,22,3,0,116,15,3,26,36,-10,19:29
,28,Mike Iggulden,73,Rögle,F,55,13,17,30,38,1,4,111,27,7,29,43,-14,18:59
,29,Elias Lindholm,28,Brynäs,F,48,11,19,30,2,2,8,77,57,13,24,23,1,16:18
,30,Esa Pirnes,10,AIK,F,45,10,20,30,28,2,4,113,50,28,26,34,-8,19:25
,31,Tomi Kallio,71,Växjö,F,55,12,17,29,18,3,2,163,37,7,29,28,1,18:40
,32,Mattias Karlsson,20,HV71,D,55,9,20,29,39,5,1,155,80,42,52,31,21,22:42
,33,Johan Harju,24,Brynäs,F,55,18,10,28,16,1,6,143,24,13,30,39,-9,17:17
,34,Dennis Rasmussen,70,Växjö,F,42,16,12,28,28,4,2,68,27,8,22,23,-1,18:26
,35,Melker Karlsson,15,Skellefteå,F,44,13,15,28,14,2,4,64,31,31,33,13,20,16:56
,36,Alexander Barta,29,Rögle,F,55,11,17,28,41,1,3,97,10,13,20,36,-16,18:51
,37,Niklas Nordgren,13,Timrå,F,43,8,20,28,30,2,4,97,7,4,20,24,-4,17:39
,38,William Karlsson,71,HV71,F,50,4,24,28,12,2,0,102,32,19,37,20,17,17:31
,39,Magnus Johansson,7,Linköping,D,55,3,25,28,12,1,3,81,21,32,44,33,11,21:32
,40,Mario Kempe,70,MODO,F,53,15,12,27,12,2,5,143,46,15,24,23,1,16:21
,41,Dave Spina,12,MODO,F,55,10,17,27,32,1,2,107,16,10,26,18,8,14:13
,42,Oscar Möller,45,Skellefteå,F,28,18,8,26,2,3,7,127,18,3,19,15,4,17:19
,43,Sebastian Enterfeldt,59,Brynäs,F,48,13,13,26,18,4,4,70,105,25,24,34,-10,17:05
,44,Magnus Kahnberg,11,Frölunda,F,49,11,15,26,10,4,5,130,13,9,22,26,-4,16:46
,45,Toni Koivisto,21,Luleå,F,50,10,16,26,12,3,2,104,14,9,21,15,6,15:54
,46,Robert Rosén,87,Växjö,F,53,9,17,26,24,3,3,126,11,8,22,29,-7,18:10
,47,Mattias Bäckman,5,Linköping,D,52,2,24,26,34,1,0,67,5,33,42,36,6,20:06
,48,Patrik Carlsson,72,HV71,F,53,14,10,24,16,4,0,86,34,16,35,23,12,16:06
,49,Mattias Ritola,21,MODO,F,50,11,13,24,12,0,2,98,37,8,21,15,6,15:50
,50,Dick Axelsson,31,Frölunda,F,45,10,14,24,79,0,1,47,16,10,24,20,4,15:29
,51,Linus Klasen,86,Luleå,F,47,10,14,24,18,7,2,113,5,8,20,18,2,16:30
,52,Daniel Sondell,50,Rögle,D,51,6,18,24,14,1,3,88,6,17,31,44,-13,23:24
,53,Nicklas Jensen,46,AIK,F,50,17,6,23,16,5,6,123,17,3,18,30,-12,15:33
,54,Joonas Vihko,20,Luleå,F,49,15,8,23,12,2,2,90,30,2,30,19,11,15:23
,55,Niklas Fogström,36,Luleå,F,52,10,13,23,12,2,1,44,39,13,33,14,19,13:18
,56,Andreas Jämtin,18,/,F,46,9,14,23,95,1,2,93,76,6,23,26,-3,14:59
,56,Niklas Sundström,24,MODO,F,46,9,14,23,34,1,2,43,20,8,31,29,2,18:14
,58,Alexander Steen,20,MODO,F,20,8,15,23,28,2,3,80,31,8,16,11,5,20:25
,59,Chris Abbott,29,Luleå,F,49,8,15,23,59,1,2,66,33,15,30,23,7,18:36
,60,Jonas Liwing,23,AIK,D,54,8,15,23,14,2,5,55,11,39,28,39,-11,22:19
,61,Mat Robinson,33,Timrå,D,55,7,16,23,30,3,3,102,40,68,23,34,-11,1:33
,62,Elias Fälth,33,HV71,D,49,5,18,23,24,0,0,121,22,24,42,32,10,19:57
,63,Pontus Petterström,18,Skellefteå,F,45,11,11,22,14,3,3,69,12,23,28,11,17,14:15
,64,Ted Brithén,90,Rögle,F,53,10,12,22,4,1,2,105,33,13,17,26,-9,15:00
,65,Erik Forssell,20,Skellefteå,F,30,9,13,22,12,0,3,52,4,15,13,12,1,16:56
,66,David Petrasek,22,HV71,D,49,8,14,22,44,1,2,95,29,20,45,26,19,21:08
,67,Marcel Müller,41,MODO,F,53,8,14,22,34,2,0,91,35,15,22,25,-3,13:47
,68,Ladislav Nagy,22,MODO,F,49,7,15,22,32,1,1,125,18,6,27,20,7,16:01
,69,Christian Bäckman,5,Frölunda,D,54,7,15,22,36,1,4,76,13,49,30,34,-4,22:16
,70,Pierre-Edouard Bellemare,41,Skellefteå,F,29,6,16,22,47,1,2,57,30,12,23,15,8,15:52
,71,Johannes Salmonsson,25,Linköping,F,53,10,11,21,16,2,1,78,11,4,26,25,1,15:16
,72,Ville Lajunen,47,Färjestad,D,53,7,14,21,16,1,5,84,2,32,40,28,12,20:09
,73,Petr Vampola,44,Växjö,F,42,4,17,21,30,1,0,77,3,2,26,28,-2,17:46
,74,Linus Persson,25,Luleå,F,51,9,11,20,6,2,3,68,8,9,19,11,8,14:49
,75,Joakim Hillding,24,Färjestad,F,54,6,14,20,22,2,1,85,28,6,23,11,12,12:19
,76,Andreas Thuresson,12,Brynäs,F,48,11,8,19,50,3,0,114,96,4,23,26,-3,16:33
,77,Morten Madsen,29,MODO,F,55,11,8,19,4,0,0,93,32,10,22,30,-8,15:33
,78,Marius Holtet,12,Färjestad,F,52,9,10,19,50,2,1,99,112,22,22,22,0,15:53
,79,Jack Connolly,20,Färjestad,F,34,8,11,19,16,1,3,63,3,4,18,14,4,16:13
,80,Björn Melin,9,AIK,F,49,7,12,19,16,2,2,94,51,3,20,30,-10,14:58
,81,Jonathan Granström,31,Brynäs,F,54,4,15,19,101,0,1,72,77,17,20,35,-15,16:45
,82,Daniel Widing,41,Brynäs,F,53,10,8,18,56,1,1,133,23,4,21,29,-8,12:50
,83,Mathias Tjärnqvist,71,Rögle,F,54,10,8,18,30,1,4,91,80,43,21,38,-17,18:22
,84,Fabian Brunnström,54,Frölunda,F,51,9,9,18,24,3,0,106,21,2,26,18,8,14:25
,85,Petter Emanuelsson,11,Skellefteå,F,54,9,9,18,8,2,2,74,19,6,22,13,9,10:42
,86,Jonathan Hedström,71,Timrå,F,52,6,12,18,34,1,1,80,31,2,16,35,-19,18:08
,87,Johan Davidsson,76,HV71,F,51,5,13,18,14,0,0,65,8,4,25,26,-1,17:12
,88,Mikael Johansson,85,Färjestad,F,32,4,14,18,12,1,1,48,3,2,17,12,5,14:22
,89,Joonas Lehtivuori,3,MODO,D,55,3,15,18,16,1,1,78,15,55,32,42,-10,21:17
,90,Noah Welch,5,Växjö,D,43,8,9,17,56,0,2,96,85,32,28,32,-4,21:37
,91,Anton Axelsson,6,Frölunda,F,53,8,9,17,14,0,1,84,15,8,26,14,12,14:38
,92,Oscar Steen,45,AIK,F,55,7,10,17,26,1,0,48,7,12,22,32,-10,15:45
,93,Daniel Gunnarsson,16,Luleå,D,53,6,11,17,20,2,3,108,9,19,29,18,11,18:35
,94,Mika Pyörälä,27,Luleå,F,32,5,12,17,6,0,1,57,17,11,19,17,2,16:51
,95,Cam Abbott,24,Luleå,F,52,5,12,17,44,0,1,98,39,6,27,12,15,13:28
,96,Jonas Nordquist,39,Brynäs,F,44,4,13,17,20,1,0,58,5,6,18,25,-7,14:42
,97,Jonas Holös,6,Växjö,D,55,4,13,17,10,0,2,97,22,21,27,24,3,22:46
,98,Per Hallin,8,Timrå,F,49,11,5,16,56,3,1,89,33,9,18,26,-8,15:45
,99,Mattias Weinhandl,80,Linköping,F,30,9,7,16,14,3,3,66,12,8,14,21,-7,16:30
,100,Eric Himelfarb,39,Linköping,F,49,9,7,16,24,1,2,78,28,11,17,23,-6,14:19
,101,Joachim Rohdin,72,Timrå,F,53,8,8,16,20,0,2,80,30,12,13,24,-11,13:37
,102,Max Friberg,12,Timrå,F,55,8,8,16,12,0,4,111,41,22,12,22,-10,14:23
,103,Kim Hirschovits,44,Luleå,F,39,7,9,16,28,0,0,43,6,7,21,9,12,14:13
,104,Andreas Molinder,24,Timrå,F,42,7,9,16,6,1,1,46,18,3,15,17,-2,14:49
,105,Patrik Lundh,79,Färjestad,F,50,7,9,16,51,2,0,76,19,10,24,14,10,15:37
,106,Per-Johan Axelsson,11,Frölunda,F,49,6,10,16,10,3,1,43,9,12,21,14,7,14:47
,107,Fredrik Eriksson,8,Frölunda,D,55,6,10,16,20,2,0,105,25,51,34,23,11,20:01
,108,Lukas Kilström,5,Luleå,D,49,5,11,16,55,1,1,72,35,25,33,17,16,17:44
,109,Henrik Tömmernes,7,Frölunda,D,54,5,11,16,28,1,2,106,13,39,28,37,-9,22:34
,110,Daniel Fernholm,24,HV71,D,43,4,12,16,36,1,0,60,48,23,26,22,4,18:56
,111,Max Görtz,17,Färjestad,F,50,9,6,15,4,1,0,70,19,8,19,13,6,8:52
,112,Sebastian Karlsson,12,Linköping,F,54,7,8,15,24,0,4,69,28,14,13,22,-9,14:04
,113,Jesper Ollas,17,Brynäs,F,55,7,8,15,16,2,1,114,49,11,21,37,-16,14:11
,114,Liam Reddox,85,Växjö,F,51,5,10,15,6,0,1,101,68,21,19,26,-7,16:49
,115,Jakob Johansson,26,Rögle,F,55,5,10,15,49,1,3,76,13,14,16,30,-14,16:13
,116,Sebastian Lauritzen,16,Brynäs,F,43,2,13,15,26,0,2,84,13,16,13,21,-8,14:12
,117,Christian Söderström,82,Timrå,F,47,7,7,14,16,1,1,98,27,5,22,26,-4,17:17
,118,Peter Öberg,27,MODO,F,51,6,8,14,14,2,3,51,32,19,12,22,-10,13:38
,119,Jonas Almtorp,16,Linköping,F,53,6,8,14,20,0,3,64,24,14,19,19,0,14:36
,120,Matt Duchene,91,Frölunda,F,19,4,10,14,12,1,1,39,12,3,18,8,10,17:30
,121,Oscar Fantenberg,66,HV71,D,28,3,11,14,12,1,3,70,27,20,22,14,8,20:05
,122,Niclas Burström,3,Skellefteå,D,51,3,11,14,26,3,0,40,8,13,31,22,9,17:46
,123,Niclas Hävelid,28,Linköping,D,55,3,11,14,28,1,3,50,23,54,28,29,-1,20:10
,124,Robin Figren,23,Linköping,F,55,9,4,13,28,4,1,88,29,11,15,27,-12,13:02
,125,Anton Hedman,8,Luleå,F,46,7,6,13,32,1,3,73,107,6,14,12,2,10:12
,126,Mathis Olimb,46,Frölunda,F,30,6,7,13,6,1,4,35,2,2,8,16,-8,15:39
,127,Jens Jakobs,26,Luleå,F,46,6,7,13,4,4,1,64,1,4,16,17,-1,9:54
,128,Oscar Ahlström,86,AIK,F,55,6,7,13,8,0,1,89,13,9,15,25,-10,12:18
,129,Matt Murley,19,Timrå,F,13,5,8,13,22,1,0,32,4,3,10,5,5,17:56
,130,Jari Tolsa,17,Frölunda,F,52,5,8,13,16,2,0,48,27,9,17,18,-1,11:48
,131,Patrik Zackrisson,26,Linköping,F,25,4,9,13,10,2,2,32,11,5,10,10,0,16:35
,132,Martin Sevc,55,Skellefteå,D,37,3,10,13,48,0,0,54,44,13,31,19,12,18:45
,133,Tomas Skogs,23,Skellefteå,D,51,3,10,13,42,1,2,34,55,33,39,18,21,18:03
,134,Fredrik Lindgren,61,Skellefteå,D,50,2,11,13,26,2,0,66,26,26,32,20,12,18:46
,135,Tobias Viklund,16,AIK,D,53,2,11,13,28,0,0,96,61,39,33,48,-15,22:01
,136,Sebastian Erixon,50,Timrå,D,54,2,11,13,14,0,0,99,27,48,29,37,-8,22:30
,137,John Klingberg,15,Skellefteå,D,25,1,12,13,6,0,0,37,9,1,19,9,10,17:30
,138,Viktor Stålberg,25,Frölunda,F,11,7,5,12,10,1,1,37,7,2,13,8,5,17:16
,139,Viktor Arvidsson,9,Skellefteå,F,49,7,5,12,12,0,2,93,11,15,14,14,0,11:03
,140,Tom Preissing,42,Rögle,D,29,5,7,12,10,1,4,48,6,11,13,21,-8,21:48
,141,Oscar Sundh,13,HV71,F,33,5,7,12,12,2,0,42,33,7,20,17,3,15:17
,142,Karl Fabricius,52,Luleå,F,50,5,7,12,32,2,0,78,10,13,24,8,16,13:17
,143,Per Ledin,97,HV71,F,55,5,7,12,129,0,0,66,84,9,19,21,-2,14:07
,144,Pavel Skrbek,11,Luleå,D,31,4,8,12,14,1,1,39,7,31,14,14,0,20:00
,145,Alexander Larsson,20,Timrå,F,33,4,8,12,18,0,3,52,35,11,14,20,-6,16:19
,146,Stefan Johansson,16,AIK,D,47,4,8,12,20,1,2,77,33,34,18,29,-11,21:57
,147,Erik Josefsson,60,Växjö,F,55,4,8,12,16,1,2,61,26,19,16,19,-3,15:14
,148,Simon Önerud,11,Timrå,F,44,6,5,11,10,2,0,72,37,9,14,18,-4,13:58
,149,Jan Sandström,7,Luleå,D,46,6,5,11,18,0,0,74,24,49,31,11,20,17:22
,150,Fredrik Hynning,12,AIK,F,50,5,6,11,18,2,0,61,28,15,10,23,-13,15:06
,150,Alexander Johansson,16,Växjö,F,50,5,6,11,12,0,0,63,47,10,15,11,4,12:30
,152,Victor Ahlström,68,AIK,F,55,5,6,11,12,0,1,78,14,4,13,25,-12,11:54
,153,Christian Sandberg,21,AIK,F,31,4,7,11,8,2,0,52,17,11,12,16,-4,14:41
,154,Kristian Forsberg,28,MODO,F,53,4,7,11,22,1,0,66,59,33,16,25,-9,13:50
,155,Johan Fransson,10,Luleå,D,55,3,8,11,12,0,1,125,34,21,33,27,6,21:35
,156,Fredrik Sjöström,18,Frölunda,F,50,5,5,10,16,1,0,57,55,21,14,20,-6,12:21
,157,Anders Bastiansen,20,Färjestad,F,53,5,5,10,38,1,0,59,21,28,17,21,-4,14:49
,158,Johan Forsberg,9,Skellefteå,F,39,4,6,10,12,0,0,36,33,6,14,8,6,10:11
,159,Kristofer Berglund,2,Växjö,D,54,3,7,10,14,1,1,67,37,26,22,35,-13,20:58
,160,Mads Hansen,24,Brynäs,F,42,2,8,10,38,0,1,54,11,16,11,21,-10,15:08
,161,Robin Jonsson,39,Luleå,D,49,2,8,10,24,0,0,47,18,32,32,8,24,16:24
,162,Brendan Bell,22,Frölunda,D,21,1,9,10,8,0,0,30,8,14,13,11,2,20:42
,163,Fredrik Carlsson,17,AIK,D,46,1,9,10,10,0,0,19,11,39,24,28,-4,17:28
,164,Sebastian Collberg,49,Frölunda,F,35,6,3,9,6,3,1,38,4,4,7,7,0,10:01
,165,Steve Saviano,15,Växjö,F,55,6,3,9,4,2,1,77,12,4,10,17,-7,10:34
,166,Joakim Nordström,13,AIK,F,43,5,4,9,29,0,1,64,36,17,10,22,-12,14:43
,167,Fredrik Warg,29,Rögle,F,34,4,5,9,10,1,3,45,33,6,14,29,-15,17:55
,168,Mats Rosseli Olsen,51,Frölunda,F,54,3,6,9,8,1,0,51,22,14,9,13,-4,9:10
,169,Christoffer Persson,6,Frölunda,D,52,2,7,9,28,0,0,22,37,34,25,21,4,16:39
,170,Ole-Kristian Tollefsen,55,Färjestad,D,54,2,7,9,92,0,0,50,64,52,39,31,8,21:01
,170,Nicklas Lasu,31,Frölunda,F,54,2,7,9,18,1,0,66,73,13,14,25,-11,14:35
,172,Anton Grundel,73,Färjestad,D,46,1,8,9,16,0,0,52,29,31,34,18,16,19:08
,173,Oliver Bohm,3,Frölunda,D,49,1,8,9,16,0,0,42,12,26,18,19,-1,14:25
,174,Brad Moran,20,Växjö,F,37,5,3,8,24,2,2,54,15,9,12,27,-15,16:19
,174,Johan Lindström,79,HV71,F,37,5,3,8,4,0,0,32,13,3,12,8,4,7:44
,176,Linus Hultström,33,Linköping,D,55,5,3,8,30,0,0,66,20,22,21,27,-6,13:19
,176,Dennis Everberg,18,Rögle,F,55,5,3,8,47,0,0,57,75,42,13,27,-14,13:00
,178,Richard Lintner,22,Rögle,D,12,3,5,8,10,0,3,28,4,9,6,16,-10,0:03
,179,Sami Sandell,40,Luleå,F,40,3,5,8,12,1,1,64,19,4,13,5,8,11:19
,180,Johan Alm,,Skellefteå,D,55,3,5,8,42,1,0,52,56,27,33,24,9,15:59
,181,Fredrik Svensson,4,Luleå,D,37,2,6,8,18,1,0,23,23,19,22,18,4,14:04
,182,Daniel Grillfors,32,Linköping,D,43,2,6,8,22,0,1,39,35,25,25,23,2,17:16
,183,Yared Hagos,91,Timrå,F,45,2,6,8,42,0,1,62,18,11,7,13,-6,14:15
,184,Christian Djoos,,Brynäs,D,47,2,6,8,38,1,0,47,11,30,25,26,-1,15:35
,185,Jonas Ahnelöv,55,MODO,D,53,2,6,8,22,1,1,101,56,61,41,37,4,23:33
,186,Christopher Liljewall,52,Rögle,F,55,2,6,8,18,1,0,58,41,14,15,22,-7,13:07
,187,Mikko Luoma,5,HV71,D,47,1,7,8,48,1,0,45,10,9,21,21,0,14:09
,188,Jan Hlavac,27,Växjö,F,13,5,2,7,2,3,2,39,6,4,6,1,5,18:35
,189,Martin Lundberg,27,Skellefteå,F,53,5,2,7,53,1,2,62,83,32,16,6,10,13:37
,190,Jan Urbas,9,Växjö,F,52,4,3,7,4,0,0,81,43,10,11,24,-13,12:56
,191,Cody Franson,44,Brynäs,D,26,3,4,7,10,1,1,48,37,23,14,18,-4,21:15
,192,Adam Pettersson,12,Skellefteå,F,53,3,4,7,24,1,0,46,34,9,8,6,2,11:49
,192,Johan Markusson,38,Växjö,F,53,3,4,7,30,0,0,49,78,30,15,13,2,12:01
,194,Jesper Jensen,41,Rögle,D,43,1,6,7,40,0,1,57,27,26,25,36,-11,19:18
,195,Jesper Dahlroth,6,Timrå,D,48,1,6,7,14,0,0,49,24,11,12,11,1,10:15
,196,Andreas Frisk,3,AIK,D,52,1,6,7,12,0,0,37,4,23,26,23,3,13:35
,197,Viktor Lindgren,10,Rögle,F,27,4,2,6,10,1,1,33,7,6,7,15,-8,14:37
,198,Tommy Kristiansen,16,HV71,F,41,4,2,6,43,0,0,31,38,4,8,10,-2,7:37
,199,Martin Röymark,27,Färjestad,F,55,4,2,6,22,0,0,63,63,18,16,11,5,12:55
,200,Peter Cehlarik,26,Luleå,F,8,3,3,6,0,0,0,10,4,2,10,2,8,11:17
,201,Ludwig Byström,,MODO,D,30,3,3,6,2,1,0,17,0,14,16,9,7,10:10
,202,Björn Svensson,26,MODO,F,40,3,3,6,6,1,0,36,13,5,9,12,-3,9:31
,203,Erik Andersson,2,Skellefteå,D,49,3,3,6,12,1,0,48,13,15,33,7,26,14:00
,204,Ryan Vesce,17,Skellefteå,F,22,2,4,6,12,1,0,24,5,3,12,10,2,11:07
,205,Lee Goren,37,Linköping,F,24,2,4,6,48,0,0,56,12,9,6,12,-6,17:23
,206,Sebastian Strandberg,29,HV71,F,45,2,4,6,6,0,0,27,11,6,10,10,0,7:01
,207,Erik Lindhagen,29,Linköping,F,53,2,4,6,24,1,0,50,16,4,10,12,-2,10:35
,208,Lasse Kukkonen,3,Rögle,D,54,2,4,6,30,1,0,47,24,61,23,40,-17,20:16
,209,Alexander Lindqvist Hansen,64,Rögle,F,55,2,4,6,22,0,0,60,48,8,12,16,-4,9:51
,210,Jeremias Augustin,22,Växjö,D,53,1,5,6,8,0,0,41,26,30,17,15,2,16:25
,211,Fredrik Styrman,2,/,D,46,0,6,6,30,0,0,29,8,26,13,28,-15,13:38
,212,Anton Wedin,57,Timrå,F,41,4,1,5,2,0,0,42,9,6,10,13,-3,9:26
,213,Radek Smolenak,70,Timrå,F,9,3,2,5,6,2,0,24,6,0,2,1,1,17:26
,214,Kris Beech,24,AIK,F,23,3,2,5,16,1,0,25,10,10,12,10,2,13:00
,215,Victor Berglind,67,Brynäs,D,37,3,2,5,8,1,1,23,9,21,10,17,-7,10:18
,216,Robin Sterner,18,Timrå,F,50,3,2,5,26,1,2,32,24,6,9,13,-4,10:22
,217,Martin Johansson,25,Brynäs,F,51,3,2,5,4,0,0,59,29,6,11,14,-3,9:40
,218,Jörgen Sundqvist,22,Brynäs,D,54,3,2,5,60,0,0,63,97,54,30,42,-12,20:22
,219,Anton Bengtsson,28,HV71,F,37,2,3,5,10,1,0,44,13,3,13,11,2,10:47
,220,Mikael Johansson,21,Frölunda,F,43,2,3,5,2,0,0,44,26,6,10,19,-9,16:15
,221,Mikko Kousa,48,MODO,D,16,1,4,5,12,0,1,32,10,17,6,12,-6,22:06
,222,Edgars Klavins,27,AIK,F,30,1,4,5,4,0,0,20,8,2,13,7,6,7:34
,223,Rasmus Edström,32,/,D,34,1,4,5,4,0,0,14,2,7,13,12,1,12:02
,224,Kalle Kaijomaa,56,Växjö,D,37,1,4,5,22,0,0,25,10,12,19,16,3,15:16
,225,Alexander Bonsaksen,47,Rögle,D,55,1,4,5,56,0,0,29,84,69,16,36,-20,18:20
,226,Ryan Lasch,81,Växjö,F,10,0,5,5,4,0,0,16,2,1,6,2,4,16:22
,227,Jonathan Carlsson,36,Timrå,D,45,0,5,5,6,0,0,45,14,22,13,21,-8,13:10
,228,Mats Lavander,62,Brynäs,F,46,0,5,5,62,0,0,39,15,10,9,14,-5,8:20
,229,Nils Bäckström,3,/,D,53,0,5,5,38,0,0,30,36,23,17,26,-9,13:15
,229,Victor Panelin Borg,,Rögle,D,53,0,5,5,40,0,0,28,9,17,12,23,-11,12:48
,231,Niclas Lundgren,8,Växjö,D,55,0,5,5,10,0,0,43,9,20,17,23,-6,15:22
,231,Daniel Rahimi,48,Linköping,D,55,0,5,5,56,0,0,35,121,33,26,19,7,15:59
,233,Mats Trygg,46,HV71,D,52,3,1,4,28,0,0,64,24,26,25,23,2,15:34
,234,Richard Demén Willaume,7,Timrå,D,27,2,2,4,12,1,1,18,8,8,12,14,-2,16:02
,235,Doug Lynch,44,Frölunda,D,33,2,2,4,18,1,0,42,3,17,17,14,3,15:07
,236,Patric Blomdahl,84,AIK,F,34,2,2,4,51,1,0,50,67,20,6,18,-12,13:14
,237,Jeremy Boyce,23,Timrå,F,49,2,2,4,12,1,0,45,23,15,16,18,-2,12:52
,237,Robin Jacobsson,5,/,D,49,2,2,4,42,1,0,40,59,18,17,17,0,13:46
,239,Dennis Persson,29,Brynäs,D,16,1,3,4,6,0,0,16,10,8,7,14,-7,16:08
,239,Dean Kukan,,Luleå,D,16,1,3,4,0,0,0,11,7,6,15,6,9,18:47
,241,Simon Bertilsson,15,Brynäs,D,22,1,3,4,28,0,1,18,22,33,9,12,-3,18:34
,242,David Gunnarsson,35,MODO,F,32,1,3,4,2,0,0,12,4,8,6,5,1,8:52
,243,Tom Linder,55,Växjö,D,35,1,3,4,14,0,0,23,5,10,7,6,1,7:59
,244,Robin Persson,11,Timrå,D,39,1,3,4,18,1,0,30,26,14,19,23,-4,17:59
,245,Johan Andersson,32,Växjö,F,46,1,3,4,30,0,0,58,76,11,8,15,-7,10:14
,246,Simon Löf,14,Brynäs,D,48,1,3,4,22,0,0,36,31,31,18,35,-17,16:44
,247,Joachim Nermark,80,Linköping,F,53,1,3,4,2,1,0,30,12,12,5,7,-2,7:41
,248,Erik Thorell,20,Färjestad,F,54,1,3,4,10,0,0,43,30,16,8,9,-1,8:23
,249,Samuel Påhlsson,26,MODO,F,23,0,4,4,8,0,0,31,44,4,10,8,2,17:04
,250,Gustaf Wesslau,32,HV71,Gk,49,0,4,4,0,0,0,0,0,0,97,63,34,0:00
,251,Oscar Hedman,41,Timrå,D,55,0,4,4,28,0,0,53,41,21,21,28,-7,19:25
,252,Johan Andersson,17,Timrå,F,50,3,0,3,18,0,0,51,39,35,8,9,-1,11:32
,253,Kristian Huselius,20,AIK,F,5,2,1,3,0,0,0,13,0,0,4,3,1,16:46
,254,David Åslin,29,Växjö,F,9,2,1,3,6,1,0,21,9,1,4,0,4,13:18
,255,Daniel Zaar,72,Rögle,F,25,2,1,3,0,0,0,29,15,0,5,9,-4,6:08
,256,Christopher Fish,29,Linköping,F,29,2,1,3,6,0,0,25,16,1,2,6,-4,6:26
,257,Nils Bergström,4,Rögle,F,33,2,1,3,12,0,0,27,19,3,5,13,-8,8:21
,258,Daniel Sylwander,23,Rögle,F,51,2,1,3,18,1,0,55,37,10,7,9,-2,6:17
,259,Dan Spang,26,HV71,D,11,1,2,3,0,0,0,24,1,6,11,10,1,19:48
,260,Jesper Pettersson,37,Linköping,D,14,1,2,3,6,1,0,4,4,1,5,0,5,8:13
,261,Josh MacNevin,44,AIK,D,15,1,2,3,12,0,1,19,4,14,4,12,-8,20:37
,262,Andrée Brendheden,65,Rögle,F,16,1,2,3,0,0,0,11,14,2,2,4,-2,8:17
,263,Daniel Josefsson,12,AIK,D,30,1,2,3,10,1,0,32,14,19,12,23,-11,19:05
,264,Emil Molin,24,Brynäs,F,34,1,2,3,0,0,0,22,6,2,4,11,-7,7:51
,265,Björn Karlsson,3,Växjö,D,42,1,2,3,12,0,0,31,8,19,14,20,-6,14:11
,266,Dick Tärnström,6,AIK,D,6,0,3,3,6,0,0,3,0,7,1,2,-1,19:47
,267,Ziga Pavlin,20,Rögle,D,10,0,3,3,2,0,0,15,4,10,2,8,-6,21:28
,267,Miikka Männikkö,41,Växjö,F,10,0,3,3,4,0,0,13,5,1,3,4,-1,15:11
,269,Oscar Klefbom,7,Färjestad,D,11,0,3,3,2,0,0,15,3,4,8,1,7,17:28
,270,Janos Hari,16,MODO,F,29,0,3,3,2,0,0,18,2,2,3,6,-3,6:25
,271,Linus Fröberg,71,Färjestad,F,34,0,3,3,4,0,0,13,8,6,4,3,1,6:53
,272,Alexander Salak,53,Färjestad,Gk,53,0,3,3,8,0,0,0,0,0,67,46,21,0:00
,273,Pierre Johnsson,2,Frölunda,D,10,1,1,2,10,0,0,9,12,6,6,6,0,17:32
,273,Rastislav Pavlikovsky,14,Linköping,F,10,1,1,2,2,0,1,9,2,1,1,7,-6,12:32
,275,Filip Sandberg,16,HV71,F,15,1,1,2,0,0,0,10,10,0,2,5,-3,5:50
,276,Joakim Nygård,11,Färjestad,F,28,1,1,2,31,0,0,18,8,3,3,5,-2,3:38
,277,Jesper Williamsson,34,HV71,D,29,1,1,2,8,1,0,35,17,2,5,7,-2,9:34
,278,Gustav Rydahl,15,Frölunda,F,31,1,1,2,10,0,0,21,40,9,2,11,-9,7:10
,279,Calle Andersson,14,Färjestad,D,34,1,1,2,6,1,0,12,0,4,3,6,-3,6:38
,280,Christopher Aspeqvist,90,AIK,D,42,1,1,2,8,0,0,40,13,8,9,17,-8,10:01
,281,Mikael Eriksson,61,Växjö,F,48,1,1,2,61,0,0,31,32,7,3,7,-4,5:57
,282,Daniel Mannberg,79,Luleå,F,16,0,2,2,4,0,0,8,4,0,3,4,-1,8:57
,283,Alexander Lindgren,10,Brynäs,F,24,0,2,2,6,0,0,8,10,0,3,5,-2,5:00
,283,Sebastian Dyk,3,HV71,F,24,0,2,2,4,0,0,21,8,0,4,5,-1,6:19
,285,Viktor Svedberg,8,Frölunda,D,51,0,2,2,24,0,0,27,23,24,10,13,-3,8:55
,286,Bernhard Starkbaum,29,MODO,Gk,55,0,2,2,2,0,0,0,0,0,74,69,5,0:00
,287,Gustav Possler,80,MODO,F,7,1,0,1,2,0,0,4,1,1,1,0,1,5:30
,287,Christopher Bengtsson,40,MODO,F,7,1,0,1,4,0,0,5,0,2,3,3,0,7:01
,287,Andreas Johnson,88,Frölunda,F,7,1,0,1,0,1,0,2,2,0,0,0,0,3:54
,290,Adam Bergqvist,,Brynäs,D,8,1,0,1,0,0,0,1,0,0,1,0,1,3:35
,291,Oskar Sundqvist,29,Skellefteå,F,14,1,0,1,8,1,0,8,5,2,3,1,2,6:54
,292,Wilhelm Westlund,28,Färjestad,D,26,1,0,1,0,0,0,9,0,7,4,5,-1,6:38
,293,Jakob Lilja,15,Rögle,F,29,1,0,1,4,0,0,14,14,4,1,6,-5,6:39
,294,Gustav Hjalmarsson,91,Växjö,F,32,1,0,1,4,0,0,23,10,2,3,4,-1,4:54
,295,David Rundqvist,29,Färjestad,F,2,0,1,1,0,0,0,1,0,1,1,0,1,6:49
,296,Tomas Marcinko,,MODO,F,4,0,1,1,2,0,0,5,3,4,3,4,-1,16:49
,297,Simon Fernholm,17,Frölunda,D,5,0,1,1,0,0,0,0,0,0,1,0,1,2:11
,298,Jesper Thörnberg,23,HV71,F,8,0,1,1,2,0,0,7,2,5,2,3,-1,6:53
,299,Ari Vallin,11,Färjestad,D,9,0,1,1,8,0,0,5,5,2,4,7,-3,14:39
,300,Tobias Törnkvist,14,Rögle,F,13,0,1,1,4,0,0,9,5,1,0,3,-3,6:16
,301,David Lillieström-Karlsson,93,AIK,F,14,0,1,1,0,0,0,6,3,2,2,6,-4,7:28
,302,Jonas Berglund,14,Luleå,F,16,0,1,1,2,0,0,6,3,2,3,2,1,8:06
,303,Sanny Lindström,8,Färjestad,D,17,0,1,1,22,0,0,10,26,18,6,4,2,18:32
,304,Simon Fredriksson,55,Färjestad,D,18,0,1,1,4,0,0,3,0,4,3,3,0,5:20
,305,Richard Stehlik,75,MODO,D,22,0,1,1,27,0,0,19,11,8,3,9,-6,9:44
,306,Martin Strbak,77,Rögle,D,23,0,1,1,24,0,0,12,15,13,8,11,-3,17:39
,306,Daniel Öhrn,63,Timrå,F,23,0,1,1,0,0,0,13,14,0,1,7,-6,6:00
,308,Robert Hägg,14,MODO,D,27,0,1,1,2,0,0,14,20,8,4,7,-3,7:46
,309,Jonathan Andersson,22,AIK,D,30,0,1,1,6,0,0,10,3,3,7,13,-6,6:31
,310,Nichlas Torp,38,MODO,D,46,0,1,1,34,0,0,33,46,43,16,15,1,12:11
,311,Andreas Andersson,54,Linköping,Gk,50,0,1,1,0,0,0,0,0,0,38,43,-5,0:00
,312,Martin Gerber,28,Rögle,Gk,51,0,1,1,47,0,0,0,0,0,53,80,-27,1:11
,312,Robin Rahm,35,Brynäs,Gk,51,0,1,1,2,0,0,0,0,0,32,44,-12,0:00
,314,Albin Lorentzon,27,Linköping,D,53,0,1,1,81,0,0,10,47,31,13,20,-7,12:04
,315,Jonas Fransson,32,Rögle,Gk,54,0,1,1,2,0,0,0,0,0,14,36,-22,0:00
,316,Daniel Bellissimo,30,Timrå,Gk,55,0,1,1,2,0,0,0,0,0,32,54,-22,0:00
,317,Bobbo Petersson,53,Linköping,D,1,0,0,0,0,0,0,0,0,0,0,0,0,0:00
,317,Stefan Steen,26,Skellefteå,Gk,1,0,0,0,0,0,0,0,0,0,0,0,0,0:00
,317,Niclas Edman,,HV71,D,1,0,0,0,0,0,0,0,0,0,0,0,0,0:00
,317,William Haag,13,Frölunda,F,1,0,0,0,0,0,0,0,0,0,0,0,0,0:00
,317,Viktor Scherrieble,35,Färjestad,Gk,1,0,0,0,0,0,0,0,0,0,0,0,0,0:00
,317,Viktor Crus Rydberg,16,Linköping,F,1,0,0,0,0,0,0,0,0,0,0,0,0,0:00
,317,Jesper Johansson,14,Skellefteå,F,1,0,0,0,0,0,0,0,0,0,0,0,0,5:21
,317,Victor Öhman,12,MODO,F,1,0,0,0,0,0,0,0,0,0,0,0,0,0:00
,317,Hugo Fagerblom,30,Frölunda,Gk,1,0,0,0,0,0,0,0,0,0,0,0,0,0:00
,317,Jesper Appel,15,Färjestad,D,1,0,0,0,0,0,0,0,0,0,0,0,0,0:00
,317,Jacob Johansson,30,Linköping,Gk,1,0,0,0,0,0,0,0,0,0,0,0,0,0:00
,317,Robin Kovacs,96,AIK,F,1,0,0,0,0,0,0,0,0,0,0,0,0,1:49
,317,Pontus Gulldén,17,Växjö,F,1,0,0,0,0,0,0,0,0,0,0,0,0,0:00
,317,Sebastian Aho,63,Skellefteå,D,1,0,0,0,0,0,0,0,0,0,0,0,0,0:00
,317,Markus Magnusson,13,Luleå,D,1,0,0,0,0,0,0,0,0,0,0,0,0,0:00
,317,Carl-Johan Meyer,,Brynäs,D,1,0,0,0,0,0,0,0,0,0,0,0,0,0:00
,317,Daniel Ljunggren,90,Brynäs,F,1,0,0,0,0,0,0,1,0,0,0,0,0,9:13
,317,Johan Eriksson,28,Brynäs,F,1,0,0,0,0,0,0,0,0,1,0,0,0,8:57
,317,Mattias Thunman Hälldahl,,Timrå,D,1,0,0,0,0,0,0,0,0,0,0,0,0,2:04
,336,Anton Lindholm,54,Skellefteå,D,2,0,0,0,2,0,0,0,1,0,0,0,0,4:22
,336,Ludvig Engsund,35,Rögle,Gk,2,0,0,0,0,0,0,0,0,0,0,0,0,0:00
,336,Emil Pettersson,14,Timrå,F,2,0,0,0,0,0,0,1,0,0,0,1,-1,7:44
,336,Sebastian Andersson,1,Timrå,Gk,2,0,0,0,0,0,0,0,0,0,0,0,0,0:00
,336,Tommi Juntunen,20,Frölunda,D,2,0,0,0,0,0,0,0,1,1,0,1,-1,7:32
,336,Anton Santesson,19,Rögle,D,2,0,0,0,0,0,0,0,0,0,0,0,0,0:00
,336,Rasmus Djerf,,HV71,F,2,0,0,0,0,0,0,0,1,0,0,0,0,0:38
,336,Jesper Bärgård,92,Linköping,F,2,0,0,0,0,0,0,0,0,0,0,0,0,0:00
,336,Luca Boltshauser,,Färjestad,Gk,2,0,0,0,0,0,0,0,0,0,0,0,0,0:00
,336,Lucas Wallmark,23,Skellefteå,F,2,0,0,0,0,0,0,1,0,0,0,0,0,9:23
,336,Anton Brehmer,19,Linköping,F,2,0,0,0,0,0,0,0,0,0,0,1,-1,0:50
,336,Simon Petersson,,HV71,D,2,0,0,0,0,0,0,0,0,0,0,0,0,2:49
,348,Michael Lindqvist,34,AIK,F,3,0,0,0,0,0,0,0,0,1,0,0,0,1:05
,348,Gustaf Burström,,Luleå,D,3,0,0,0,0,0,0,0,0,0,0,0,0,0:00
,348,Andreas Borgman,,Timrå,D,3,0,0,0,0,0,0,1,0,0,0,0,0,0:52
,348,Johan Nielsen,30,Rögle,Gk,3,0,0,0,0,0,0,0,0,0,0,0,0,0:00
,348,Albin Carlson,14,MODO,D,3,0,0,0,0,0,0,0,0,0,0,0,0,2:19
,348,Ludvig Nilsson,41,Timrå,F,3,0,0,0,0,0,0,2,1,0,0,0,0,6:14
,348,Raymond Bamberg,,Luleå,F,3,0,0,0,0,0,0,1,0,0,0,0,0,2:28
,348,Max Örnskog,,HV71,F,3,0,0,0,0,0,0,1,0,0,0,0,0,4:03
,356,Anton Karlsson,47,Linköping,D,4,0,0,0,2,0,0,3,3,0,0,1,-1,6:41
,356,Jonathan Johnson,22,Frölunda,F,4,0,0,0,0,0,0,0,0,0,0,0,0,0:39
,358,Sam Marklund,11,Skellefteå,F,5,0,0,0,0,0,0,4,2,1,0,1,-1,6:32
,358,Arvid Lundberg,52,Skellefteå,D,5,0,0,0,0,0,0,0,1,2,0,0,0,2:07
,358,Jakub Vrana,13,Linköping,F,5,0,0,0,0,0,0,4,0,2,0,2,-2,9:32
,358,Anton Hedberg,,Brynäs,Gk,5,0,0,0,0,0,0,0,0,0,0,0,0,0:00
,358,Erik Karlsson,19,Frölunda,F,5,0,0,0,0,0,0,4,1,0,0,0,0,4:01
,363,Johan Porsberger,15,Luleå,F,6,0,0,0,0,0,0,4,3,1,0,1,-1,6:26
,363,Jonas Johansson,25,Brynäs,Gk,6,0,0,0,0,0,0,0,0,0,0,0,0,0:00
,363,Edwin Hedberg,20,MODO,F,6,0,0,0,0,0,0,3,1,1,0,0,0,3:53
,363,Marcus Fornell,9,Linköping,F,6,0,0,0,0,0,0,0,1,0,0,2,-2,2:23
,363,Marcus Oskarsson,7,Luleå,D,6,0,0,0,2,0,0,5,0,3,3,5,-2,10:06
,363,Jonatan Nielsen,51,Linköping,D,6,0,0,0,0,0,0,0,0,1,1,1,0,3:05
,363,Lars Jonsson,20,Brynäs,D,6,0,0,0,2,0,0,2,2,4,1,3,-2,12:54
,370,Thomas Spelling,12,Rögle,F,7,0,0,0,0,0,0,4,0,0,0,1,-1,2:42
,370,Mathias Israelsson,1,Frölunda,Gk,7,0,0,0,0,0,0,0,0,0,0,0,0,0:00
,372,Sebastian Selin,40,Skellefteå,F,8,0,0,0,0,0,0,4,4,2,0,0,0,4:10
,372,Filip Windlert,7,AIK,D,8,0,0,0,0,0,0,0,0,0,0,0,0,0:00
,372,Christoffer Gozzi,15,AIK,F,8,0,0,0,0,0,0,2,0,0,0,0,0,1:47
,372,Kristoffer Wikner-Sundborg,17,Frölunda,F,8,0,0,0,0,0,0,3,0,2,0,1,-1,4:04
,376,Dennis Nordström,56,AIK,F,9,0,0,0,0,0,0,4,2,0,0,2,-2,4:16
,376,Emil Larsson,36,Brynäs,F,9,0,0,0,0,0,0,2,4,1,0,1,-1,3:42
,376,Sebastian Wännström,22,Brynäs,F,9,0,0,0,8,0,0,14,6,2,0,5,-5,12:17
,376,Samuel Ward,99,Luleå,Gk,9,0,0,0,0,0,0,0,0,0,0,0,0,0:00
,376,Oscar Engsund,32,HV71,D,9,0,0,0,0,0,0,3,0,0,0,0,0,3:17
,376,Niklas Hansson,33,Rögle,D,9,0,0,0,4,0,0,0,2,2,0,3,-3,5:41
,376,Johan Olofsson,8,Färjestad,F,9,0,0,0,2,0,0,3,3,0,0,0,0,3:55
,383,Tim Heed,4,Växjö,D,10,0,0,0,2,0,0,6,0,5,1,2,-1,7:07
,384,Rasmus Holmén,,AIK,F,11,0,0,0,2,0,0,6,0,1,0,1,-1,2:18
,384,Sebastian Ottosson,15,Linköping,F,11,0,0,0,0,0,0,0,4,1,0,1,-1,2:35
,384,Viktor Kokman,99,HV71,Gk,11,0,0,0,0,0,0,0,0,0,0,0,0,0:00
,384,Alexander Hamberg,35,AIK,Gk,11,0,0,0,0,0,0,0,0,0,3,1,2,0:00
,388,Johan Johnsson,41,HV71,F,12,0,0,0,2,0,0,2,1,0,0,2,-2,3:08
,388,Anton Cederholm,2,Rögle,D,12,0,0,0,6,0,0,4,5,5,1,2,-1,9:01
,390,Claes Nordén,21,Linköping,F,13,0,0,0,0,0,0,2,7,1,0,1,-1,2:04
,390,Petter Granberg,8,Skellefteå,D,13,0,0,0,4,0,0,5,12,3,4,3,1,13:02
,392,Mattias Nörstebö,18,Brynäs,D,17,0,0,0,6,0,0,4,0,4,3,3,0,5:13
,393,Marcus Högberg,1,Linköping,Gk,20,0,0,0,0,0,0,0,0,0,4,6,-2,0:00
,394,Linus Fernström,39,Frölunda,Gk,21,0,0,0,0,0,0,0,0,0,4,9,-5,0:00
,395,Oscar Alsenfelt,69,MODO,Gk,23,0,0,0,0,0,0,0,0,0,11,20,-9,0:00
,396,Patrick Galbraith,31,Frölunda,Gk,29,0,0,0,0,0,0,0,0,0,6,9,-3,0:00
,397,Linus Ullmark,30,MODO,Gk,32,0,0,0,0,0,0,0,0,0,8,8,0,0:00
,398,Christian Engstrand,1,Linköping,Gk,39,0,0,0,4,0,0,0,0,0,60,40,20,0:00
,399,Niklas Lundström,,AIK,Gk,46,0,0,0,0,0,0,0,0,0,15,34,-19,0:00
,400,Johan Holmqvist,40,Brynäs,Gk,48,0,0,0,2,0,0,0,0,0,49,73,-24,0:00
,401,David Rautio,30,Luleå,Gk,49,0,0,0,0,0,0,0,0,0,52,26,26,0:00
,402,Jonas Gunnarsson,37,HV71,Gk,50,0,0,0,0,0,0,0,0,0,22,26,-4,0:00
,403,Julius Hudacek,33,Frölunda,Gk,52,0,0,0,2,0,0,0,0,0,79,65,14,0:00
,403,Johan Gustafsson,37,Luleå,Gk,52,0,0,0,0,0,0,0,0,0,59,41,18,0:00
,405,Daniel Larsson,,AIK,Gk,53,0,0,0,0,0,0,0,0,0,65,82,-17,0:00
,405,Joakim Lundström,84,Timrå,Gk,53,0,0,0,0,0,0,0,0,0,37,37,0,0:00
,407,Fredrik Pettersson-Wentzel,53,Färjestad,Gk,54,0,0,0,0,0,0,0,0,0,40,27,13,0:00
,407,Markus Svensson,35,Skellefteå,Gk,54,0,0,0,2,0,0,0,0,0,52,37,15,0:00
,409,Joacim Eriksson,30,Skellefteå,Gk,55,0,0,0,4,0,0,0,0,0,68,37,31,0:00
,409,Mattias Modig,33,Växjö,Gk,55,0,0,0,0,0,0,0,0,0,13,20,-7,0:00
,409,Fredrik Norrena,30,Växjö,Gk,55,0,0,0,0,0,0,0,0,0,62,62,0,0:00
,1,Robert Rosén,87,AIK,F,55,21,39,60,20,2,7,148,13,-,51,29,22,18:25
,2,Jakob Silfverberg,33,Brynäs,F,49,24,30,54,10,4,10,154,17,-,33,35,-2,19:12
,3,Nicklas Danielsson,74,MODO,F,53,21,31,52,77,3,5,208,21,-,48,22,26,17:41
,4,Per-Åge Skröder,10,MODO,F,53,22,29,51,52,1,5,153,46,-,49,28,21,19:26
,5,Bud Holloway,4,Skellefteå,F,55,21,28,49,32,2,12,153,35,-,34,23,11,16:39
,6,Richard Gynge,10,AIK,F,55,28,16,44,14,5,8,190,23,-,42,30,12,15:23
,7,Rob Schremp,44,MODO,F,55,19,22,41,46,8,7,166,12,-,35,34,1,18:46
,8,Mathis Olimb,46,Frölunda,F,55,10,31,41,34,2,1,80,10,-,47,24,23,17:54
,9,Niklas Olausson,16,Luleå,F,53,8,33,41,18,3,1,84,8,-,30,20,10,17:35
,10,Mika Pyörälä,27,Frölunda,F,53,22,18,40,12,5,3,98,52,-,43,19,24,16:33
,11,Fredrik Pettersson,10,Frölunda,F,54,16,24,40,48,6,3,140,58,-,45,19,26,17:19
,12,Jason Krog,9,HV71,F,50,12,28,40,22,3,1,77,18,-,33,28,5,17:29
,13,Johan Davidsson,76,HV71,F,52,10,30,40,18,2,2,80,6,-,35,20,15,19:15
,14,Calle Järnkrok,19,Brynäs,F,50,16,23,39,22,6,6,108,9,-,29,32,-3,19:06
,15,Lee Goren,37,Skellefteå,F,51,11,28,39,40,0,1,123,41,-,38,32,6,18:45
,16,Mikael Johansson,85,Färjestad,F,53,8,31,39,22,1,2,102,4,-,29,31,-2,17:15
,17,Pär Arlbrandt,40,Linköping,F,55,14,23,37,24,2,5,126,17,-,33,29,4,15:25
,18,Niklas Sundström,24,MODO,F,50,11,26,37,42,0,1,57,22,-,43,29,14,19:12
,19,Brad Moran,20,Växjö,F,55,9,28,37,22,1,2,112,11,-,37,37,0,19:27
,20,Simon Hjalmarsson,59,Luleå,F,53,19,17,36,8,7,6,139,37,-,37,24,13,18:57
,21,Pierre-Edouard Bellemare,41,Skellefteå,F,55,19,17,36,40,5,3,162,58,-,34,22,12,17:54
,22,Johan Larsson,10,Brynäs,F,49,12,24,36,34,3,8,95,63,-,20,30,-10,18:38
,23,Carl Söderberg,17,Linköping,F,42,14,21,35,20,6,2,117,30,-,30,24,6,19:34
,24,Mike Iggulden,73,Växjö,F,41,13,21,34,12,4,4,72,7,-,25,31,-6,17:34
,25,Ryan Gunderson,13,Brynäs,D,55,9,25,34,6,0,7,117,6,-,22,35,-13,21:57
,26,Ilkka Heikkinen,49,Växjö,D,55,18,15,33,34,4,11,121,91,-,28,35,-7,23:26
,27,Jukka Voutilainen,39,HV71,F,52,14,19,33,18,5,8,105,28,-,30,19,11,17:37
,28,Oscar Steen,45,AIK,F,52,6,27,33,28,2,2,51,7,-,38,30,8,17:15
,29,Marcus Nilson,3,Djurgården,F,51,11,21,32,45,5,3,114,32,-,27,36,-9,17:38
,30,Matt Murley,19,Timrå,F,55,15,16,31,16,2,6,139,16,-,24,34,-10,17:19
,31,Oscar Möller,45,Skellefteå,F,54,14,17,31,6,2,4,164,51,-,29,24,5,15:01
,32,Sebastian Lauritzen,16,Brynäs,F,40,10,21,31,8,0,5,96,12,-,17,19,-2,17:23
,33,Jimmie Ericsson,21,Skellefteå,F,45,10,21,31,40,2,5,87,32,-,27,20,7,17:45
,34,Kristofer Ottosson,9,Djurgården,F,54,12,18,30,12,1,2,88,14,-,32,33,-1,18:42
,35,Joel Lundqvist,20,Frölunda,F,48,11,19,30,63,2,5,78,102,-,27,19,8,17:55
,36,Oscar Sundh,13,HV71,F,53,15,14,29,90,5,1,105,34,-,41,27,14,16:53
,37,Jesse Joensuu,11,HV71,F,50,13,16,29,56,3,3,109,121,-,29,31,-2,17:15
,38,Tomi Kallio,71,Växjö,F,43,12,17,29,18,3,3,120,21,-,21,34,-13,17:31
,39,Magnus Johansson,7,Linköping,D,55,6,23,29,16,1,1,114,22,-,37,40,-3,23:32
,40,Liam Reddox,85,Växjö,F,55,11,17,28,32,1,4,126,43,-,23,32,-9,18:14
,41,Christian Berglund,17,Färjestad,F,53,16,11,27,61,6,1,150,86,-,30,21,9,14:13
,42,Christian Bäckman,5,Frölunda,D,55,11,16,27,48,5,2,106,18,-,40,33,7,23:16
,43,Rickard Wallin,51,Färjestad,F,53,9,18,27,42,2,4,105,11,-,30,19,11,19:25
,44,Chris Abbott,29,Luleå,F,46,8,19,27,48,0,0,54,90,-,32,20,12,17:48
,45,Andreas Falk,19,HV71,F,54,7,20,27,72,0,0,87,35,-,40,29,11,17:17
,46,Dick Tärnström,6,AIK,D,46,8,18,26,38,2,3,71,19,-,35,25,10,18:53
,47,Johan Harju,24,Luleå,F,53,15,10,25,16,4,3,108,44,-,30,18,12,15:35
,48,Kamil Piros,26,HV71,F,47,12,13,25,12,3,5,75,32,-,21,12,9,14:14
,49,Thomas Pöck,22,MODO,D,55,9,16,25,32,2,1,132,67,-,47,34,13,23:13
,50,Jimmie Ölvestad,19,Djurgården,F,48,13,11,24,83,2,5,102,109,-,27,31,-4,15:50
,51,Patrik Lundh,79,Färjestad,F,54,11,13,24,28,1,2,95,26,-,25,20,5,15:50
,52,Patrick von Gunten,33,Frölunda,D,51,5,19,24,12,1,2,83,23,-,35,19,16,20:14
,53,Andreas Jämtin,18,Linköping,F,53,16,7,23,138,3,8,116,117,-,26,24,2,15:15
,54,Jan Hlavac,27,Linköping,F,37,10,13,23,20,3,2,79,19,-,14,21,-7,16:41
,55,Jonas Nordquist,39,Brynäs,F,48,9,14,23,16,3,1,91,4,-,23,28,-5,15:56
,56,Per Åslund,22,Färjestad,F,53,8,15,23,22,2,1,92,30,-,22,11,11,15:03
,57,Erik Forssell,20,Skellefteå,F,55,12,10,22,18,5,1,87,4,-,25,25,0,16:22
,58,Anders Söderberg,26,Skellefteå,F,42,8,14,22,10,2,4,94,6,-,16,18,-2,14:05
,59,Sebastian Enterfeldt,59,Luleå,F,45,8,14,22,8,1,2,62,74,-,21,20,1,17:23
,60,Anders Bastiansen,20,Färjestad,F,52,8,14,22,18,1,4,62,18,-,19,16,3,16:33
,61,Jaroslav Hlinka,71,Linköping,F,42,5,17,22,6,2,2,80,12,-,14,22,-8,17:13
,62,Mikko Luoma,5,HV71,D,49,4,18,22,48,1,2,124,7,-,41,30,11,22:01
,63,Hannu Pikkarainen,48,Skellefteå,D,50,3,19,22,4,1,2,87,26,-,30,25,5,20:10
,64,Josh Soares,97,Växjö,F,50,11,10,21,24,2,1,87,17,-,20,29,-9,14:42
,65,Jonathan Hedström,71,Timrå,F,53,9,12,21,72,2,0,82,52,-,28,38,-10,17:52
,66,Steve Saviano,15,Växjö,F,54,9,12,21,2,3,0,79,7,-,20,18,2,11:55
,67,Per Ledin,97,HV71,F,46,7,14,21,62,1,1,67,57,-,29,17,12,14:57
,68,Mats Lavander,62,Brynäs,F,49,7,14,21,50,0,3,72,41,-,20,21,-1,14:13
,69,Oscar Ahlström,86,AIK,F,53,13,7,20,8,1,1,89,14,-,21,22,-1,11:26
,70,Daniel Widing,41,Brynäs,F,55,12,8,20,22,3,5,136,55,-,16,24,-8,14:53
,71,Daniel Grillfors,32,HV71,D,54,11,9,20,43,1,4,58,29,-,26,21,5,14:48
,72,Magnus Kahnberg,11,Frölunda,F,29,9,11,20,4,0,6,75,6,-,11,10,1,15:24
,73,Dick Axelsson,31,MODO,F,36,9,11,20,59,0,1,79,37,-,17,24,-7,16:42
,74,Jari Tolsa,17,Frölunda,F,42,8,12,20,45,1,4,50,31,-,18,13,5,15:02
,75,Joakim Lindström,10,Skellefteå,F,21,7,13,20,45,4,2,84,15,-,18,10,8,19:00
,76,Mattias Ritola,21,MODO,F,35,7,13,20,30,2,2,80,31,-,16,22,-6,18:57
,77,Alexander Larsson,20,Timrå,F,45,7,13,20,16,1,1,91,59,-,27,30,-3,16:00
,78,Kyle Klubertanz,49,Djurgården,D,55,7,13,20,42,0,3,98,25,-,32,43,-11,22:02
,79,Jesper Ollas,17,Brynäs,F,55,6,14,20,36,1,1,113,54,-,20,28,-8,14:50
,80,Fredrik Eriksson,8,Frölunda,D,55,4,16,20,50,0,1,99,19,-,31,28,3,19:44
,80,Mat Robinson,33,Timrå,D,55,4,16,20,45,1,1,120,53,-,34,44,-10,22:28
,82,Johan Fransson,10,Luleå,D,48,1,19,20,12,0,1,112,33,-,22,29,-7,20:44
,83,Kent McDonell,3,AIK,F,42,11,8,19,26,1,6,135,32,-,16,18,-2,16:14
,84,Hannes Hyvönen,23,Färjestad,F,36,10,9,19,41,4,6,102,36,-,18,23,-5,14:42
,85,Robin Figren,23,Linköping,F,51,9,10,19,57,2,1,100,52,-,18,19,-1,13:28
,86,Christian Söderström,82,Skellefteå,F,49,8,11,19,22,2,3,97,14,-,23,25,-2,14:40
,87,Sami Sandell,40,Luleå,F,41,10,8,18,6,4,4,92,16,-,20,11,9,14:15
,88,Toni Koivisto,21,/,F,52,10,8,18,6,3,1,107,34,-,20,20,0,15:29
,89,Elias Fälth,33,Luleå,D,53,9,9,18,16,3,3,133,21,-,38,25,13,20:59
,90,Daniel Bång,20,AIK,F,50,8,10,18,30,1,1,79,75,-,19,19,0,15:35
,91,Magnus Nygren,32,Färjestad,D,50,7,11,18,6,1,5,94,28,-,14,24,-10,14:47
,92,Johannes Salmonsson,25,AIK,F,41,5,13,18,16,2,0,67,20,-,22,24,-2,16:26
,93,Josh MacNevin,44,AIK,D,43,4,14,18,44,2,0,70,24,-,26,21,5,17:31
,94,Simon Önerud,11,Timrå,F,54,11,6,17,24,3,0,109,41,-,26,32,-6,14:18
,95,Mattias Ekholm,14,Brynäs,D,41,9,8,17,55,0,6,94,21,-,32,31,1,22:16
,96,Mikael Johansson,21,Frölunda,F,54,8,9,17,42,3,0,58,38,-,18,22,-4,15:32
,97,Dennis Rasmussen,70,Växjö,F,55,8,9,17,10,2,1,82,18,-,19,26,-7,16:38
,98,Petr Vampola,44,Timrå,F,20,6,11,17,40,0,1,44,6,-,16,15,1,20:54
,99,Martin Röymark,27,Timrå,F,55,6,11,17,22,0,3,93,66,-,22,29,-7,14:43
,100,John Norman,37,Djurgården,F,55,4,13,17,10,0,0,66,31,-,24,15,9,14:48
,101,Josef Boumedienne,78,Djurgården,D,36,2,15,17,32,0,0,47,22,-,25,28,-3,20:06
,102,Damien Fleury,13,/,F,52,12,4,16,20,1,1,113,29,-,19,27,-8,13:40
,103,Morten Madsen,29,MODO,F,49,11,5,16,10,3,0,94,19,-,24,19,5,16:01
,104,Johan Lindström,79,HV71,F,48,10,6,16,10,2,0,49,21,-,23,16,7,12:19
,105,Marcus Paulsson,53,Färjestad,F,52,10,6,16,43,4,1,95,26,-,16,22,-6,12:15
,106,Timo Pärssinen,27,Timrå,F,53,7,9,16,20,2,2,94,17,-,23,38,-15,16:46
,107,Niclas Hävelid,28,Linköping,D,55,7,9,16,24,1,5,82,33,-,23,35,-12,23:27
,108,Jesper Fasth,18,HV71,F,21,5,11,16,4,1,1,28,13,-,20,11,9,16:55
,109,Martin Sevc,55,Färjestad,D,50,5,11,16,118,1,2,110,38,-,29,24,5,22:53
,110,Victor Ahlström,68,AIK,F,51,4,12,16,4,1,0,72,21,-,20,24,-4,12:02
,111,Sebastian Wännström,22,Brynäs,F,43,8,7,15,20,4,0,59,19,-,15,20,-5,9:46
,112,Pontus Åberg,46,Djurgården,F,47,8,7,15,6,4,0,85,22,-,15,18,-3,11:33
,113,Mario Kempe,70,Djurgården,F,52,8,7,15,14,2,0,95,60,-,15,19,-4,13:16
,114,Ville Viitaluoma,39,Luleå,F,55,6,9,15,22,2,2,74,27,-,18,16,2,15:21
,115,Mads Hansen,24,Brynäs,F,48,5,10,15,20,0,0,71,10,-,17,21,-4,15:12
,116,Tim Eriksson,26,Djurgården,F,53,4,11,15,10,1,1,66,16,-,16,21,-5,11:09
,117,Topi Jaakola,18,Luleå,D,54,2,13,15,18,1,0,81,49,-,37,22,15,19:56
,118,Patrick Cehlin,71,Djurgården,F,48,10,4,14,20,2,0,101,26,-,14,13,1,13:03
,119,Marius Holtet,12,Färjestad,F,51,8,6,14,55,2,1,84,78,-,15,16,-1,14:23
,120,Per Hallin,8,Timrå,F,49,7,7,14,22,1,0,72,40,-,14,15,-1,12:49
,121,Mattias Persson,90,Luleå,F,42,6,8,14,14,3,2,55,10,-,13,18,-5,13:03
,122,Mika Hannula,33,MODO,F,20,5,9,14,8,2,3,43,13,-,13,18,-5,18:06
,123,Andreas Holmqvist,7,Djurgården,D,40,5,9,14,20,2,2,65,23,-,19,21,-2,18:47
,124,Henrik Tömmernes,7,Frölunda,D,44,5,9,14,36,0,3,84,30,-,36,25,11,22:46
,125,Daniel Tjärnqvist,34,Djurgården,D,45,4,10,14,22,0,2,94,11,-,25,34,-9,2:14
,126,Per-Johan Axelsson,11,Frölunda,F,52,2,12,14,24,1,0,33,29,-,20,15,5,13:50
,127,Mathias Tjärnqvist,71,Djurgården,F,52,6,7,13,34,0,4,82,55,-,19,21,-2,16:14
,128,Fredrik Sjöström,18,/,F,55,6,7,13,38,0,0,66,80,-,21,20,1,13:31
,129,Mika Zibanejad,93,Djurgården,F,26,5,8,13,4,1,0,55,32,-,12,14,-2,15:45
,130,Jonathan Granström,31,Brynäs,F,42,5,8,13,91,4,4,63,42,-,14,24,-10,17:05
,131,Fredrik Lindgren,61,Skellefteå,D,54,5,8,13,26,0,3,87,40,-,33,41,-8,19:54
,132,Joakim Hillding,24,Färjestad,F,53,4,9,13,20,0,0,70,42,-,19,22,-3,12:26
,133,Stefan Johansson,16,AIK,D,55,4,9,13,30,0,3,82,31,-,28,29,-1,18:16
,134,Daniel Rudslätt,14,AIK,F,50,3,10,13,18,1,0,99,26,-,18,22,-4,15:26
,135,Oscar Hedman,41,Timrå,D,55,2,11,13,24,0,0,80,27,-,35,36,-1,22:06
,136,Christian Sandberg,21,AIK,F,36,6,6,12,10,1,1,60,22,-,14,17,-3,15:43
,137,Jonas Almtorp,16,Djurgården,F,50,6,6,12,18,2,1,51,35,-,17,21,-4,14:54
,138,Niclas Burström,3,Skellefteå,D,51,6,6,12,32,2,1,45,8,-,30,33,-3,17:51
,139,Mattias Karlsson,20,HV71,D,54,6,6,12,34,0,2,113,58,-,36,34,2,21:41
,140,Linus Videll,55,AIK,F,14,5,7,12,2,0,2,35,2,-,12,6,6,15:50
,141,Joonas Vihko,20,Luleå,F,50,5,7,12,18,0,1,91,52,-,17,19,-2,15:00
,142,Patric Blomdahl,84,AIK,F,54,5,7,12,20,1,0,71,89,-,19,19,0,13:03
,143,Freddy Meyer,34,MODO,D,31,3,9,12,55,1,1,58,55,-,28,26,2,23:53
,144,Andreas Molinder,24,/,F,43,3,9,12,0,1,1,56,16,-,13,22,-9,13:59
,145,Joonas Lehtivuori,3,MODO,D,54,3,9,12,18,2,0,58,23,-,33,23,10,20:28
,146,Sebastian Karlsson,12,Linköping,F,43,7,4,11,47,0,0,72,38,-,16,16,0,15:49
,147,Yared Hagos,91,Timrå,F,46,6,5,11,70,2,1,62,31,-,17,17,0,14:19
,148,Johan Sundström,28,Frölunda,F,49,6,5,11,8,1,0,68,16,-,14,8,6,12:06
,149,Janos Hari,16,MODO,F,31,5,6,11,33,0,0,34,5,-,13,14,-1,9:16
,150,Anton Axelsson,6,Frölunda,F,42,5,6,11,16,1,0,55,26,-,19,10,9,13:29
,151,Martin Johansson,25,Brynäs,F,53,5,6,11,4,1,0,59,28,-,16,21,-5,13:20
,152,Christian Eklund,20,Djurgården,F,48,4,7,11,36,1,0,45,36,-,17,24,-7,12:58
,153,Fredrik Bremberg,73,/,F,27,3,8,11,2,1,0,36,0,-,11,13,-2,13:46
,154,Adam Almquist,5,HV71,D,42,3,8,11,26,0,1,66,13,-,31,15,16,19:26
,155,Gustav Hjalmarsson,91,Växjö,F,53,3,8,11,18,1,0,62,100,-,16,18,-2,9:37
,155,Jonas Liwing,23,AIK,D,53,3,8,11,16,1,0,41,31,-,21,24,-3,16:44
,157,Ole-Kristian Tollefsen,55,MODO,D,50,2,9,11,62,1,0,83,88,-,47,42,5,23:03
,158,Jonas Ahnelöv,55,MODO,D,54,2,9,11,16,0,0,45,55,-,38,38,0,20:19
,159,Björn Karlsson,3,Växjö,D,53,1,10,11,30,0,1,52,16,-,32,29,3,19:06
,160,Erik Josefsson,60,Växjö,F,52,8,2,10,12,2,0,63,19,-,15,17,-2,15:05
,161,Ilkka Pikkarainen,63,Timrå,F,27,5,5,10,18,1,0,53,34,-,12,17,-5,12:05
,162,Oscar Lindberg,24,Skellefteå,F,46,5,5,10,18,1,1,72,38,-,10,18,-8,10:50
,163,Max Friberg,12,Timrå,F,48,5,5,10,8,0,0,51,45,-,10,13,-3,10:11
,164,Pontus Petterström,18,Linköping,F,52,5,5,10,10,0,1,79,29,-,16,21,-5,15:07
,165,Sebastian Meijer,13,Luleå,F,43,4,6,10,6,0,1,32,19,-,11,10,1,10:18
,166,Noah Welch,5,HV71,D,51,4,6,10,85,0,0,79,88,-,35,24,11,19:50
,167,Jan Sandström,7,Luleå,D,52,4,6,10,18,1,1,84,21,-,23,19,4,19:38
,168,Johan Forsberg,9,Skellefteå,F,55,4,6,10,39,1,0,68,65,-,17,18,-1,10:48
,169,Björn Svensson,26,MODO,F,32,3,7,10,8,0,2,65,16,-,15,12,3,16:57
,170,Johan Åkerman,4,Linköping,D,36,2,8,10,28,0,1,68,14,-,10,23,-13,18:27
,171,Tobias Viklund,16,AIK,D,51,2,8,10,8,0,0,85,72,-,30,25,5,19:05
,172,Kristofer Berglund,2,Färjestad,D,51,0,10,10,44,0,0,55,30,-,33,25,8,18:32
,173,Johan Andersson,32,Växjö,F,40,5,4,9,16,0,0,46,24,-,10,9,1,9:32
,174,Andreas Dackell,12,Brynäs,F,16,4,5,9,6,1,1,29,3,-,4,10,-6,16:38
,175,Nicklas Lasu,31,Frölunda,F,45,4,5,9,39,0,0,65,48,-,14,22,-8,14:30
,176,Kristian Forsberg,28,MODO,F,55,4,5,9,14,0,0,72,49,-,18,23,-5,12:48
,176,Erik Lindhagen,29,Linköping,F,55,4,5,9,22,0,0,71,16,-,15,19,-4,12:45
,178,Mattias Sjögren,11,Färjestad,F,28,3,6,9,22,1,1,46,22,-,9,18,-9,15:34
,179,David Petrasek,22,HV71,D,15,2,7,9,6,1,2,43,5,-,7,6,1,21:47
,180,Jonas Holös,6,Växjö,D,41,2,7,9,8,1,1,53,14,-,17,26,-9,22:34
,181,Mattias Carlsson,15,Djurgården,F,44,6,2,8,8,0,2,61,14,-,9,15,-6,13:16
,182,Mark Hartigan,13,Linköping,F,23,5,3,8,20,0,3,33,22,-,8,11,-3,14:48
,183,Mikael Håkanson,51,Linköping,F,31,3,5,8,6,0,2,40,30,-,5,15,-10,11:43
,184,Anders Eriksson,40,Växjö,F,47,3,5,8,14,1,0,43,34,-,13,22,-9,11:29
,185,Rasmus Edström,32,Skellefteå,D,35,2,6,8,10,0,2,37,8,-,15,7,8,16:01
,186,Elias Granath,4,Timrå,D,44,2,6,8,36,0,1,34,36,-,18,26,-8,14:10
,187,Jan-Axel Alavaara,55,Skellefteå,D,38,1,7,8,30,0,0,33,7,-,21,21,0,17:36
,188,Mattias Bäckman,5,Linköping,D,42,1,7,8,14,0,1,60,4,-,21,14,7,16:21
,189,Pierre Johnsson,2,Frölunda,D,44,1,7,8,38,0,0,46,87,-,28,19,9,20:44
,190,Nils Andersson,8,Växjö,D,45,1,7,8,10,1,1,43,3,-,15,19,-4,10:55
,191,Niclas Andersén,9,Brynäs,D,55,1,7,8,48,0,0,52,31,-,39,32,7,18:36
,192,Jonas Brodin,25,Färjestad,D,49,0,8,8,14,0,0,56,5,-,22,16,6,17:27
,193,Oscar Fantenberg,66,HV71,D,37,3,4,7,6,1,1,33,18,-,14,11,3,12:06
,194,Erik Gustafsson,56,Djurgården,D,41,3,4,7,16,0,0,31,20,-,13,16,-3,15:09
,195,Daniel Gunnarsson,16,Luleå,D,46,3,4,7,8,0,1,56,9,-,19,13,6,11:23
,196,Kalle Olsson,85,Linköping,F,51,3,4,7,20,2,0,41,51,-,11,13,-2,9:44
,197,Rastislav Pavlikovsky,14,AIK,F,24,2,5,7,24,1,1,23,3,-,9,10,-1,16:20
,198,Tomas Skogs,23,Skellefteå,D,44,2,5,7,14,1,0,39,38,-,24,10,14,16:45
,199,Daniel Brodin,34,Djurgården,F,46,2,5,7,28,1,0,63,69,-,12,19,-7,9:43
,200,Stefan Meyer,14,Färjestad,F,25,1,6,7,40,1,0,21,31,-,9,9,0,10:11
,201,Fredrik Claesson,14,Djurgården,D,47,1,6,7,8,1,0,32,27,-,28,21,7,17:05
,202,Fredrik Svensson,4,AIK,D,39,0,7,7,45,0,0,36,47,-,17,21,-4,13:21
,203,Tommy Kristiansen,16,HV71,F,32,3,3,6,22,0,0,32,47,-,9,9,0,10:05
,204,Anton Grundel,73,Färjestad,D,43,3,3,6,10,0,1,65,31,-,12,20,-8,15:29
,205,Erik Thorell,20,Färjestad,F,44,3,3,6,2,0,0,38,24,-,8,10,-2,8:29
,206,Joakim Nordström,13,AIK,F,47,3,3,6,4,2,0,47,28,-,8,18,-10,12:08
,207,Fredric Andersson,13,MODO,F,54,3,3,6,6,1,0,81,14,-,17,22,-5,12:27
,208,Nichlas Torp,38,Timrå,D,47,2,4,6,89,1,0,58,99,-,22,36,-14,17:16
,209,Christoffer Persson,6,Frölunda,D,52,1,5,6,38,0,0,30,30,-,26,19,7,15:54
,210,Marcus Högström,4,Timrå,D,30,0,6,6,8,0,0,35,16,-,11,14,-3,13:29
,211,Johan Alm,,Skellefteå,D,36,0,6,6,12,0,0,15,16,-,14,13,1,12:22
,212,Lars Jonsson,20,Brynäs,D,42,0,6,6,12,0,0,50,22,-,19,21,-2,15:45
,213,Johan Markusson,38,Växjö,F,51,0,6,6,26,0,0,62,87,-,12,13,-1,14:04
,214,Jonas Berglund,14,Luleå,F,52,0,6,6,0,0,0,30,8,-,13,16,-3,9:30
,215,Jesper Dahlroth,6,Timrå,D,37,4,1,5,0,0,1,29,5,-,15,17,-2,10:13
,216,Patrick Yetman,24,Linköping,F,13,3,2,5,6,1,1,26,7,-,8,10,-2,14:10
,217,Melker Karlsson,15,Skellefteå,F,44,3,2,5,8,1,0,44,43,-,6,15,-9,11:50
,218,Viktor Svedberg,8,Frölunda,D,55,3,2,5,20,1,0,37,18,-,14,16,-2,9:15
,219,Max Görtz,17,Färjestad,F,18,2,3,5,0,0,1,31,8,-,3,5,-2,9:38
,220,Joel Mustonen,40,/,F,22,2,3,5,6,0,0,13,3,-,5,4,1,6:24
,221,Konstantin Komarek,67,Luleå,F,45,2,3,5,4,0,1,34,22,-,7,8,-1,8:12
,222,Robin Jonsson,39,Luleå,D,46,2,3,5,24,0,0,40,30,-,17,20,-3,16:00
,223,Emil Molin,24,Brynäs,F,34,1,4,5,0,0,0,15,0,-,6,6,0,5:28
,224,Daniel Rahimi,48,HV71,D,54,1,4,5,20,0,0,24,94,-,21,18,3,13:12
,225,Simon Bertilsson,15,Brynäs,D,43,0,5,5,68,0,0,35,95,-,18,24,-6,18:24
,226,Per Hållberg,18,Växjö,D,29,2,2,4,26,0,2,12,4,-,8,18,-10,16:34
,227,Robin Sterner,18,Färjestad,F,40,2,2,4,33,0,0,26,14,-,8,14,-6,8:56
,228,Philip Holm,25,Djurgården,D,50,2,2,4,18,0,0,35,19,-,19,14,5,11:47
,228,Mikael Eriksson,61,Växjö,F,50,2,2,4,53,0,0,31,39,-,7,18,-11,10:35
,230,Klas Dahlbeck,6,Linköping,D,55,2,2,4,20,0,0,46,53,-,27,24,3,18:29
,231,John Klingberg,15,Skellefteå,D,16,1,3,4,6,0,0,22,8,-,6,7,-1,15:31
,232,Fredrik Styrman,2,Skellefteå,D,19,1,3,4,0,0,0,15,2,-,9,11,-2,16:37
,233,Johan Andersson,17,Timrå,F,23,1,3,4,10,0,0,34,18,-,5,11,-6,13:46
,234,Pontus Netterberg,14,HV71,F,24,1,3,4,4,0,0,11,6,-,4,1,3,4:01
,235,Petter Granberg,8,Skellefteå,D,38,1,3,4,10,0,0,20,44,-,14,15,-1,13:10
,236,Lukas Kilström,5,Luleå,D,39,1,3,4,16,0,0,19,44,-,13,15,-2,14:31
,237,Fredrik Hynning,12,Skellefteå,F,44,1,3,4,10,0,0,37,16,-,6,15,-9,9:46
,238,Patrik Carlsson,72,HV71,F,48,1,3,4,4,0,0,52,13,-,10,11,-1,13:34
,239,Anton Hedman,8,MODO,F,52,1,3,4,28,0,0,50,140,-,9,16,-7,8:16
,240,Karel Pilar,92,Växjö,D,13,0,4,4,6,0,0,12,1,-,10,9,1,20:27
,241,Fredrik Carlsson,17,AIK,D,34,0,4,4,8,0,0,12,12,-,16,12,4,15:33
,242,Martin Lundberg,27,Skellefteå,F,45,0,4,4,22,0,0,37,90,-,5,22,-17,12:26
,243,Robin Lindqvist,22,/,F,49,0,4,4,12,0,0,45,29,-,7,27,-20,11:56
,243,Johan Jonsson,20,Växjö,D,49,0,4,4,4,0,0,27,6,-,20,25,-5,16:32
,245,Peter Ölvecky,61,Växjö,F,17,3,0,3,6,0,2,20,3,-,3,2,1,14:53
,246,David Lillieström-Karlsson,93,AIK,F,28,3,0,3,2,1,0,27,14,-,4,3,1,8:10
,247,Victor Backman,27,Frölunda,F,8,2,1,3,0,1,0,8,3,-,3,2,1,7:18
,248,Sebastian Dyk,3,HV71,F,15,2,1,3,2,0,0,10,2,-,3,4,-1,5:19
,249,Mats Trygg,46,HV71,D,21,2,1,3,18,0,0,33,14,-,11,11,0,18:37
,250,Jens Westin,3,MODO,D,30,2,1,3,4,0,0,19,1,-,10,11,-1,14:26
,251,Johan Larsson,3,Färjestad,D,31,2,1,3,12,0,0,31,14,-,7,13,-6,12:17
,252,Kim Karlsson,,Luleå,F,36,2,1,3,16,0,0,22,3,-,5,10,-5,8:50
,253,Jesper Thörnberg,23,HV71,F,37,2,1,3,10,1,0,36,26,-,5,9,-4,6:47
,254,Christopher Aspeqvist,90,AIK,D,41,2,1,3,6,0,0,19,14,-,9,18,-9,7:42
,255,Jeremy Boyce,23,Timrå,F,46,2,1,3,2,0,0,36,16,-,8,10,-2,9:48
,256,Jörgen Sundqvist,22,Brynäs,D,52,2,1,3,59,0,0,52,94,-,21,31,-10,17:57
,257,Petr Kalus,14,MODO,F,13,1,2,3,2,1,1,17,33,-,3,0,3,11:10
,258,Daniel Mannberg,79,Luleå,F,36,1,2,3,0,0,0,31,17,-,3,5,-2,9:06
,259,Sanny Lindström,8,Färjestad,D,46,1,2,3,54,0,0,42,88,-,25,24,1,19:33
,260,Brett Skinner,27,MODO,D,11,0,3,3,0,0,0,12,2,-,5,4,1,16:44
,261,Vladimir Mihalik,56,Timrå,D,13,0,3,3,14,0,0,16,12,-,8,10,-2,19:46
,262,Ivan Majesky,26,Linköping,D,22,0,3,3,18,0,0,16,52,-,13,9,4,18:18
,263,Niclas Wallin,26,Luleå,D,33,0,3,3,35,0,0,18,35,-,16,6,10,17:04
,264,Antti Halonen,18,Timrå,D,36,0,3,3,52,0,0,47,36,-,16,22,-6,19:11
,265,Robin Persson,11,Linköping,D,39,0,3,3,26,0,0,14,18,-,5,18,-13,10:38
,266,David Printz,55,Djurgården,D,43,0,3,3,34,0,0,42,70,-,19,24,-5,18:20
,267,Patrik Nemeth,12,AIK,D,46,0,3,3,55,0,0,50,49,-,25,22,3,17:10
,268,Oscar Klefbom,7,Färjestad,D,33,2,0,2,4,0,0,41,14,-,11,12,-1,13:44
,269,Simon Löf,14,Brynäs,D,39,2,0,2,14,0,0,25,23,-,14,18,-4,12:48
,270,Jeremias Augustin,22,Växjö,D,54,2,0,2,30,0,0,36,27,-,26,24,2,18:38
,271,Tomas Netik,17,Växjö,F,12,1,1,2,2,0,0,18,1,-,1,3,-2,13:52
,272,Morten Ask,21,HV71,F,31,1,1,2,12,1,0,14,10,-,3,5,-2,6:28
,273,John Westin,25,MODO,F,38,1,1,2,2,0,0,34,29,-,3,10,-7,8:20
,274,Albin Lorentzon,27,Linköping,D,44,1,1,2,32,0,0,17,45,-,15,17,-2,12:53
,275,Henrik Samuelsson,67,MODO,F,15,0,2,2,12,0,0,16,10,-,3,10,-7,14:35
,276,Erik Nyström,77,MODO,F,19,0,2,2,0,0,0,14,2,-,3,4,-1,8:01
,277,Johan Motin,57,Timrå,D,33,0,2,2,18,0,0,24,35,-,15,16,-1,15:41
,278,Erik Andersson,2,Linköping,D,39,0,2,2,14,0,0,23,7,-,9,12,-3,8:55
,279,Johan Holmqvist,40,Brynäs,Gk,47,0,2,2,2,0,0,0,0,-,41,48,-7,0:00
,280,Michael Holmqvist,18,Linköping,F,48,0,2,2,22,0,0,52,16,-,4,18,-14,10:26
,281,Fredrik Norrena,30,Linköping,Gk,55,0,2,2,12,0,0,0,0,-,65,74,-9,0:00
,282,Gustav Possler,80,MODO,F,2,1,0,1,0,0,0,3,0,-,1,0,1,5:45
,282,Jesper Olofsson,92,MODO,F,2,1,0,1,0,0,0,2,0,-,1,0,1,8:08
,284,Daniel Öhrn,63,Timrå,F,3,1,0,1,2,0,0,3,2,-,1,1,0,5:50
,285,Johan Andersson,24,Timrå,F,7,1,0,1,2,1,0,8,2,-,3,3,0,12:14
,286,Mats Rosseli Olsen,51,Frölunda,F,11,1,0,1,0,0,0,11,1,-,4,1,3,10:40
,287,Petter Emanuelsson,11,Skellefteå,F,17,1,0,1,4,0,0,3,11,-,1,4,-3,5:21
,288,Joachim Rohdin,72,Brynäs,F,54,1,0,1,20,1,0,31,37,-,3,10,-7,6:32
,289,Måns Krüger,53,MODO,F,3,0,1,1,0,0,0,0,0,-,1,1,0,6:18
,290,Douglas Lögdal,46,Timrå,F,5,0,1,1,0,0,0,0,0,-,2,1,1,6:16
,291,Fredric Weigel,22,Djurgården,F,6,0,1,1,0,0,0,3,0,-,1,2,-1,5:58
,292,Sebastian Strandberg,29,HV71,F,8,0,1,1,2,0,0,2,2,-,1,0,1,4:46
,293,Joakim Eriksson,10,Linköping,F,12,0,1,1,10,0,0,7,0,-,1,3,-2,13:56
,294,Patrik Cedergren,28,MODO,D,14,0,1,1,4,0,0,13,3,-,6,2,4,8:38
,295,Sebastian Ottosson,15,Linköping,F,15,0,1,1,0,0,0,5,4,-,2,1,1,4:21
,296,Ludwig Blomstrand,80,Djurgården,F,18,0,1,1,4,0,0,5,8,-,1,3,-2,3:36
,296,Kim Lennhammer,28,Djurgården,D,18,0,1,1,0,0,0,7,0,-,2,3,-1,3:55
,298,Ludwig Byström,,MODO,D,20,0,1,1,8,0,0,4,5,-,5,3,2,5:57
,299,Pierre Hedin,21,Timrå,D,23,0,1,1,10,0,0,23,11,-,11,16,-5,18:09
,300,Tom Linder,55,Växjö,D,32,0,1,1,8,0,0,8,6,-,7,8,-1,8:46
,301,Viktor Fasth,30,AIK,Gk,48,0,1,1,4,0,0,0,0,-,73,67,6,0:00
,302,Jonathan Carlsson,36,Brynäs,D,51,0,1,1,4,0,0,20,11,-,7,12,-5,5:44
,303,Niklas Svedberg,89,Brynäs,Gk,52,0,1,1,8,0,0,0,0,-,44,53,-9,0:00
,304,Mikael Tellqvist,32,MODO,Gk,53,0,1,1,0,0,0,0,0,-,86,72,14,0:00
,305,Andreas Hadelöv,1,Skellefteå,Gk,55,0,1,1,0,0,0,0,0,-,39,46,-7,0:00
,305,Magnus Hellberg,45,Frölunda,Gk,55,0,1,1,0,0,0,0,0,-,35,29,6,0:00
,305,Gustaf Wesslau,32,Djurgården,Gk,55,0,1,1,2,0,0,0,0,-,82,88,-6,0:00
,308,Mathias Franzén,15,AIK,F,1,0,0,0,0,0,0,0,0,-,0,0,0,8:33
,308,Jesper Williamsson,34,HV71,D,1,0,0,0,0,0,0,0,0,-,0,0,0,0:08
,308,Alexander Falk,41,Djurgården,D,1,0,0,0,0,0,0,0,0,-,0,0,0,0:00
,308,Christian Djoos,,Brynäs,D,1,0,0,0,0,0,0,0,0,-,0,0,0,4:53
,308,Arvid Lundberg,52,Skellefteå,D,1,0,0,0,0,0,0,0,0,-,0,0,0,0:00
,308,Sebastian Persson,38,Djurgården,F,1,0,0,0,0,0,0,0,0,-,0,1,-1,2:52
,308,Joakim Thelin,11,AIK,F,1,0,0,0,0,0,0,0,0,-,0,0,0,0:00
,308,Linus Werneman,,Timrå,F,1,0,0,0,0,0,0,0,0,-,0,0,0,0:00
,308,Viktor Scherrieble,35,Färjestad,Gk,1,0,0,0,0,0,0,0,0,-,0,0,0,0:00
,308,Alexander Wennberg,10,Djurgården,F,1,0,0,0,0,0,0,0,0,-,0,0,0,0:00
,308,Anton Lindholm,54,Skellefteå,D,1,0,0,0,0,0,0,0,0,-,0,0,0,0:00
,308,Sebastian Andersson,1,Timrå,Gk,1,0,0,0,0,0,0,0,0,-,0,0,0,0:00
,308,Marcus Sörensen,66,Skellefteå,F,1,0,0,0,0,0,0,0,0,-,0,0,0,0:00
,308,Tobias Ställborn,,Växjö,D,1,0,0,0,0,0,0,0,0,-,0,0,0,0:00
,308,Stefan Steen,26,Skellefteå,Gk,1,0,0,0,0,0,0,0,0,-,0,0,0,0:00
,308,Andreas Dahlström,72,AIK,F,1,0,0,0,0,0,0,0,0,-,0,0,0,2:42
,308,Maciej Szwoch,32,MODO,Gk,1,0,0,0,0,0,0,0,0,-,0,0,0,0:00
,308,Oscar Back,,HV71,F,1,0,0,0,0,0,0,0,0,-,0,0,0,0:00
,308,Kim Sunna,27,Luleå,F,1,0,0,0,0,0,0,0,0,-,0,0,0,1:28
,308,Alexander Berg,,Luleå,Gk,1,0,0,0,0,0,0,0,0,-,0,0,0,0:00
,308,Viktor Näslund,17,HV71,D,1,0,0,0,0,0,0,0,0,-,0,0,0,0:00
,308,Viktor Kokman,99,HV71,Gk,1,0,0,0,0,0,0,0,0,-,0,0,0,0:00
,308,Jonatan Nielsen,51,Linköping,D,1,0,0,0,0,0,0,0,0,-,0,0,0,0:00
,331,Oscar Engsund,32,HV71,D,2,0,0,0,0,0,0,0,0,-,0,0,0,0:00
,331,Jan Urbas,9,Växjö,F,2,0,0,0,0,0,0,0,0,-,0,0,0,4:21
,331,Sam Marklund,11,Skellefteå,F,2,0,0,0,0,0,0,0,1,-,0,0,0,8:38
,331,Gustaf Lindvall,30,/,Gk,2,0,0,0,0,0,0,0,0,-,0,2,-2,0:00
,331,Patric Gozzi,19,AIK,F,2,0,0,0,0,0,0,0,1,-,0,0,0,3:18
,331,Victor Jigmalm,,Linköping,F,2,0,0,0,0,0,0,1,1,-,0,1,-1,3:22
,331,Julius Selle-Larsson,,HV71,D,2,0,0,0,0,0,0,0,0,-,0,0,0,0:00
,331,Dennis Bozic,29,MODO,D,2,0,0,0,0,0,0,0,1,-,0,1,-1,14:10
,331,Oskar Fredriksson,,Skellefteå,D,2,0,0,0,0,0,0,0,0,-,0,0,0,0:00
,331,Henri Snäll,11,Luleå,F,2,0,0,0,0,0,0,0,0,-,0,0,0,0:48
,331,Eric Moe,9,MODO,D,2,0,0,0,0,0,0,1,1,-,0,1,-1,5:26
,331,Filip Windlert,7,AIK,D,2,0,0,0,0,0,0,0,0,-,0,0,0,3:48
,331,Johannes Jönsson,38,Växjö,Gk,2,0,0,0,0,0,0,0,0,-,0,0,0,0:00
,331,Måns Johansson,35,AIK,Gk,2,0,0,0,0,0,0,0,0,-,0,0,0,0:00
,331,Marcus Fagerudd,29,Luleå,D,2,0,0,0,0,0,0,0,0,-,0,0,0,2:12
,346,Marcus Due-Boje,1,Djurgården,Gk,3,0,0,0,0,0,0,0,0,-,0,0,0,0:00
,346,Oskar Lindstedt,3,AIK,D,3,0,0,0,0,0,0,0,0,-,0,1,-1,2:29
,346,Michael Haga,85,Luleå,F,3,0,0,0,0,0,0,0,0,-,0,0,0,0:33
,346,Otto Jaksch,,Frölunda,D,3,0,0,0,0,0,0,0,0,-,0,0,0,0:00
,346,Dean Kukan,,Luleå,D,3,0,0,0,0,0,0,3,0,-,0,0,0,4:40
,346,Philip Martinsson,,Frölunda,D,3,0,0,0,0,0,0,0,0,-,0,0,0,0:00
,346,Axel Brage,33,Linköping,Gk,3,0,0,0,0,0,0,0,0,-,0,0,0,0:00
,346,Mattias Granlund,20,Skellefteå,F,3,0,0,0,0,0,0,1,3,-,0,0,0,4:41
,346,Linus Arnesson,28,Djurgården,D,3,0,0,0,0,0,0,0,0,-,0,0,0,0:00
,346,William Haag,13,Frölunda,F,3,0,0,0,0,0,0,0,0,-,0,0,0,0:13
,346,Karl-Johan Lundström,28,MODO,D,3,0,0,0,0,0,0,1,3,-,0,1,-1,9:56
,346,Nicklas Heinerö,10,AIK,F,3,0,0,0,2,0,0,1,0,-,1,0,1,4:43
,358,Andreas Hörberg,,Växjö,Gk,4,0,0,0,0,0,0,0,0,-,0,0,0,0:00
,358,Christopher Fish,29,Linköping,F,4,0,0,0,0,0,0,3,4,-,0,1,-1,6:16
,358,Charlie Torstensson,35,Frölunda,Gk,4,0,0,0,0,0,0,0,0,-,0,0,0,0:00
,358,Viktor Arvidsson,9,Skellefteå,F,4,0,0,0,0,0,0,1,0,-,0,0,0,2:54
,362,Joel Östman,,Timrå,D,5,0,0,0,2,0,0,1,1,-,0,2,-2,3:00
,362,Linus Fernström,39,Frölunda,Gk,5,0,0,0,0,0,0,0,0,-,0,0,0,0:00
,362,Linus Hultström,33,Linköping,D,5,0,0,0,4,0,0,5,2,-,1,2,-1,6:13
,362,Daniel Bertov,3,Färjestad,D,5,0,0,0,0,0,0,0,0,-,0,0,0,1:53
,362,Marcus Sandström,16,Luleå,F,5,0,0,0,2,0,0,0,4,-,0,1,-1,4:40
,362,Rickard Steijer,1,Timrå,Gk,5,0,0,0,0,0,0,0,0,-,0,0,0,0:00
,362,Aleksis Ahlqvist,1,Timrå,Gk,5,0,0,0,0,0,0,0,0,-,0,4,-4,0:00
,362,Victor Berglind,67,Brynäs,D,5,0,0,0,0,0,0,0,0,-,0,0,0,0:00
,362,Anton Byström,,MODO,F,5,0,0,0,2,0,0,2,0,-,0,0,0,7:01
,362,Patrik Edlund,,Timrå,D,5,0,0,0,0,0,0,3,0,-,0,0,0,4:14
,362,Joel Lassinantti,34,Luleå,Gk,5,0,0,0,0,0,0,0,0,-,0,0,0,0:00
,373,Robin Dahse,12,Växjö,F,6,0,0,0,0,0,0,3,0,-,0,0,0,4:03
,373,Peter Wennerström,13,Färjestad,F,6,0,0,0,6,0,0,1,3,-,0,1,-1,6:30
,375,Sebastian Nilsson,,Växjö,F,7,0,0,0,0,0,0,0,1,-,0,1,-1,1:36
,376,Linus Ullmark,30,MODO,Gk,8,0,0,0,0,0,0,0,0,-,4,6,-2,0:00
,376,Johan Linnander,20,HV71,F,8,0,0,0,2,0,0,1,0,-,0,1,-1,5:43
,376,Claes Nordén,21,Linköping,F,8,0,0,0,0,0,0,3,8,-,0,0,0,2:51
,379,Jonathan Johnson,22,Frölunda,F,9,0,0,0,0,0,0,0,0,-,0,0,0,1:52
,379,Linus Fröberg,71,Färjestad,F,9,0,0,0,0,0,0,2,0,-,1,3,-2,4:00
,381,Daniel Åhsberg,22,Växjö,F,10,0,0,0,0,0,0,10,2,-,0,0,0,7:21
,382,Anton Wedin,57,Timrå,F,11,0,0,0,0,0,0,6,2,-,1,2,-1,5:38
,382,Tyler Plante,35,Djurgården,Gk,11,0,0,0,0,0,0,0,0,-,0,0,0,0:00
,382,Oscar Dansk,35,Brynäs,Gk,11,0,0,0,0,0,0,0,0,-,0,0,0,0:00
,382,Patrik Hersley,6,MODO,D,11,0,0,0,2,0,0,15,4,-,2,8,-6,10:09
,386,Elias Lindholm,28,Brynäs,F,12,0,0,0,0,0,0,6,2,-,1,3,-2,3:45
,386,Marcus Bohman,37,MODO,D,12,0,0,0,0,0,0,3,2,-,4,0,4,3:56
,386,Kristoffer Wikner-Sundborg,17,Frölunda,F,12,0,0,0,0,0,0,3,1,-,0,2,-2,1:48
,389,Stefan Söder,91,Djurgården,F,13,0,0,0,0,0,0,2,1,-,2,1,1,1:49
,389,Jonas Gunnarsson,37,HV71,Gk,13,0,0,0,0,0,0,0,0,-,5,1,4,0:00
,391,Niklas Lundström,,AIK,Gk,15,0,0,0,0,0,0,0,0,-,7,3,4,0:00
,391,Marcus Johansson,29,Växjö,D,15,0,0,0,2,0,0,0,3,-,1,2,-1,4:23
,393,Patrik Näslund,,Frölunda,F,16,0,0,0,0,0,0,1,10,-,2,2,0,3:42
,394,Joachim Nermark,80,Linköping,F,17,0,0,0,2,0,0,12,9,-,1,3,-2,7:55
,395,Mattias Janmark,10,AIK,F,18,0,0,0,2,0,0,7,4,-,0,4,-4,7:46
,396,Jonathan Tholander,18,HV71,F,21,0,0,0,6,0,0,14,13,-,0,3,-3,4:47
,397,Oliver Bohm,3,Frölunda,D,22,0,0,0,2,0,0,4,0,-,0,4,-4,3:38
,398,Martin Laumann Ylven,35,Linköping,F,24,0,0,0,56,0,0,16,63,-,0,5,-5,7:45
,399,Jonas Frögren,24,Färjestad,D,33,0,0,0,47,0,0,16,74,-,25,15,10,16:27
,400,Sebastian Collberg,49,Frölunda,F,41,0,0,0,0,0,0,25,11,-,2,10,-8,6:56
,400,Tim Sandberg,31,Djurgården,Gk,41,0,0,0,0,0,0,0,0,-,5,7,-2,0:00
,402,Markus Svensson,35,AIK,Gk,45,0,0,0,0,0,0,0,0,-,22,24,-2,0:00
,403,Frederik Andersen,30,Frölunda,Gk,46,0,0,0,2,0,0,0,0,-,68,46,22,0:00
,403,Stefan Ridderwall,39,Timrå,Gk,46,0,0,0,0,0,0,0,0,-,28,41,-13,0:00
,405,Anton Forsberg,48,MODO,Gk,47,0,0,0,0,0,0,0,0,-,23,18,5,0:00
,406,Daniel Larsson,,HV71,Gk,48,0,0,0,4,0,0,0,0,-,61,51,10,0:00
,406,Andreas Andersson,54,HV71,Gk,48,0,0,0,4,0,0,0,0,-,36,25,11,0:00
,408,Johan Gustafsson,37,Luleå,Gk,50,0,0,0,0,0,0,0,0,-,49,38,11,0:00
,409,Martin Gerber,28,Växjö,Gk,51,0,0,0,2,0,0,0,0,-,56,65,-9,0:00
,410,Joakim Lundström,84,Timrå,Gk,52,0,0,0,2,0,0,0,0,-,63,68,-5,0:00
,410,Christian Engstrand,1,Linköping,Gk,52,0,0,0,2,0,0,0,0,-,13,15,-2,0:00
,412,Oscar Alsenfelt,69,Växjö,Gk,53,0,0,0,2,0,0,0,0,-,25,26,-1,0:00
,413,Cristopher Nihlstorp,41,Färjestad,Gk,54,0,0,0,2,0,0,0,0,-,65,62,3,0:00
,413,David Rautio,30,Luleå,Gk,54,0,0,0,0,0,0,0,0,-,42,34,8,0:00
,413,Joacim Eriksson,30,Skellefteå,Gk,54,0,0,0,2,0,0,0,0,-,57,44,13,0:00
,416,Fredrik Pettersson-Wentzel,53,Färjestad,Gk,55,0,0,0,0,0,0,0,0,-,19,20,-1,0:00
,1,Joakim Lindström,10,Skellefteå,F,54,28,32,60,134,7,15,151,59,-,44,34,10,17:05
,2,Mikko Lehtonen,8,Skellefteå,F,55,30,28,58,34,6,12,220,39,-,41,40,1,17:09
,3,David Rundblad,7,Skellefteå,D,55,11,39,50,14,7,3,115,46,-,46,40,6,22:49
,4,Martin Thörnberg,10,HV71,F,52,25,19,44,24,6,11,184,72,-,35,24,11,18:55
,5,Byron Ritchie,93,MODO,F,53,23,21,44,72,5,4,93,10,-,44,38,6,20:23
,6,Niklas Andersson,24,Frölunda,F,53,14,30,44,30,1,5,109,39,-,33,48,-15,18:15
,7,Linus Videll,55,SSK,F,52,20,23,43,10,4,3,120,13,-,44,40,4,17:32
,8,Per-Åge Skröder,10,MODO,F,55,15,26,41,62,1,7,178,49,-,34,32,2,19:13
,9,Pär Arlbrandt,40,Luleå,F,55,19,21,40,16,2,9,142,12,-,27,24,3,16:05
,10,Jaroslav Hlinka,71,Linköping,F,43,11,29,40,12,2,1,98,9,-,37,24,13,18:31
,11,Kamil Piros,26,HV71,F,54,12,27,39,34,2,2,67,33,-,38,31,7,15:12
,12,Magnus Johansson,7,Linköping,D,55,7,31,38,14,1,4,139,9,-,38,26,12,0:03
,13,Nicklas Danielsson,74,MODO,F,54,17,20,37,77,2,7,167,33,-,27,25,2,16:18
,14,Jan Hlavac,27,Linköping,F,43,16,21,37,18,3,4,129,4,-,37,19,18,18:39
,15,Johan Davidsson,76,HV71,F,40,11,26,37,35,1,3,71,0,-,29,14,15,20:11
,16,Chris Abbott,29,Luleå,F,55,17,19,36,32,10,4,98,62,-,31,29,2,18:05
,17,Andreas Dackell,12,Brynäs,F,53,11,25,36,26,2,4,67,7,-,27,39,-12,18:47
,18,Pelle Prestberg,10,Färjestad,F,48,10,26,36,12,2,3,109,6,-,22,22,0,14:03
,19,Mikael Johansson,85,Färjestad,F,45,12,23,35,22,2,3,69,6,-,24,21,3,15:23
,20,Sebastian Lauritzen,16,Brynäs,F,50,8,27,35,38,4,3,92,29,-,30,16,14,16:19
,21,Marcus Krüger,32,Djurgården,F,52,6,29,35,52,1,1,81,12,-,32,20,12,17:49
,22,Jakob Silfverberg,33,Brynäs,F,53,18,16,34,16,3,7,125,30,-,29,42,-13,18:02
,23,Eero Somervuori,8,Brynäs,F,55,17,17,34,24,4,8,144,34,-,24,38,-14,17:30
,24,Elias Fälth,33,Luleå,D,53,6,28,34,14,2,3,135,16,-,28,34,-6,20:53
,25,Jimmie Ericsson,21,Skellefteå,F,53,13,20,33,34,2,3,100,48,-,31,19,12,16:52
,26,Kim Hirschovits,44,Timrå,F,52,12,21,33,52,2,1,83,9,-,26,30,-4,16:57
,27,Niklas Sundström,24,MODO,F,53,11,22,33,38,2,2,67,10,-,34,21,13,19:21
,28,Mattias Ekholm,14,Brynäs,D,55,10,23,33,38,1,5,102,44,-,43,33,10,22:22
,28,Juuso Hietanen,11,HV71,D,55,10,23,33,18,4,8,172,21,-,39,30,9,22:08
,30,Christian Berglund,17,Färjestad,F,51,17,15,32,68,6,5,140,45,-,28,29,-1,16:20
,31,Patrik Zackrisson,26,Linköping,F,55,16,15,31,8,3,5,120,15,-,32,18,14,18:22
,32,Kris Beech,24,HV71,F,48,14,17,31,50,3,7,72,31,-,32,25,7,17:16
,33,Jonas Nordquist,39,Brynäs,F,50,13,18,31,18,1,3,89,3,-,27,27,0,15:47
,34,Teemu Laine,92,HV71,F,44,21,9,30,36,4,2,103,31,-,31,17,14,16:32
,35,Dick Axelsson,31,Färjestad,F,47,15,15,30,126,1,1,90,28,-,28,24,4,14:34
,36,Ryan Lasch,81,SSK,F,55,12,18,30,40,2,4,76,9,-,23,39,-16,15:02
,36,Tomi Kallio,71,Frölunda,F,55,12,18,30,36,2,3,163,49,-,33,50,-17,17:22
,38,Fredrik Warg,29,Skellefteå,F,50,11,19,30,30,2,4,81,42,-,32,29,3,15:49
,39,Janne Niinimaa,44,Luleå,D,48,9,21,30,44,2,7,86,10,-,32,34,-2,23:05
,40,Josef Boumedienne,78,Djurgården,D,52,5,25,30,73,0,2,103,27,-,30,40,-10,22:12
,41,Morten Madsen,29,MODO,F,55,14,15,29,6,3,3,100,36,-,34,36,-2,16:09
,42,Andreas Holmqvist,7,Djurgården,D,49,12,17,29,10,4,8,96,9,-,24,23,1,19:04
,43,Andreas Falk,19,HV71,F,55,9,20,29,56,3,2,76,13,-,31,30,1,17:53
,44,Simon Hjalmarsson,59,Luleå,F,55,8,21,29,16,1,3,136,22,-,23,31,-8,16:49
,45,Mattias Carlsson,15,SSK,F,55,17,11,28,10,3,6,133,17,-,32,34,-2,19:07
,46,Ilkka Pikkarainen,63,Timrå,F,50,15,13,28,119,2,6,107,127,-,26,25,1,14:20
,47,Joonas Vihko,20,Luleå,F,54,11,17,28,14,5,4,109,48,-,28,28,0,15:22
,48,Oscar Steen,45,AIK,F,55,10,18,28,42,1,1,63,8,-,27,27,0,16:43
,49,Joakim Eriksson,10,SSK,F,53,8,20,28,46,4,2,74,11,-,26,28,-2,19:33
,50,Pasi Puistola,21,HV71,D,54,5,23,28,52,0,5,94,12,-,39,29,10,21:38
,51,Calle Järnkrok,19,Brynäs,F,49,11,16,27,4,4,2,77,7,-,30,33,-3,16:45
,52,Jonas Almtorp,16,SSK,F,54,5,22,27,56,0,0,83,25,-,43,40,3,17:23
,53,Erik Forssell,20,Skellefteå,F,54,14,12,26,22,2,3,106,2,-,37,24,13,17:00
,54,Patrik Lundh,79,Färjestad,F,55,12,14,26,28,2,7,92,20,-,26,21,5,15:59
,55,Anton Lander,51,Timrå,F,49,11,15,26,38,2,1,122,26,-,27,40,-13,18:19
,56,Niklas Olausson,16,Luleå,F,44,10,16,26,12,1,4,66,3,-,24,16,8,16:28
,57,Patrik Carlsson,72,SSK,F,54,10,16,26,45,1,2,95,20,-,21,30,-9,15:47
,58,Anton Rödin,18,Brynäs,F,53,7,19,26,16,1,3,86,19,-,25,34,-9,15:28
,59,Christian Söderström,82,Skellefteå,F,54,10,15,25,20,3,1,116,25,-,29,20,9,16:11
,60,Fredrik Bremberg,73,HV71,F,45,9,16,25,14,2,0,46,0,-,28,21,7,13:11
,61,Jonathan Granström,31,Brynäs,F,50,5,20,25,48,0,1,62,53,-,25,37,-12,19:01
,62,Ladislav Nagy,22,MODO,F,25,12,12,24,46,2,4,67,21,-,20,14,6,19:03
,63,Kent McDonell,3,AIK,F,39,10,14,24,45,4,1,109,34,-,22,17,5,16:14
,64,Mattias Sjögren,11,Färjestad,F,51,7,17,24,44,2,2,99,55,-,32,27,5,17:32
,65,Anders Söderberg,26,Skellefteå,F,55,7,17,24,8,2,2,98,17,-,27,24,3,12:16
,66,Tim Erixon,4,Skellefteå,D,48,5,19,24,40,0,4,89,15,-,27,28,-1,19:53
,67,Riku Hahl,33,Frölunda,F,47,4,20,24,14,1,1,59,47,-,24,23,1,17:43
,68,Mathias Tjärnqvist,71,Djurgården,F,43,17,6,23,18,3,6,98,41,-,23,25,-2,18:18
,69,Mika Pyörälä,27,Frölunda,F,47,14,9,23,8,4,4,101,34,-,26,25,1,16:33
,70,Toni Koivisto,21,Frölunda,F,54,14,9,23,12,2,1,110,18,-,34,22,12,15:20
,71,Martin Röymark,27,Timrå,F,55,14,9,23,12,3,1,102,79,-,27,30,-3,16:02
,72,Matt Murley,19,/,F,44,12,11,23,36,1,5,78,22,-,24,26,-2,16:11
,73,Richard Gynge,10,AIK,F,51,12,11,23,22,3,0,91,30,-,30,37,-7,12:50
,74,Robert Rosén,87,MODO,F,55,11,12,23,8,1,10,65,8,-,3,9,-6,10:05
,75,Andreas Jämtin,18,Linköping,F,37,9,14,23,158,2,1,92,59,-,23,15,8,14:52
,76,Marcus Nilson,3,Djurgården,F,39,7,16,23,38,1,3,89,6,-,22,29,-7,16:41
,77,Dragan Umicevic,84,/,F,43,7,16,23,22,1,5,71,13,-,21,26,-5,13:45
,78,Kristofer Ottosson,9,Djurgården,F,53,6,17,23,16,1,3,79,7,-,28,36,-8,18:44
,79,Robert Carlsson,14,SSK,F,46,11,11,22,14,0,2,54,115,-,30,29,1,15:31
,80,Christian Sandberg,21,AIK,F,50,11,11,22,24,1,3,103,43,-,23,25,-2,15:15
,81,Per Åslund,22,Färjestad,F,53,11,11,22,8,1,2,107,31,-,26,23,3,15:12
,82,Gabriel Karlsson,49,Timrå,F,49,7,15,22,22,0,0,87,9,-,33,29,4,16:32
,83,Arto Laatikainen,42,SSK,D,54,6,16,22,28,3,2,104,56,-,39,39,0,22:50
,84,Jonas Junland,44,Färjestad,D,41,5,17,22,18,1,1,80,8,-,34,23,11,22:00
,85,Niclas Hävelid,28,Linköping,D,50,5,17,22,22,1,4,90,14,-,34,26,8,22:45
,86,Mikko Luoma,5,HV71,D,33,3,19,22,70,0,2,65,8,-,31,12,19,22:34
,87,Timo Pärssinen,27,Timrå,F,36,11,10,21,18,1,2,66,28,-,21,23,-2,16:43
,88,Daniel Widing,41,Djurgården,F,52,10,11,21,55,0,3,114,22,-,21,23,-2,14:31
,89,Erik Lindhagen,29,Linköping,F,55,10,11,21,14,3,0,71,2,-,26,14,12,12:56
,90,Rickard Wallin,51,Färjestad,F,32,9,12,21,20,2,3,83,6,-,23,11,12,18:33
,91,Oscar Ahlström,86,AIK,F,53,9,12,21,8,1,4,102,8,-,21,20,1,13:05
,92,Jukka Voutilainen,39,HV71,F,36,8,13,21,20,2,1,98,13,-,19,13,6,17:14
,93,Daniel Rudslätt,14,AIK,F,52,8,13,21,34,1,0,101,24,-,33,20,13,15:42
,94,Victor Ahlström,68,AIK,F,53,8,13,21,8,2,3,73,14,-,21,20,1,13:20
,95,Martin Sevc,55,Färjestad,D,51,6,15,21,96,3,2,93,32,-,38,38,0,23:26
,96,Lars Jonsson,20,Brynäs,D,45,13,7,20,20,2,4,87,19,-,31,33,-2,20:35
,97,Marcus Paulsson,53,Färjestad,F,43,11,9,20,14,2,0,85,21,-,24,20,4,13:50
,98,Johannes Salmonsson,25,AIK,F,52,9,11,20,28,0,3,59,23,-,23,29,-6,15:20
,99,Sebastian Enterfeldt,59,Luleå,F,53,9,11,20,10,1,2,64,43,-,22,23,-1,15:33
,100,Johan Lindström,79,HV71,F,51,8,12,20,10,1,0,64,24,-,23,17,6,12:48
,101,Oscar Sundh,13,HV71,F,53,8,12,20,22,2,0,66,18,-,29,17,12,13:16
,102,Mikael Johansson,21,Frölunda,F,55,8,12,20,24,3,2,82,51,-,24,33,-9,17:49
,103,Staffan Kronwall,24,Djurgården,D,45,7,13,20,14,1,1,79,25,-,37,25,12,22:51
,104,Rastislav Pavlikovsky,14,AIK,F,44,6,14,20,18,0,0,36,0,-,27,15,12,16:44
,105,Per Svartvadet,39,MODO,F,54,6,14,20,20,1,1,47,15,-,19,35,-16,14:50
,106,Sebastian Erixon,50,Timrå,D,44,5,15,20,20,1,0,98,9,-,31,38,-7,20:59
,107,Hannu Pikkarainen,48,MODO,D,24,3,17,20,4,1,3,72,4,-,20,13,7,0:29
,108,Henrik Tömmernes,7,Frölunda,D,47,3,17,20,24,0,0,110,24,-,29,46,-17,20:01
,109,Cam Abbott,24,Luleå,F,32,10,9,19,6,2,2,66,37,-,19,15,4,15:42
,110,Johan Andersson,24,AIK,F,48,10,9,19,16,3,1,53,5,-,24,34,-10,15:19
,111,Fredrik Lindgren,61,Skellefteå,D,51,5,14,19,38,0,0,79,23,-,40,22,18,20:23
,112,Mattias Timander,3,MODO,D,55,4,15,19,60,1,1,109,33,-,31,35,-4,21:58
,113,Pierre-Edouard Bellemare,41,Skellefteå,F,53,10,8,18,20,1,0,124,54,-,21,20,1,15:46
,114,Fredric Andersson,13,SSK,F,55,10,8,18,12,1,2,95,24,-,22,25,-3,12:33
,115,Mikko Mäenpää,27,Frölunda,D,46,8,10,18,46,3,3,98,23,-,30,30,0,19:17
,116,Martin Chabada,12,SSK,F,46,7,11,18,28,1,0,72,49,-,20,17,3,14:38
,117,Anders Bastiansen,20,Färjestad,F,51,6,12,18,30,2,0,66,9,-,22,28,-6,16:06
,118,Dale Clarke,76,Brynäs,D,53,4,14,18,34,2,2,99,8,-,28,38,-10,20:37
,119,Björn Svensson,26,Timrå,F,55,4,14,18,20,3,1,77,16,-,27,29,-2,13:29
,120,Markus Seikola,21,SSK,D,44,2,16,18,20,0,2,128,30,-,21,34,-13,17:52
,121,Mario Kempe,70,Djurgården,F,54,10,7,17,6,5,2,93,49,-,15,22,-7,12:20
,122,Joel Lundqvist,20,Frölunda,F,31,9,8,17,22,2,4,45,80,-,16,28,-12,19:15
,123,John Norman,37,Djurgården,F,51,8,9,17,10,2,0,67,11,-,22,18,4,12:49
,124,Lubos Bartecko,23,MODO,F,25,7,10,17,8,1,1,59,16,-,20,17,3,20:51
,125,Erik Andersson,2,Linköping,D,52,6,11,17,26,2,2,43,3,-,23,17,6,15:25
,126,Christian Bäckman,5,Frölunda,D,21,4,13,17,8,0,3,57,7,-,16,17,-1,23:04
,127,Jesper Fasth,18,HV71,F,36,7,9,16,6,1,2,34,25,-,14,8,6,12:33
,128,Daniel Grillfors,32,HV71,D,54,7,9,16,26,0,1,59,21,-,37,27,10,17:12
,129,Dick Tärnström,6,AIK,D,50,6,10,16,36,0,3,113,16,-,33,37,-4,21:41
,130,Per Hallin,8,Timrå,F,47,5,11,16,65,2,1,54,40,-,16,19,-3,13:05
,131,Patrick Cehlin,71,Djurgården,F,48,4,12,16,14,2,1,80,22,-,18,12,6,12:26
,132,Adam Almquist,5,HV71,D,52,0,16,16,32,0,0,62,12,-,39,19,20,19:48
,133,Pontus Petterström,18,Linköping,F,48,10,5,15,22,3,2,65,6,-,17,9,8,14:40
,134,Jesper Mattsson,26,Frölunda,F,23,7,8,15,8,1,5,41,20,-,8,6,2,14:56
,135,Mats Lavander,62,Luleå,F,48,6,9,15,10,1,3,60,10,-,13,13,0,14:24
,136,Mattias Karlsson,20,Timrå,D,54,6,9,15,24,2,4,122,86,-,35,49,-14,21:32
,137,Tim Eriksson,26,Djurgården,F,52,5,10,15,16,1,0,56,12,-,22,17,5,10:00
,137,Oscar Eklund,16,Djurgården,D,52,5,10,15,28,0,0,75,14,-,30,28,2,20:16
,139,Magnus Nygren,32,Färjestad,D,22,4,11,15,4,0,3,38,3,-,12,14,-2,16:54
,140,Kristofer Berglund,2,Färjestad,D,51,3,12,15,28,2,3,68,20,-,29,30,-1,20:41
,141,Daniel Corso,13,Timrå,F,18,7,7,14,41,1,2,39,10,-,14,13,1,16:32
,142,Mika Viinanen,37,Timrå,F,35,7,7,14,22,2,2,57,36,-,15,21,-6,16:56
,143,Mads Hansen,24,Brynäs,F,51,7,7,14,36,1,0,61,22,-,24,21,3,16:27
,144,Andreas Molinder,24,Linköping,F,54,7,7,14,10,0,1,55,8,-,24,13,11,13:07
,145,Oscar Lindberg,24,Skellefteå,F,41,5,9,14,31,1,0,56,31,-,17,18,-1,10:53
,146,Per-Johan Axelsson,11,Frölunda,F,50,4,10,14,41,1,0,56,31,-,19,29,-10,14:47
,147,Christian Eklund,20,Djurgården,F,53,4,10,14,44,0,1,51,49,-,21,20,1,13:03
,148,Mikael Håkanson,51,Linköping,F,36,7,6,13,14,1,6,80,10,-,11,15,-4,13:58
,149,Nicklas Lasu,31,Frölunda,F,54,7,6,13,24,1,0,78,73,-,17,27,-10,15:04
,150,Magnus Kahnberg,11,Brynäs,F,40,6,7,13,12,0,0,81,13,-,19,13,6,11:41
,151,Anton Axelsson,6,Timrå,F,28,5,8,13,4,0,1,25,21,-,11,13,-2,12:12
,152,Anton Hedman,8,MODO,F,48,5,8,13,97,0,3,58,121,-,9,22,-13,10:56
,153,Johan Forsberg,9,Skellefteå,F,34,4,9,13,4,0,1,53,33,-,12,13,-1,12:34
,154,Daniel Brodin,34,Djurgården,F,51,4,9,13,61,1,0,90,79,-,17,13,4,11:19
,155,Anders Eriksson,8,/,D,31,2,11,13,52,1,0,52,34,-,22,26,-4,0:41
,156,Lukas Kilström,5,SSK,D,50,2,11,13,43,0,0,47,40,-,31,22,9,16:32
,157,André Petersson,40,HV71,F,31,8,4,12,18,1,2,48,6,-,12,7,5,10:58
,158,Jimmie Ölvestad,19,Djurgården,F,34,7,5,12,20,1,0,63,60,-,17,23,-6,17:23
,159,Sanny Lindström,8,Färjestad,D,41,6,6,12,62,2,1,46,81,-,27,22,5,20:55
,160,Daniel Bång,20,AIK,F,40,5,7,12,82,2,1,51,59,-,12,19,-7,13:13
,161,Karl Fabricius,52,Luleå,F,54,5,7,12,6,1,1,72,25,-,11,20,-9,13:57
,162,Ville Koistinen,6,Skellefteå,D,31,4,8,12,24,0,1,52,30,-,21,22,-1,19:00
,163,David Engblom,33,AIK,F,53,4,8,12,22,0,1,49,36,-,24,24,0,14:30
,164,Andreas Karlsson,28,Frölunda,F,35,2,10,12,12,0,1,34,9,-,13,19,-6,12:33
,165,Antti Halonen,18,Timrå,D,44,2,10,12,69,1,0,53,61,-,32,23,9,17:56
,166,Martin Lundberg,27,Skellefteå,F,52,4,7,11,55,0,0,55,107,-,18,24,-6,12:13
,167,Jonas Liwing,23,AIK,D,45,3,8,11,10,1,2,53,13,-,17,30,-13,18:00
,168,Fredrik Hynning,12,Timrå,F,19,2,9,11,8,0,0,23,4,-,14,12,2,15:07
,169,Oscar Hedman,41,Frölunda,D,55,2,9,11,50,0,0,55,35,-,27,35,-8,20:04
,170,Mikko Jokela,9,Timrå,D,45,1,10,11,58,0,0,59,58,-,28,28,0,21:52
,171,Mathias Månsson,41,SSK,F,36,8,2,10,20,2,2,48,42,-,11,18,-7,14:31
,172,Martin Laumann Ylven,35,Linköping,F,46,6,4,10,55,1,0,69,103,-,16,11,5,10:45
,173,Sebastian Karlsson,12,Linköping,F,54,6,4,10,26,1,0,56,27,-,18,14,4,13:24
,174,Michael Holmqvist,18,Linköping,F,51,5,5,10,39,0,0,72,19,-,20,12,8,14:11
,174,Yared Hagos,91,Skellefteå,F,51,5,5,10,56,1,0,61,27,-,16,11,5,12:31
,176,Robin Lindqvist,22,/,F,54,5,5,10,44,1,1,45,47,-,15,27,-12,13:43
,177,Jamie Lundmark,17,Timrå,F,18,3,7,10,12,0,2,36,13,-,7,15,-8,16:53
,178,Jeff Ulmer,22,Linköping,F,29,6,3,9,6,1,1,55,3,-,11,14,-3,12:01
,179,Stefan Johansson,16,AIK,D,50,6,3,9,32,4,0,73,27,-,28,17,11,17:33
,180,Mika Zibanejad,93,Djurgården,F,26,5,4,9,2,0,0,53,28,-,8,7,1,12:02
,181,Nils Ekman,3,Djurgården,F,20,4,5,9,33,1,2,33,8,-,8,11,-3,15:12
,182,Kristian Forsberg,28,MODO,F,51,4,5,9,24,0,0,52,54,-,20,25,-5,13:34
,183,Kim Karlsson,,Luleå,F,55,4,5,9,6,0,1,61,6,-,16,17,-1,11:41
,184,Jari Tolsa,17,Linköping,F,48,3,6,9,28,1,1,39,31,-,11,12,-1,11:33
,185,Pavel Skrbek,11,/,D,40,2,7,9,18,0,1,36,22,-,23,24,-1,20:15
,186,Pierre Hedin,21,SSK,D,55,2,7,9,34,0,0,53,14,-,37,29,8,18:46
,187,Josh MacNevin,44,AIK,D,20,1,8,9,16,0,0,42,14,-,13,12,1,19:37
,188,Adam Larsson,5,Skellefteå,D,37,1,8,9,41,0,1,52,53,-,26,14,12,18:44
,189,Ivan Majesky,26,Skellefteå,D,44,1,8,9,28,0,1,44,50,-,24,20,4,18:10
,190,Jan Sandström,7,Luleå,D,51,1,8,9,8,1,1,81,22,-,26,36,-10,20:39
,191,Mika Hannula,33,Djurgården,F,14,5,3,8,12,2,3,40,7,-,6,7,-1,14:31
,192,Carl Klingberg,97,/,F,49,5,3,8,14,1,0,87,45,-,11,17,-6,10:18
,193,Johan Larsson,10,Brynäs,F,43,4,4,8,18,0,0,40,22,-,11,8,3,9:43
,194,Niclas Andersén,9,Brynäs,D,51,4,4,8,42,1,0,51,58,-,36,37,-1,18:51
,195,Marius Holtet,12,Färjestad,F,55,4,4,8,14,2,0,62,69,-,10,16,-6,9:55
,196,Alexander Sundström,,Brynäs,F,53,3,5,8,14,0,0,32,58,-,13,19,-6,10:08
,197,Julian Jacobsen,33,SSK,F,54,3,5,8,12,0,0,53,7,-,12,19,-7,9:00
,198,Per Ledin,97,HV71,F,43,2,6,8,58,1,0,38,39,-,20,15,5,14:42
,199,Elias Granath,4,Timrå,D,42,1,7,8,32,0,1,45,33,-,24,23,1,15:56
,200,Tomas Skogs,23,Timrå,D,43,1,7,8,50,0,0,42,55,-,26,22,4,19:22
,201,David Printz,55,Djurgården,D,50,1,7,8,79,0,0,47,52,-,32,33,-1,19:32
,202,Klas Dahlbeck,6,Linköping,D,47,0,8,8,12,0,0,40,8,-,27,19,8,16:21
,203,Alexander Larsson,20,Timrå,F,49,4,3,7,16,2,0,62,56,-,13,19,-6,10:00
,204,Emil Kåberg,27,Färjestad,F,51,4,3,7,36,0,1,57,62,-,11,21,-10,10:55
,205,Peter Nolander,70,AIK,D,52,4,3,7,18,0,0,51,12,-,27,33,-6,17:00
,206,Robin Sterner,18,Färjestad,F,53,4,3,7,18,0,1,40,9,-,13,9,4,8:52
,207,Johan Andersson,17,Linköping,F,51,3,4,7,49,2,0,91,34,-,14,14,0,13:10
,208,Yanick Lehoux,26,SSK,F,19,2,5,7,14,0,0,46,3,-,10,9,1,15:59
,209,Hans Jonsson,5,MODO,D,44,2,5,7,32,0,0,28,50,-,17,12,5,12:22
,210,Mikko Kalteva,57,SSK,D,46,2,5,7,24,1,0,26,26,-,23,26,-3,15:00
,211,Topi Jaakola,18,Luleå,D,55,2,5,7,14,0,0,45,26,-,28,28,0,18:38
,212,Patrik Nemeth,12,AIK,D,38,1,6,7,18,0,0,35,30,-,25,25,0,17:42
,213,Daniel Josefsson,12,MODO,D,45,1,6,7,6,1,0,34,6,-,21,27,-6,14:59
,214,Jens Westin,3,MODO,D,44,0,7,7,14,0,0,51,7,-,22,26,-4,15:01
,215,Niclas Burström,3,Skellefteå,D,52,0,7,7,16,0,0,41,3,-,26,24,2,14:46
,216,Melker Karlsson,15,Skellefteå,F,40,4,2,6,2,0,0,33,35,-,11,8,3,7:51
,216,Simon Önerud,11,HV71,F,40,4,2,6,14,0,0,38,28,-,8,8,0,6:22
,218,Jonathan Carlsson,36,Brynäs,D,46,4,2,6,12,1,0,33,21,-,15,19,-4,11:14
,219,Patric Blomdahl,84,AIK,F,39,3,3,6,92,0,1,49,86,-,15,15,0,12:19
,220,Nichlas Falk,16,Djurgården,F,45,3,3,6,12,0,1,20,3,-,19,16,3,15:08
,221,Anders Burström,21,Luleå,F,52,3,3,6,24,0,0,44,9,-,7,22,-15,12:44
,222,Charlie Cook,7,MODO,D,22,1,5,6,10,0,0,40,8,-,9,12,-3,19:55
,223,Stefan Bemström,22,SSK,D,53,1,5,6,28,0,0,59,15,-,35,27,8,18:40
,224,Robin Persson,11,Linköping,D,42,0,6,6,16,0,0,35,29,-,26,17,9,16:54
,225,Viktor Ekbom,8,Linköping,D,49,0,6,6,10,0,0,32,5,-,13,10,3,13:08
,226,Fredrik Carlsson,17,AIK,D,54,0,6,6,6,0,0,23,23,-,27,18,9,15:50
,227,Niko Dimitrakos,13,MODO,F,22,4,1,5,22,1,2,40,15,-,5,10,-5,14:08
,228,Richard Zednik,22,AIK,F,18,2,3,5,12,1,1,33,3,-,7,9,-2,16:26
,229,Pierre Johnsson,2,Luleå,D,25,2,3,5,6,1,0,19,33,-,12,12,0,16:58
,230,Jacob Blomqvist,44,MODO,F,49,2,3,5,12,0,0,43,32,-,7,15,-8,8:48
,231,Tobias Ericsson,67,AIK,D,41,1,4,5,14,0,0,29,19,-,8,15,-7,9:51
,232,John Klingberg,15,Frölunda,D,26,0,5,5,10,0,0,24,14,-,9,12,-3,12:34
,233,Josef Melichar,25,Linköping,D,41,0,5,5,24,0,0,30,22,-,24,12,12,15:05
,234,Per Hållberg,18,MODO,D,50,0,5,5,32,0,0,52,14,-,24,23,1,12:18
,235,Ville Mäntymaa,8,Frölunda,D,46,3,1,4,18,1,1,38,19,-,11,20,-9,12:44
,236,Tobias Viklund,16,Frölunda,D,55,2,2,4,36,0,0,74,60,-,20,40,-20,18:17
,237,Timo Seppänen,6,SSK,D,48,1,3,4,22,0,0,26,14,-,16,26,-10,13:40
,238,Christoph Schubert,16,Frölunda,D,23,0,4,4,49,0,0,33,57,-,17,17,0,20:40
,239,Pär Styf,36,Timrå,D,26,0,4,4,30,0,0,32,23,-,9,17,-8,15:14
,240,Jonas Brodin,25,Färjestad,D,42,0,4,4,12,0,0,29,6,-,25,19,6,14:10
,241,Nichlas Torp,38,HV71,D,48,0,4,4,32,0,0,33,84,-,26,24,2,13:51
,242,Fredrik Norrena,30,Linköping,Gk,52,0,4,4,12,0,0,0,1,-,82,60,22,0:00
,243,Linus Werneman,,Timrå,F,9,2,1,3,0,0,0,5,5,-,4,1,3,6:38
,244,Stefan Lassen,14,Djurgården,D,43,2,1,3,22,0,0,30,14,-,11,23,-12,10:31
,245,Daniel Rahimi,48,HV71,D,44,2,1,3,20,0,1,28,41,-,9,12,-3,10:01
,246,Andreas Pihl,2,Linköping,D,46,2,1,3,53,0,0,30,18,-,24,13,11,15:39
,247,Magnus Häggström,17,MODO,F,48,2,1,3,10,0,0,43,42,-,5,15,-10,8:19
,248,Mattias Beck,83,AIK,F,11,1,2,3,2,0,0,10,2,-,4,5,-1,7:30
,249,Jeremy Boyce,23,Timrå,F,33,1,2,3,4,0,0,12,10,-,3,6,-3,5:33
,250,Ole-Kristian Tollefsen,55,MODO,D,43,1,2,3,95,0,0,56,83,-,22,23,-1,19:01
,251,Pekka Saarenheimo,28,SSK,F,22,0,3,3,6,0,0,23,7,-,7,14,-7,12:32
,252,Emil Sandin,13,Brynäs,F,26,0,3,3,6,0,0,14,34,-,8,11,-3,8:02
,253,Sebastian Meijer,13,Luleå,F,45,0,3,3,8,0,0,34,14,-,6,14,-8,10:57
,254,Robin Jonsson,39,Luleå,D,53,0,3,3,24,0,0,30,9,-,20,22,-2,16:14
,255,Jörgen Sundqvist,22,Brynäs,D,54,0,3,3,59,0,0,45,99,-,28,48,-20,19:56
,255,Pontus Sjögren,87,SSK,Gk,54,0,3,3,2,0,0,0,0,-,78,72,6,0:00
,257,Jonas Berglund,14,Luleå,F,24,2,0,2,2,0,0,14,6,-,4,8,-4,9:58
,258,Fredrik Claesson,14,Djurgården,D,35,2,0,2,6,0,0,18,7,-,16,12,4,11:38
,259,Thom Flodqvist,20,SSK,F,38,2,0,2,0,0,0,17,1,-,4,10,-6,6:17
,260,Marcus Sörensen,66,Djurgården,F,8,1,1,2,0,0,0,9,4,-,3,1,2,9:27
,261,Simon Löf,14,Brynäs,D,15,1,1,2,4,0,0,7,1,-,3,5,-2,9:45
,262,Thomas Raffl,41,Luleå,F,22,1,1,2,10,0,0,19,13,-,2,6,-4,5:32
,263,Oscar Klefbom,7,Färjestad,D,23,1,1,2,2,0,0,11,6,-,7,6,1,8:22
,263,Adam Pettersson,12,Skellefteå,F,23,1,1,2,2,0,0,6,7,-,2,3,-1,4:04
,265,Eric Norin,47,AIK,D,11,0,2,2,2,0,0,9,4,-,4,8,-4,8:27
,266,Henrik Nilsson,27,AIK,D,17,0,2,2,10,0,0,5,4,-,1,6,-5,6:22
,266,Anton Byström,,MODO,F,17,0,2,2,2,0,0,8,3,-,4,1,3,6:33
,268,Alexander Bonsaksen,47,MODO,D,31,0,2,2,6,0,0,10,15,-,6,6,0,6:42
,269,Simon Bertilsson,15,Brynäs,D,36,0,2,2,20,0,0,16,46,-,15,11,4,12:13
,270,Johan Björk,55,HV71,D,40,0,2,2,12,0,0,16,6,-,13,6,7,9:46
,271,Jonas Frögren,24,Färjestad,D,43,0,2,2,53,0,0,15,68,-,26,19,7,18:42
,272,Sebastian Wännström,22,Brynäs,F,45,0,2,2,6,0,0,25,7,-,5,9,-4,4:51
,273,Vili Sopanen,17,Luleå,F,5,1,0,1,0,0,0,10,3,-,1,1,0,12:59
,274,Filip Olsson,,AIK,D,9,1,0,1,2,0,0,3,0,-,3,4,-1,5:48
,275,William Wallén,61,Frölunda,F,12,1,0,1,0,1,0,5,2,-,0,4,-4,2:29
,275,Tim Heed,4,SSK,D,12,1,0,1,0,0,1,13,1,-,1,9,-8,9:28
,275,Linus Fagemo,,Frölunda,F,12,1,0,1,2,0,0,21,2,-,2,3,-1,9:39
,278,Victor Berglind,67,Brynäs,D,18,1,0,1,2,0,1,2,0,-,0,4,-4,1:42
,279,Konstantin Komarek,67,Luleå,F,19,1,0,1,2,0,0,7,3,-,2,3,-1,4:51
,280,Christian Nyman,89,Luleå,F,21,1,0,1,0,0,0,4,1,-,1,2,-1,4:20
,281,Lars Lökken Östli,37,Luleå,D,32,1,0,1,8,1,1,10,2,-,2,5,-3,7:51
,282,Johan Sundström,28,Frölunda,F,41,1,0,1,10,0,0,16,6,-,1,8,-7,4:25
,283,Fredrik Sonntag,6,Timrå,D,47,1,0,1,20,0,0,14,24,-,11,12,-1,9:08
,284,Pontus Netterberg,14,HV71,F,3,0,1,1,0,0,0,2,2,-,0,1,-1,5:22
,284,Henrik Björklund,14,Färjestad,F,3,0,1,1,2,0,0,3,1,-,2,1,1,10:23
,286,Andreas Valdix,14,Timrå,F,4,0,1,1,0,0,0,0,1,-,2,0,2,7:06
,286,Gustaf Thorell,12,/,F,4,0,1,1,0,0,0,5,5,-,2,2,0,7:34
,286,Patrik Gozzi,22,AIK,D,4,0,1,1,0,0,0,1,2,-,1,2,-1,5:52
,286,Mikael Österberg,4,AIK,D,4,0,1,1,2,0,0,0,1,-,2,1,1,13:02
,290,Oskar Nilsson,,Luleå,F,5,0,1,1,4,0,0,2,0,-,2,1,1,11:11
,291,Richard Demén-Willaume,18,Frölunda,D,6,0,1,1,8,0,0,3,3,-,2,2,0,16:12
,292,Joakim Nordström,13,AIK,F,11,0,1,1,0,0,0,6,4,-,2,7,-5,6:54
,293,Joachim Nermark,80,Linköping,F,12,0,1,1,2,0,0,4,3,-,0,1,-1,4:58
,294,Johan Alm,,Skellefteå,D,13,0,1,1,6,0,0,11,3,-,4,6,-2,9:47
,295,Ludvig Rensfeldt,29,Brynäs,F,16,0,1,1,0,0,0,3,0,-,3,4,-1,4:22
,296,Fredrik Svensson,4,AIK,D,18,0,1,1,8,0,0,14,15,-,12,7,5,14:55
,297,Daniel Mannberg,79,Luleå,F,20,0,1,1,4,0,0,14,7,-,2,9,-7,9:54
,298,Blaz Gregorc,15,SSK,D,21,0,1,1,2,0,0,7,2,-,4,9,-5,7:29
,299,Petter Granberg,8,Skellefteå,D,23,0,1,1,6,0,0,4,7,-,5,4,1,6:10
,300,Alexander Deilert,54,Djurgården,D,27,0,1,1,4,0,0,9,5,-,4,2,2,6:15
,301,Anton Grundel,73,Färjestad,D,32,0,1,1,8,0,0,28,10,-,14,14,0,13:52
,302,Alexander Lagerström,23,SSK,F,40,0,1,1,4,0,0,12,2,-,4,6,-2,3:20
,303,Stefan Ridderwall,39,Djurgården,Gk,43,0,1,1,4,0,0,0,0,-,38,44,-6,0:00
,304,Alexander Salak,53,Färjestad,Gk,44,0,1,1,41,0,0,0,0,-,60,48,12,0:00
,304,Fredrik Styrman,2,Luleå,D,44,0,1,1,14,0,0,40,4,-,11,18,-7,16:20
,306,Niklas Svedberg,89,Brynäs,Gk,45,0,1,1,2,0,0,0,0,-,39,34,5,0:00
,307,Daniel Larsson,,HV71,Gk,52,0,1,1,8,0,0,2,0,-,89,66,23,0:00
,308,Johan Holmqvist,40,Frölunda,Gk,53,0,1,1,2,0,0,0,0,-,58,79,-21,0:00
,309,Tuomas Tarkki,32,MODO,Gk,55,0,1,1,2,0,0,0,0,-,78,75,3,0:00
,310,Marcus Due-Boje,1,Djurgården,Gk,1,0,0,0,0,0,0,0,0,-,0,0,0,0:00
,310,Pontus Åberg,46,Djurgården,F,1,0,0,0,0,0,0,0,0,-,0,0,0,0:00
,310,Patrik Edlund,,Timrå,D,1,0,0,0,0,0,0,0,1,-,0,0,0,4:44
,310,Pär Lindholm,17,Skellefteå,F,1,0,0,0,0,0,0,2,1,-,0,0,0,8:55
,310,Fredric Weigel,22,Djurgården,F,1,0,0,0,0,0,0,0,1,-,0,0,0,3:25
,310,Philip Holm,25,Djurgården,D,1,0,0,0,0,0,0,0,0,-,0,0,0,0:00
,310,John Westin,25,MODO,F,1,0,0,0,0,0,0,0,0,-,0,0,0,4:11
,310,Felix Eriksson,,Brynäs,F,1,0,0,0,0,0,0,0,0,-,0,0,0,0:00
,310,Oliver Bohm,3,Frölunda,D,1,0,0,0,0,0,0,0,0,-,0,0,0,0:00
,310,Joel Lassinantti,34,Luleå,Gk,1,0,0,0,0,0,0,0,0,-,0,0,0,0:00
,310,Douglas Lögdal,46,Timrå,F,1,0,0,0,0,0,0,0,0,-,0,0,0,6:19
,310,Pontus Johansson,,Timrå,F,1,0,0,0,0,0,0,0,0,-,0,0,0,0:00
,310,Jonathan Sääf,,Frölunda,Gk,1,0,0,0,0,0,0,0,0,-,0,0,0,0:00
,310,Joakim Ramsten,,AIK,F,1,0,0,0,0,0,0,0,0,-,0,0,0,0:02
,310,Daniel Olsson Trkulja,17,AIK,F,1,0,0,0,0,0,0,0,0,-,0,0,0,0:00
,310,Viktor Rönnbäck,,Luleå,D,1,0,0,0,0,0,0,0,0,-,0,0,0,0:00
,310,Ludwig Byström,,MODO,D,1,0,0,0,0,0,0,0,0,-,0,0,0,0:00
,310,Nicklas Heinerö,10,AIK,F,1,0,0,0,0,0,0,0,0,-,0,0,0,0:00
,310,Joakim Mattsson,2,Timrå,F,1,0,0,0,0,0,0,0,0,-,0,0,0,3:22
,310,Petri Pakaslahti,20,SSK,F,1,0,0,0,0,0,0,1,0,-,0,0,0,2:54
,310,Marcus Wallmark,,Skellefteå,F,1,0,0,0,0,0,0,0,0,-,0,0,0,0:00
,331,Tero Leinonen,1,Linköping,Gk,2,0,0,0,0,0,0,0,0,-,0,0,0,0:00
,331,Henrik Lundberg,,Skellefteå,F,2,0,0,0,0,0,0,0,0,-,0,0,0,1:40
,331,Jannick Christensen,,Frölunda,D,2,0,0,0,0,0,0,0,0,-,0,0,0,0:00
,331,Oskar Östlund,53,Brynäs,Gk,2,0,0,0,0,0,0,0,0,-,0,0,0,0:00
,331,Henrik Lundberg,1,Frölunda,Gk,2,0,0,0,0,0,0,0,0,-,0,0,0,0:00
,331,Linus Fröberg,71,Brynäs,F,2,0,0,0,0,0,0,1,0,-,0,0,0,10:11
,331,Alexander Ytterell,66,SSK,D,2,0,0,0,0,0,0,0,0,-,0,0,0,6:10
,331,Pål Eriksson,,Timrå,D,2,0,0,0,0,0,0,0,0,-,0,0,0,0:00
,331,Philip Kemi,,Luleå,D,2,0,0,0,2,0,0,1,1,-,0,0,0,12:43
,331,Johan Mattsson,33,SSK,Gk,2,0,0,0,0,0,0,0,0,-,0,0,0,0:00
,331,Niclas Edman,,Färjestad,D,2,0,0,0,0,0,0,0,2,-,0,1,-1,10:58
,342,Adam Rundqvist,23,Färjestad,F,3,0,0,0,0,0,0,1,0,-,0,1,-1,5:06
,342,Petter Emanuelsson,11,Skellefteå,F,3,0,0,0,0,0,0,0,0,-,0,0,0,2:55
,342,Jonas Gunnarsson,37,HV71,Gk,3,0,0,0,0,0,0,0,0,-,0,0,0,0:00
,342,Erik Thorell,20,Färjestad,F,3,0,0,0,0,0,0,0,0,-,0,0,0,2:02
,342,Sondre Olden,23,MODO,F,3,0,0,0,0,0,0,2,0,-,0,0,0,2:50
,342,Marcus Högström,4,/,D,3,0,0,0,2,0,0,3,0,-,2,1,1,9:11
,342,Marcus Ragnarsson,10,Djurgården,D,3,0,0,0,4,0,0,6,4,-,1,3,-2,18:51
,342,Viktor Arvidsson,9,Skellefteå,F,3,0,0,0,0,0,0,0,0,-,0,0,0,0:28
,342,Sebastian Strandberg,29,HV71,F,3,0,0,0,0,0,0,0,0,-,0,0,0,0:00
,351,Mattias Granlund,20,Skellefteå,F,4,0,0,0,0,0,0,0,4,-,0,0,0,2:14
,351,Andreas Gröndahl,19,SSK,F,4,0,0,0,2,0,0,0,0,-,0,0,0,2:35
,351,Gustaf Lindvall,30,Timrå,Gk,4,0,0,0,0,0,0,0,0,-,2,4,-2,0:00
,351,Mathias Franzen,72,AIK,F,4,0,0,0,0,0,0,0,0,-,0,0,0,2:47
,351,Ted Johansson,,Luleå,F,4,0,0,0,0,0,0,0,0,-,0,0,0,0:35
,351,Andreas Forsström,15,MODO,F,4,0,0,0,0,0,0,0,0,-,0,1,-1,3:52
,357,Kim Lennhammer,28,Djurgården,D,5,0,0,0,0,0,0,0,0,-,0,0,0,0:08
,357,Jesper Olofsson,92,MODO,F,5,0,0,0,0,0,0,3,1,-,0,1,-1,3:51
,357,Sebastian Collberg,49,Frölunda,F,5,0,0,0,0,0,0,2,3,-,0,0,0,1:36
,360,Arvid Strömberg,13,Djurgården,F,6,0,0,0,0,0,0,1,0,-,0,0,0,2:20
,360,Mattias Bäckman,5,Linköping,D,6,0,0,0,4,0,0,1,1,-,0,2,-2,4:39
,360,Eddie Larsson,53,MODO,D,6,0,0,0,2,0,0,5,2,-,0,2,-2,6:39
,360,Dennis Bozic,29,Linköping,D,6,0,0,0,0,0,0,3,2,-,0,0,0,5:38
,360,Rickard Steijer,1,Timrå,Gk,6,0,0,0,0,0,0,0,0,-,0,0,0,0:00
,365,Aleksis Ahlqvist,1,Timrå,Gk,7,0,0,0,0,0,0,0,0,-,8,12,-4,0:00
,366,Isak Ahrling,16,MODO,D,8,0,0,0,27,0,0,3,1,-,0,5,-5,5:51
,366,Casper Carning,,Frölunda,F,8,0,0,0,0,0,0,2,0,-,0,0,0,0:49
,366,Joel Mustonen,40,Skellefteå,F,8,0,0,0,0,0,0,6,1,-,0,3,-3,4:49
,366,Oscar Dansk,35,Brynäs,Gk,8,0,0,0,0,0,0,0,0,-,0,0,0,0:00
,366,Oscar Fantenberg,66,HV71,D,8,0,0,0,0,0,0,4,0,-,1,2,-1,7:43
,366,Vesa Toskala,31,AIK,Gk,8,0,0,0,0,0,0,0,0,-,3,5,-2,0:00
,372,Tim Harrysson,1,Linköping,Gk,9,0,0,0,0,0,0,0,0,-,0,0,0,0:00
,372,Jonas Sparring,1,Färjestad,Gk,9,0,0,0,0,0,0,0,0,-,0,0,0,0:00
,372,Petr Tenkrat,62,Skellefteå,F,9,0,0,0,2,0,0,11,5,-,2,3,-1,8:37
,372,Viktor Svedberg,8,Frölunda,D,9,0,0,0,0,0,0,0,0,-,0,0,0,0:00
,376,Robin Dahse,12,Frölunda,F,10,0,0,0,0,0,0,3,1,-,0,2,-2,3:08
,376,Andro Michel,40,Färjestad,Gk,10,0,0,0,0,0,0,0,0,-,8,3,5,0:00
,376,Marcus Karlsson,53,Färjestad,D,10,0,0,0,6,0,0,4,0,-,3,3,0,6:35
,379,Sebastian Ottosson,15,Linköping,F,11,0,0,0,0,0,0,1,0,-,0,0,0,1:48
,379,Lance Ward,47,HV71,D,11,0,0,0,22,0,0,6,9,-,2,4,-2,8:09
,379,Stefan Söder,91,Djurgården,F,11,0,0,0,0,0,0,1,1,-,0,1,-1,0:54
,379,Mattias Lindström,17,Skellefteå,F,11,0,0,0,8,0,0,3,11,-,0,1,-1,5:36
,379,Rasmus Edström,32,Skellefteå,D,11,0,0,0,0,0,0,1,0,-,1,4,-3,2:32
,384,Christopher Heino-Lindberg,40,AIK,Gk,12,0,0,0,0,0,0,0,0,-,5,11,-6,0:00
,384,Viktor Wahlquist,13,Linköping,F,12,0,0,0,0,0,0,4,2,-,0,0,0,3:15
,384,Matthias Trygg,49,MODO,F,12,0,0,0,0,0,0,1,0,-,0,0,0,2:04
,387,Joachim Rohdin,72,Brynäs,F,13,0,0,0,2,0,0,5,9,-,0,2,-2,5:46
,387,Niklas Lundström,,AIK,Gk,13,0,0,0,0,0,0,0,0,-,2,3,-1,0:00
,389,Tim Sandberg,31,Djurgården,Gk,14,0,0,0,0,0,0,0,0,-,6,2,4,0:00
,390,Fredrik Pettersson-Wentzel,53,Timrå,Gk,16,0,0,0,0,0,0,0,0,-,26,27,-1,0:00
,391,Axel Brage,33,Linköping,Gk,17,0,0,0,0,0,0,0,0,-,0,0,0,0:00
,391,Victor Backman,27,Frölunda,F,17,0,0,0,2,0,0,2,4,-,0,2,-2,4:54
,391,Simon Mitman,19,Djurgården,F,17,0,0,0,10,0,0,6,12,-,1,2,-1,4:40
,394,Jesper Thörnberg,23,HV71,F,23,0,0,0,2,0,0,19,5,-,1,3,-2,4:36
,395,Jonas Engström,17,SSK,F,24,0,0,0,2,0,0,7,1,-,2,2,0,2:57
,396,Peter Andersson,44,Frölunda,D,27,0,0,0,8,0,0,15,11,-,2,6,-4,5:11
,397,Christian Engstrand,1,Linköping,Gk,30,0,0,0,0,0,0,0,0,-,15,6,9,0:00
,398,Jesper Dahlroth,6,Timrå,D,32,0,0,0,12,0,0,23,8,-,4,17,-13,8:59
,399,Magnus Åkerlund,1,Timrå,Gk,37,0,0,0,4,0,0,0,0,-,24,19,5,0:00
,400,Juha Pitkämäki,31,Timrå,Gk,40,0,0,0,2,0,0,0,0,-,42,49,-7,0:00
,401,Thomas Greiss,25,Brynäs,Gk,42,0,0,0,2,0,0,0,0,-,51,65,-14,0:00
,402,Björn Bjurling,31,/,Gk,43,0,0,0,2,0,0,0,0,-,17,29,-12,0:00
,403,Cristopher Nihlstorp,41,Färjestad,Gk,47,0,0,0,2,0,0,0,0,-,35,37,-2,0:00
,403,Viktor Fasth,30,AIK,Gk,47,0,0,0,12,0,0,0,0,-,79,64,15,0:00
,405,Mark Owuya,30,Djurgården,Gk,52,0,0,0,0,0,0,0,0,-,53,50,3,0:00
,406,Joakim Lundström,84,Frölunda,Gk,54,0,0,0,2,0,0,0,0,-,26,32,-6,0:00
,406,Riku Helenius,1,SSK,Gk,54,0,0,0,0,0,0,1,0,-,24,34,-10,0:00
,406,Anders Nilsson,31,Luleå,Gk,54,0,0,0,2,0,0,0,0,-,45,47,-2,0:00
,409,Joacim Eriksson,30,Skellefteå,Gk,55,0,0,0,2,0,0,0,0,-,29,25,4,0:00
,409,Andreas Andersson,54,HV71,Gk,55,0,0,0,0,0,0,0,0,-,26,13,13,0:00
,409,David Rautio,30,Luleå,Gk,55,0,0,0,2,0,0,0,0,-,35,43,-8,0:00
,409,Nicklas Dahlberg,30,MODO,Gk,55,0,0,0,0,0,0,0,0,-,15,25,-10,0:00
,409,Andreas Hadelöv,1,Skellefteå,Gk,55,0,0,0,2,0,0,0,0,-,84,68,16,0:00
,1,Mats Zuccarello Aasen,36,MODO,F,55,23,41,64,62,2,8,164,-,-,45,37,8,22:17
,2,Tony Mårtensson,9,Linköping,F,55,19,44,63,26,3,9,147,-,-,43,35,8,21:26
,3,Johan Davidsson,76,HV71,F,55,12,46,58,18,1,3,100,-,-,48,29,19,20:43
,4,David Petrasek,22,HV71,D,52,15,38,53,101,1,12,118,-,-,46,31,15,22:48
,5,Jan Hlavac,27,Linköping,F,38,30,21,51,24,5,9,133,-,-,39,24,15,19:28
,6,Marcus Nilson,3,Djurgården,F,53,24,27,51,32,3,11,142,-,-,44,20,24,19:05
,7,Linus Klasen,86,SSK,F,51,19,32,51,20,2,6,124,-,-,33,47,-14,18:28
,8,Jaroslav Hlinka,71,Linköping,F,41,13,37,50,12,4,3,93,-,-,34,23,11,19:13
,9,Magnus Johansson,7,Linköping,D,52,8,41,49,14,2,5,143,-,-,37,32,5,1:30
,10,Eero Somervuori,8,Brynäs,F,55,19,25,44,18,1,6,169,-,-,36,35,1,18:23
,11,Daniel Corso,13,Timrå,F,49,16,28,44,68,1,3,103,-,-,45,29,16,20:18
,12,Hannu Pikkarainen,48,MODO,D,50,11,32,43,60,1,1,129,-,-,51,32,19,21:55
,13,Martin Sonnenberg,25,Timrå,F,42,20,22,42,68,6,5,95,-,-,40,27,13,18:51
,14,Tomi Kallio,71,Frölunda,F,55,18,22,40,40,3,5,143,-,-,33,33,0,18:02
,15,Brad Moran,20,Skellefteå,F,55,14,26,40,32,3,4,123,-,-,40,40,0,19:23
,16,Pasi Puistola,21,HV71,D,54,13,26,39,99,0,11,101,-,-,45,35,10,23:18
,17,Martin Thörnberg,10,HV71,F,52,20,18,38,42,3,9,157,-,-,38,21,17,18:27
,18,Fredrik Pettersson,10,Frölunda,F,54,20,18,38,67,3,4,150,-,-,43,35,8,17:39
,19,Jukka Voutilainen,39,HV71,F,37,16,21,37,10,2,7,97,-,-,27,18,9,18:42
,20,Pär Arlbrandt,40,Luleå,F,52,16,21,37,20,2,7,104,-,-,26,29,-3,15:20
,21,Björn Melin,9,HV71,F,55,14,22,36,32,3,8,137,-,-,28,28,0,16:07
,22,Dragan Umicevic,84,Färjestad,F,55,11,25,36,30,2,3,118,-,-,26,31,-5,14:14
,23,Stephen Dixon,14,Brynäs,F,53,20,15,35,55,3,9,91,-,-,34,31,3,20:08
,24,Cam Abbott,24,Luleå,F,48,16,19,35,108,1,4,122,-,-,36,24,12,17:16
,25,Mikael Håkanson,51,Linköping,F,39,15,20,35,16,3,10,81,-,-,28,17,11,15:47
,26,Eric Beaudoin,28,Rögle,F,55,14,20,34,59,5,7,109,-,-,27,45,-18,20:16
,27,Mathis Olimb,46,Frölunda,F,55,9,25,34,20,3,6,83,-,-,27,23,4,15:11
,28,Per-Åge Skröder,10,MODO,F,48,17,16,33,37,4,10,130,-,-,33,29,4,19:10
,29,Linus Videll,55,SSK,F,49,17,16,33,18,5,4,105,-,-,33,32,1,18:07
,30,Petri Pakaslahti,20,SSK,F,54,17,16,33,53,3,8,115,-,-,33,46,-13,19:38
,31,Niklas Andersson,24,Frölunda,F,54,15,18,33,50,2,2,96,-,-,39,34,5,17:44
,32,Chris Abbott,29,Luleå,F,52,13,20,33,62,0,4,89,-,-,43,27,16,19:05
,33,Andreas Dackell,12,Brynäs,F,48,9,24,33,26,1,3,67,-,-,25,26,-1,19:42
,34,Per Åslund,22,Färjestad,F,53,17,15,32,28,3,7,90,-,-,28,28,0,16:25
,35,Patrik Zackrisson,26,Linköping,F,45,16,16,32,20,3,7,72,-,-,23,28,-5,16:54
,36,Jonas Almtorp,16,SSK,F,54,13,19,32,38,3,2,114,-,-,38,31,7,19:27
,37,Magnus Kahnberg,11,Brynäs,F,55,20,11,31,32,5,5,134,-,-,27,23,4,15:09
,38,Andreas Jämtin,18,Linköping,F,55,18,13,31,125,2,9,129,-,-,24,19,5,13:48
,38,Anders Söderberg,26,Skellefteå,F,55,18,13,31,14,3,4,111,-,-,30,35,-5,16:14
,40,Jimmie Ericsson,21,Skellefteå,F,46,17,14,31,24,4,5,108,-,-,30,25,5,17:30
,41,Jimmie Ölvestad,19,Djurgården,F,48,17,14,31,54,3,5,104,-,-,43,17,26,17:34
,42,Yanick Lehoux,26,SSK,F,39,12,19,31,18,4,3,79,-,-,31,19,12,18:12
,43,Kyle Klubertanz,49,Djurgården,D,55,12,19,31,32,2,5,123,-,-,35,37,-2,22:15
,44,Marcus Krüger,32,Djurgården,F,38,11,20,31,14,2,7,50,-,-,22,6,16,16:41
,45,Christian Söderström,82,Skellefteå,F,48,11,20,31,20,3,2,69,-,-,27,23,4,14:58
,46,Joel Lundqvist,20,Frölunda,F,49,11,20,31,34,2,2,100,-,-,42,22,20,19:46
,47,Mats Lavander,62,Luleå,F,55,17,13,30,44,6,7,106,-,-,22,36,-14,17:02
,48,Peter Forsberg,21,MODO,F,23,11,19,30,66,2,3,40,-,-,23,12,11,16:50
,49,Niklas Olausson,16,Luleå,F,46,11,19,30,18,1,5,56,-,-,21,20,1,13:23
,50,Johan Fransson,10,Luleå,D,54,11,19,30,28,3,2,196,-,-,35,39,-4,22:59
,51,Marcus Paulsson,53,Färjestad,F,53,16,13,29,20,5,4,85,-,-,24,32,-8,14:15
,52,Teemu Laine,92,HV71,F,45,15,14,29,120,5,5,128,-,-,28,28,0,16:18
,53,Magnus Pääjärvi-Svensson,91,Timrå,F,49,12,17,29,6,1,1,160,-,-,38,24,14,17:25
,54,Juuso Hietanen,11,Brynäs,D,55,12,17,29,20,3,7,141,-,-,36,38,-2,2:03
,55,Per Svartvadet,39,MODO,F,55,11,18,29,32,0,3,83,-,-,47,31,16,19:11
,56,Markus Näslund,19,MODO,F,29,10,19,29,20,3,4,90,-,-,24,16,8,19:14
,57,Dominik Granak,51,Rögle,D,50,10,19,29,52,2,6,96,-,-,36,42,-6,0:30
,58,Fredrik Hynning,12,Timrå,F,53,8,21,29,34,0,2,98,-,-,32,31,1,18:44
,59,Ove Molin,21,Brynäs,F,53,4,25,29,26,1,2,76,-,-,20,27,-7,15:49
,60,Janne Niskala,22,Frölunda,D,50,12,16,28,34,0,3,125,-,-,39,33,6,23:23
,61,Erik Forssell,20,Skellefteå,F,55,11,17,28,16,3,0,99,-,-,35,22,13,17:20
,62,Christian Bäckman,5,Frölunda,D,47,10,18,28,46,1,3,98,-,-,47,35,12,1:50
,63,Jonathan Granström,31,Brynäs,F,55,10,18,28,66,1,3,67,-,-,28,29,-1,17:46
,64,Per Ledin,97,HV71,F,47,9,18,27,116,1,1,64,-,-,27,24,3,16:01
,65,Jesper Mattsson,26,Färjestad,F,52,3,24,27,50,1,1,83,-,-,23,24,-1,17:05
,66,Mathias Månsson,41,/,F,53,14,12,26,98,2,5,114,-,-,23,29,-6,18:00
,67,Andreas Engqvist,21,Djurgården,F,55,14,12,26,30,1,4,79,-,-,29,19,10,16:45
,68,Kristofer Ottosson,9,Djurgården,F,39,12,14,26,16,1,4,73,-,-,34,17,17,20:08
,69,Per-Johan Axelsson,11,Frölunda,F,47,10,16,26,51,1,4,74,-,-,30,29,1,17:22
,70,Johan Forsberg,9,Skellefteå,F,55,9,17,26,16,2,2,88,-,-,35,21,14,13:08
,71,Andreas Falk,19,HV71,F,55,13,12,25,64,6,0,67,-,-,34,28,6,15:47
,72,Jakob Johansson,26,Rögle,F,55,10,15,25,34,1,1,98,-,-,29,39,-10,18:07
,73,Sebastian Lauritzen,16,Brynäs,F,46,7,18,25,34,2,1,92,-,-,23,17,6,16:42
,74,Karl Fabricius,52,Luleå,F,55,6,19,25,28,1,2,107,-,-,30,29,1,16:18
,75,Mattias Timander,3,MODO,D,49,5,20,25,46,1,4,106,-,-,33,32,1,22:19
,76,Johan Lindström,79,HV71,F,48,12,12,24,12,1,0,49,-,-,24,18,6,11:56
,77,Gabriel Karlsson,49,Timrå,F,50,7,17,24,36,0,1,108,-,-,30,21,9,19:53
,78,Timmy Pettersson,33,Djurgården,D,55,4,20,24,46,1,2,84,-,-,27,24,3,18:48
,79,Andreas Holmqvist,7,Djurgården,D,51,3,21,24,91,0,1,105,-,-,50,26,24,21:55
,80,Robert Carlsson,14,SSK,F,55,13,10,23,42,1,3,87,-,-,28,42,-14,18:37
,81,Björn Svensson,26,Timrå,F,55,12,11,23,20,0,1,87,-,-,28,28,0,16:57
,82,Tomas Surovy,43,Skellefteå,F,48,10,13,23,10,1,2,103,-,-,27,27,0,13:48
,83,Jan Sandström,7,Luleå,D,54,6,17,23,52,0,3,119,-,-,33,38,-5,23:11
,84,Mattias Sjögren,11,Rögle,F,54,11,11,22,20,1,3,74,-,-,24,28,-4,17:10
,85,Petr Tenkrat,62,Skellefteå,F,42,9,13,22,18,1,2,98,-,-,27,20,7,15:20
,86,Fredrik Warg,29,Skellefteå,F,46,7,15,22,47,0,1,84,-,-,15,29,-14,15:27
,87,Kristofer Berglund,2,Luleå,D,55,6,16,22,22,0,1,85,-,-,33,31,2,17:39
,88,Peter Högardh,12,Rögle,F,47,5,17,22,16,1,1,82,-,-,19,35,-16,16:32
,89,Nichlas Falk,16,Djurgården,F,53,2,20,22,38,0,1,46,-,-,33,20,13,17:42
,90,Jeremy Colliton,24,Rögle,F,46,11,10,21,24,1,3,71,-,-,20,39,-19,18:49
,91,Kent McDonell,3,Färjestad,F,47,10,11,21,46,3,2,110,-,-,26,18,8,15:43
,92,Timo Pärssinen,27,Timrå,F,54,8,13,21,22,1,2,67,-,-,28,30,-2,14:22
,93,Oscar Sundh,13,HV71,F,53,5,16,21,26,1,1,58,-,-,26,18,8,12:42
,94,Janne Niinimaa,44,HV71,D,43,4,17,21,24,1,1,80,-,-,34,34,0,21:33
,95,Pavel Skrbek,11,Skellefteå,D,50,4,17,21,68,0,3,66,-,-,35,32,3,22:09
,96,Josh Green,27,MODO,F,47,12,8,20,79,2,2,61,-,-,27,23,4,15:09
,97,Morten Madsen,29,MODO,F,45,11,9,20,58,0,1,96,-,-,25,18,7,15:30
,98,Simon Hjalmarsson,59,Rögle,F,53,11,9,20,16,1,3,82,-,-,22,28,-6,12:42
,99,Marcus Johansson,90,Färjestad,F,42,10,10,20,10,2,3,69,-,-,17,17,0,14:05
,100,Nicklas Danielsson,74,Djurgården,F,55,10,10,20,42,4,1,136,-,-,24,22,2,14:17
,101,Jacob Josefson,40,Djurgården,F,43,8,12,20,20,4,2,79,-,-,18,11,7,15:17
,102,Pierre Hedin,21,SSK,D,48,7,13,20,48,0,2,83,-,-,34,35,-1,21:18
,103,Niklas Sundström,24,MODO,F,32,5,15,20,30,1,2,40,-,-,19,18,1,17:58
,104,Marcus Ragnarsson,10,Djurgården,D,37,5,15,20,44,2,0,62,-,-,38,22,16,23:10
,105,Yared Hagos,91,Skellefteå,F,53,5,15,20,89,1,2,78,-,-,29,22,7,13:47
,106,Mattias Tedenby,21,HV71,F,44,12,7,19,30,0,0,78,-,-,26,19,7,10:42
,107,Severin Blindenbacher,55,Färjestad,D,48,8,11,19,44,1,4,91,-,-,30,24,6,21:55
,108,Anders Bastiansen,20,Färjestad,F,55,8,11,19,26,1,1,75,-,-,32,31,1,17:39
,109,Joakim Eriksson,10,Linköping,F,53,6,13,19,20,3,1,73,-,-,18,27,-9,16:20
,110,Jonas Nordquist,39,Brynäs,F,33,5,14,19,8,2,2,44,-,-,14,19,-5,15:51
,111,Mads Hansen,24,Brynäs,F,49,4,15,19,28,0,0,67,-,-,21,20,1,17:31
,112,Daniel Glimmenvall,6,Rögle,D,50,3,16,19,50,0,2,70,-,-,23,39,-16,19:31
,113,Daniel Fernholm,24,Linköping,D,52,3,16,19,42,0,1,107,-,-,35,42,-7,20:15
,114,Magnus Häggström,17,MODO,F,54,10,8,18,14,3,0,79,-,-,25,25,0,10:17
,115,Michael Holmqvist,18,Djurgården,F,52,9,9,18,20,1,2,60,-,-,13,20,-7,9:45
,116,Martin Chabada,12,Luleå,F,50,7,11,18,50,2,3,75,-,-,19,23,-4,16:06
,117,Mario Kempe,70,Rögle,F,51,7,11,18,14,0,3,74,-,-,18,24,-6,11:02
,118,Joakim Andersson,18,Frölunda,F,55,6,12,18,42,1,1,69,-,-,30,25,5,14:32
,119,Patrick Yetman,24,SSK,F,23,5,13,18,4,0,1,40,-,-,13,14,-1,17:23
,120,Jonathan Hedström,71,Luleå,F,48,2,16,18,63,2,0,58,-,-,21,29,-8,15:24
,121,Jari Tolsa,17,Linköping,F,54,7,10,17,56,2,1,65,-,-,20,23,-3,12:04
,122,Tim Eriksson,26,Djurgården,F,55,7,10,17,22,1,1,77,-,-,24,23,1,12:40
,123,Laurent Meunier,10,Timrå,F,47,4,13,17,46,1,2,62,-,-,23,20,3,14:05
,124,Adam Larsson,5,Skellefteå,D,49,4,13,17,18,1,2,79,-,-,27,33,-6,17:35
,125,Jyri Marttinen,58,Skellefteå,D,52,4,13,17,91,1,0,75,-,-,42,30,12,21:30
,126,Tommy Enström,63,Rögle,F,54,3,14,17,70,0,1,70,-,-,19,32,-13,15:28
,127,Jakob Silfverberg,33,Brynäs,F,48,8,8,16,4,1,4,72,-,-,16,10,6,12:06
,128,Anton Lander,51,Timrå,F,49,7,9,16,12,3,0,70,-,-,24,26,-2,17:52
,129,Mathias Porseland,8,Rögle,D,51,6,10,16,30,1,4,80,-,-,18,35,-17,17:02
,130,David Ullström,29,HV71,F,47,5,11,16,27,1,1,39,-,-,13,14,-1,7:50
,131,Tomas Skogs,23,Timrå,D,49,4,12,16,44,1,2,53,-,-,26,31,-5,20:09
,132,Daniel Grillfors,32,HV71,D,53,2,14,16,28,0,1,62,-,-,36,32,4,18:54
,133,André Petersson,40,HV71,F,37,10,5,15,14,3,1,62,-,-,18,21,-3,10:16
,134,Thomas Raffl,41,Luleå,F,45,7,8,15,24,2,1,74,-,-,14,18,-4,11:33
,135,Mattias Karlsson,20,Timrå,D,37,5,10,15,38,1,2,73,-,-,32,22,10,21:45
,136,Ivan Majesky,26,Skellefteå,D,53,3,12,15,78,0,0,59,-,-,38,30,8,18:32
,137,Pierre-Edouard Bellemare,41,Skellefteå,F,49,9,5,14,16,2,0,82,-,-,18,14,4,12:38
,138,Andreas Molinder,24,MODO,F,48,5,9,14,18,0,0,41,-,-,16,19,-3,12:27
,139,Pontus Petterström,18,Linköping,F,50,4,10,14,12,0,0,69,-,-,21,18,3,14:12
,140,Mikael Johansson,21,Frölunda,F,55,4,10,14,14,1,0,58,-,-,28,34,-6,14:22
,140,Fredric Andersson,13,SSK,F,55,4,10,14,41,2,0,78,-,-,17,28,-11,13:41
,142,Peter Nolander,70,Brynäs,D,47,3,11,14,28,0,0,40,-,-,29,21,8,18:21
,143,Jonas Holös,6,Färjestad,D,51,1,13,14,24,0,1,82,-,-,30,34,-4,22:09
,144,Kamil Piros,26,Timrå,F,24,8,5,13,8,1,2,32,-,-,11,13,-2,17:22
,145,Tim Erixon,4,Skellefteå,D,45,7,6,13,44,1,4,55,-,-,27,30,-3,17:47
,146,Carl Klingberg,97,Frölunda,F,42,6,7,13,16,0,0,65,-,-,15,14,1,7:36
,147,Mattias Carlsson,15,Linköping,F,50,6,7,13,22,1,1,80,-,-,15,11,4,12:03
,148,Oscar Steen,45,MODO,F,52,4,9,13,32,1,1,62,-,-,20,28,-8,15:41
,149,Riku Hahl,33,Frölunda,F,26,3,10,13,12,1,2,37,-,-,8,13,-5,16:31
,150,Niclas Hävelid,28,Linköping,D,53,3,10,13,28,0,1,57,-,-,32,27,5,22:52
,151,David Rundblad,7,Skellefteå,D,47,1,12,13,14,1,0,75,-,-,32,28,4,15:32
,152,Ari Vallin,11,Färjestad,D,48,1,12,13,44,0,0,27,-,-,24,28,-4,18:40
,153,Lubos Bartecko,23,Färjestad,F,11,7,5,12,2,3,3,26,-,-,9,8,1,17:24
,154,Kris Beech,24,HV71,F,44,4,8,12,56,0,1,82,-,-,28,32,-4,17:04
,155,Fredrik Lindgren,61,Färjestad,D,45,4,8,12,26,0,2,50,-,-,25,28,-3,18:45
,156,Tobias Viklund,16,Frölunda,D,48,4,8,12,14,1,1,56,-,-,27,39,-12,19:31
,157,Erik Andersson,2,Linköping,D,51,4,8,12,36,0,3,80,-,-,28,24,4,19:01
,158,Emil Sandin,13,Brynäs,F,51,2,10,12,10,0,1,37,-,-,13,9,4,8:05
,159,Arto Laatikainen,42,Färjestad,D,38,1,11,12,18,0,1,67,-,-,23,23,0,19:54
,160,Anton Axelsson,6,Timrå,F,51,5,6,11,4,2,0,48,-,-,16,35,-19,13:36
,161,Patrick Cehlin,71,Djurgården,F,54,5,6,11,10,1,0,75,-,-,13,21,-8,9:16
,162,Mike Zigomanis,97,Djurgården,F,27,4,7,11,12,0,1,61,-,-,14,13,1,16:16
,163,Andrée Brendheden,65,Rögle,F,34,4,7,11,16,0,0,52,-,-,13,17,-4,13:20
,164,Anders Burström,21,Luleå,F,44,4,7,11,18,0,0,45,-,-,13,16,-3,12:52
,165,Christian Eklund,20,Djurgården,F,52,4,7,11,32,0,0,47,-,-,19,17,2,11:40
,166,Elias Granath,4,Timrå,D,53,4,7,11,44,1,1,47,-,-,24,30,-6,15:37
,167,Petr Caslava,9,Timrå,D,43,3,8,11,34,1,2,74,-,-,31,31,0,23:40
,168,Daniel Josefsson,12,SSK,D,53,2,9,11,71,0,0,86,-,-,27,41,-14,22:44
,169,Stefan Bemström,22,SSK,D,49,1,10,11,20,0,0,57,-,-,26,37,-11,17:40
,170,Eric Moe,9,Timrå,D,43,0,11,11,16,0,0,54,-,-,24,21,3,15:28
,171,Dick Axelsson,31,Färjestad,F,15,6,4,10,24,1,1,28,-,-,9,9,0,13:23
,172,Mikael Lidhammar,20,Luleå,F,46,6,4,10,47,0,1,41,-,-,16,15,1,10:43
,173,Emil Lundberg,51,Luleå,F,48,5,5,10,10,1,1,49,-,-,11,17,-6,12:41
,174,Tomas Mojzis,4,MODO,D,52,5,5,10,44,0,2,60,-,-,21,22,-1,17:50
,175,Calle Järnkrok,19,Brynäs,F,33,4,6,10,2,2,1,18,-,-,11,6,5,11:06
,176,Antti Pihlström,41,Färjestad,F,43,4,6,10,44,3,1,99,-,-,16,16,0,15:04
,177,Stefan Pettersson,77,SSK,F,30,2,8,10,40,0,0,37,-,-,11,19,-8,11:15
,178,Daniel Sondell,50,MODO,D,42,2,8,10,18,1,0,64,-,-,33,40,-7,20:04
,179,Tim Heed,4,SSK,D,27,1,9,10,2,0,1,24,-,-,3,11,-8,7:15
,180,Per Hållberg,18,MODO,D,32,1,9,10,16,0,1,41,-,-,23,10,13,18:47
,181,Philip Larsen,3,Frölunda,D,42,1,9,10,20,0,1,63,-,-,31,25,6,18:28
,182,Robin Sterner,18,Färjestad,F,44,6,3,9,12,0,1,31,-,-,9,13,-4,5:55
,183,Jörgen Sundqvist,22,Brynäs,D,50,5,4,9,58,2,1,52,-,-,39,31,8,21:39
,184,Johan Andersson,17,Färjestad,F,52,5,4,9,75,0,1,70,-,-,12,20,-8,14:42
,185,Marius Holtet,12,Färjestad,F,55,5,4,9,42,0,1,98,-,-,14,22,-8,12:56
,185,Martin Röymark,27,Frölunda,F,55,5,4,9,12,1,0,39,-,-,15,21,-6,10:35
,187,Alexander Sundström,,Brynäs,F,55,4,5,9,30,1,0,40,-,-,28,21,7,12:43
,188,Pär Styf,36,Timrå,D,34,3,6,9,44,0,0,56,-,-,26,23,3,19:19
,189,Sanny Lindström,8,Färjestad,D,50,3,6,9,50,1,1,55,-,-,26,29,-3,19:42
,190,Nicklas Lasu,31,Frölunda,F,51,2,7,9,10,0,0,35,-,-,14,11,3,7:55
,191,Patric Blomdahl,84,Frölunda,F,49,6,2,8,90,1,0,36,-,-,18,23,-5,9:31
,192,Marco Tuokko,13,MODO,F,51,5,3,8,43,0,0,46,-,-,12,14,-2,8:30
,193,Dan Hinote,58,MODO,F,26,4,4,8,28,1,0,20,-,-,10,8,2,10:53
,194,Mads Bödker,7,Rögle,D,55,3,5,8,18,1,0,61,-,-,25,36,-11,15:55
,195,Adam Almquist,5,HV71,D,28,2,6,8,10,1,0,30,-,-,26,15,11,17:26
,195,Ville Mäntymaa,8,Frölunda,D,28,2,6,8,18,1,2,28,-,-,13,8,5,14:44
,197,Johan Alcén,14,Rögle,F,47,2,6,8,26,0,0,42,-,-,12,25,-13,11:47
,198,Ramzi Abid,32,Rögle,F,10,1,7,8,8,0,1,19,-,-,7,12,-5,17:08
,199,Ryan Glenn,40,SSK,D,31,1,7,8,24,0,0,47,-,-,17,25,-8,17:52
,200,Daniel Rahimi,48,Rögle,D,55,1,7,8,67,0,1,33,-,-,22,36,-14,16:36
,201,Jiri Bicek,34,SSK,F,44,5,2,7,22,0,1,53,-,-,14,19,-5,12:04
,202,Sebastian Erixon,50,Timrå,D,46,4,3,7,14,1,1,107,-,-,27,27,0,21:29
,203,Mikael Gath,14,Rögle,F,53,4,3,7,83,0,0,51,-,-,11,25,-14,10:04
,204,Fredrik Emvall,33,Linköping,F,55,3,4,7,14,0,0,53,-,-,17,18,-1,13:50
,205,Fredrik Svensson,4,SSK,D,37,2,5,7,32,0,1,25,-,-,19,22,-3,15:37
,206,Baptiste Amar,27,Rögle,D,51,2,5,7,30,0,1,53,-,-,18,36,-18,17:56
,207,Oscar Hedman,41,Frölunda,D,52,2,5,7,12,0,0,50,-,-,23,33,-10,15:32
,208,Robin Persson,11,Linköping,D,55,2,5,7,34,1,0,44,-,-,33,28,5,13:29
,208,David Printz,55,Djurgården,D,55,2,5,7,71,1,0,38,-,-,30,32,-2,19:02
,210,Julian Jakobsen,33,SSK,F,41,1,6,7,27,0,0,42,-,-,8,10,-2,7:10
,211,Andreas Karlsson,28,Frölunda,F,15,3,3,6,6,0,1,18,-,-,4,8,-4,14:48
,212,Niclas Andersén,9,Brynäs,D,42,3,3,6,28,1,0,38,-,-,18,26,-8,17:11
,213,Per Hallin,8,SSK,F,55,3,3,6,44,0,0,87,-,-,10,26,-16,12:45
,213,Sebastian Karlsson,12,Linköping,F,55,3,3,6,28,0,0,49,-,-,9,17,-8,10:03
,215,Pierre Johnsson,2,Luleå,D,36,2,4,6,38,1,2,45,-,-,18,20,-2,17:03
,216,Martin Laumann Ylven,35,Linköping,F,54,2,4,6,38,0,0,44,-,-,8,12,-4,7:09
,217,Petri Kokko,32,Brynäs,D,8,1,5,6,6,0,1,8,-,-,6,3,3,19:13
,218,Kristian Kudroc,4,/,D,38,1,5,6,92,0,0,46,-,-,19,18,1,15:38
,219,Nichlas Torp,38,HV71,D,47,1,5,6,93,0,0,44,-,-,25,19,6,14:46
,220,Robin Lindqvist,22,Luleå,F,49,1,5,6,10,0,0,33,-,-,9,23,-14,11:47
,221,Stefan Gråhns,41,SSK,F,53,1,5,6,82,0,0,39,-,-,8,24,-16,10:37
,222,Mikael Johansson,85,Färjestad,F,12,0,6,6,6,0,0,14,-,-,5,6,-1,13:12
,223,Simon Önerud,11,HV71,F,42,4,1,5,16,1,0,33,-,-,6,8,-2,6:06
,224,Lee Goren,37,Färjestad,F,16,3,2,5,65,1,0,40,-,-,6,7,-1,16:19
,225,David Fredriksson,54,SSK,F,44,3,2,5,61,1,1,35,-,-,4,17,-13,8:29
,226,Niklas Anger,17,Timrå,F,26,2,3,5,0,0,1,37,-,-,6,12,-6,12:43
,227,Daniel Brodin,34,Djurgården,F,30,2,3,5,26,1,0,44,-,-,5,11,-6,7:41
,228,Emil Kåberg,27,Färjestad,F,46,2,3,5,79,0,1,59,-,-,9,17,-8,13:14
,229,Peter Andersson,44,Frölunda,D,21,1,4,5,4,0,0,21,-,-,11,9,2,12:45
,230,Anton Rödin,18,Brynäs,F,36,1,4,5,8,0,0,29,-,-,10,11,-1,8:25
,231,Andreas Pihl,2,Linköping,D,42,1,4,5,42,1,0,42,-,-,26,19,7,17:28
,232,Stefan Erkgärds,4,Rögle,D,43,0,5,5,10,0,0,13,-,-,9,14,-5,6:38
,233,Mika Hannula,33,Djurgården,F,7,3,1,4,0,0,1,19,-,-,4,3,1,12:34
,234,Mikko Lehtonen,26,Frölunda,D,9,3,1,4,10,0,2,31,-,-,3,9,-6,23:47
,235,Mathias Tjärnqvist,71,Djurgården,F,18,2,2,4,8,0,1,41,-,-,7,5,2,15:52
,236,Kirill Starkov,14,Timrå,F,55,2,2,4,14,0,0,35,-,-,6,10,-4,6:05
,236,Kristian Forsberg,28,MODO,F,55,2,2,4,14,0,0,30,-,-,13,15,-2,8:05
,238,Lars Jonsson,20,Brynäs,D,8,1,3,4,8,0,1,27,-,-,4,4,0,1:02
,239,Giulio Scandella,17,Rögle,F,11,1,3,4,6,0,0,20,-,-,4,9,-5,14:50
,240,Henrik Björklund,14,Färjestad,F,19,1,3,4,4,0,0,10,-,-,3,5,-2,5:24
,241,Simon Bertilsson,15,Brynäs,D,32,1,3,4,43,0,0,30,-,-,11,18,-7,16:50
,242,Lukas Kilström,5,SSK,D,38,1,3,4,32,0,0,15,-,-,10,24,-14,11:29
,243,Oscar Eklund,16,Djurgården,D,53,1,3,4,30,0,0,31,-,-,19,9,10,11:12
,244,Topi Jaakola,18,SSK,D,30,0,4,4,8,0,0,44,-,-,16,19,-3,17:35
,245,Henrik Eriksson,17,Djurgården,F,34,0,4,4,6,0,0,20,-,-,9,7,2,6:04
,246,Hans Jonsson,5,MODO,D,43,0,4,4,26,0,0,40,-,-,23,17,6,16:28
,247,Martin Lundberg,27,Skellefteå,F,46,0,4,4,67,0,0,20,-,-,11,18,-7,9:07
,248,Samuli Suhonen,80,MODO,D,15,2,1,3,10,0,0,42,-,-,16,12,4,20:19
,249,Fredrik Sonntag,6,Timrå,D,22,2,1,3,4,0,0,17,-,-,7,9,-2,12:52
,250,Jens Karlsson,58,Frölunda,F,10,1,2,3,2,1,0,9,-,-,3,5,-2,9:36
,251,Thomas Enström,11,MODO,F,26,1,2,3,8,0,0,20,-,-,4,4,0,6:53
,252,Robin Jonsson,39,Luleå,D,36,1,2,3,18,1,0,21,-,-,15,9,6,13:06
,253,Andreas Salomonsson,15,MODO,F,8,0,3,3,10,0,0,11,-,-,0,4,-4,16:29
,254,Christopher Liljewall,52,Rögle,F,20,0,3,3,6,0,0,9,-,-,3,7,-4,8:08
,255,Henrik Tömmernes,7,Frölunda,D,27,0,3,3,10,0,0,23,-,-,12,8,4,7:32
,256,Per Johnsson,3,Färjestad,D,29,0,3,3,14,0,0,14,-,-,11,6,5,10:09
,257,Lance Ward,47,HV71,D,30,0,3,3,73,0,0,20,-,-,20,13,7,14:17
,257,Blaz Gregorc,15,SSK,D,30,0,3,3,10,0,0,3,-,-,3,4,-1,3:12
,259,Jens Westin,3,MODO,D,36,0,3,3,6,0,0,25,-,-,9,13,-4,9:53
,260,Niklas Strandberg,8,Skellefteå,D,37,0,3,3,37,0,0,22,-,-,8,5,3,8:22
,261,Fredrik Styrman,2,Luleå,D,39,0,3,3,16,0,0,18,-,-,16,12,4,11:35
,262,Christoffer Norgren,29,Skellefteå,D,47,0,3,3,36,0,0,9,-,-,16,23,-7,15:32
,263,Fredrik Norrena,30,Linköping,Gk,55,0,3,3,26,0,0,1,-,-,70,75,-5,0:00
,263,Simon Löf,14,Brynäs,D,55,0,3,3,10,0,0,11,-,-,17,13,4,8:53
,263,Johan Ejdepalm,8,Luleå,D,55,0,3,3,62,0,0,37,-,-,24,33,-9,15:30
,266,Henri Laurila,,MODO,D,9,2,0,2,6,1,1,17,-,-,4,0,4,15:37
,267,Melker Karlsson,15,Skellefteå,F,36,2,0,2,8,0,1,16,-,-,2,5,-3,4:28
,268,Jens Svensson,22,Timrå,F,5,1,1,2,2,0,0,4,-,-,2,0,2,5:04
,269,Robert Kantor,5,Rögle,D,9,1,1,2,8,1,0,14,-,-,5,9,-4,16:41
,270,Dennis Everberg,18,Rögle,F,12,1,1,2,6,0,0,5,-,-,2,3,-1,6:12
,271,Peter Nylander,11,Timrå,F,22,1,1,2,6,0,0,13,-,-,5,9,-4,7:37
,272,Oscar Lindberg,24,Skellefteå,F,36,1,1,2,10,0,0,18,-,-,2,10,-8,5:50
,273,Alexander Hellström,7,Luleå,D,45,1,1,2,99,0,0,21,-,-,12,23,-11,13:33
,274,Johan Björk,55,HV71,D,29,0,2,2,6,0,0,24,-,-,8,17,-9,13:51
,275,Viktor Ekbom,8,Linköping,D,47,0,2,2,16,0,0,24,-,-,10,11,-1,10:25
,276,Alexander Bonsaksen,47,MODO,D,48,0,2,2,20,0,0,16,-,-,12,13,-1,9:53
,277,Stefan Liv,1,HV71,Gk,51,0,2,2,18,0,0,0,-,-,100,72,28,0:00
,278,Jens Olsson,28,SSK,D,55,0,2,2,44,0,0,38,-,-,30,31,-1,18:32
,279,Thom Flodqvist,20,SSK,F,7,1,0,1,0,0,0,3,-,-,1,0,1,5:03
,280,Robin Andersson,32,Luleå,F,10,1,0,1,2,0,0,5,-,-,1,1,0,6:03
,281,Adam Eriksson,16,MODO,F,13,1,0,1,2,0,0,7,-,-,1,1,0,3:52
,282,Ossi-Petteri Grönholm,3,Brynäs,D,16,1,0,1,34,0,0,21,-,-,6,6,0,17:26
,283,Eddie Larsson,53,MODO,D,19,1,0,1,2,0,0,4,-,-,4,6,-2,3:41
,284,Petter Emanuelsson,11,Skellefteå,F,1,0,1,1,0,0,0,0,-,-,1,0,1,8:21
,285,Oscar Fantenberg,66,HV71,D,3,0,1,1,0,0,0,4,-,-,1,0,1,11:24
,286,Jussi Makkonen,16,Frölunda,F,9,0,1,1,2,0,0,15,-,-,1,9,-8,12:34
,286,Angel Krstev,2,Färjestad,D,9,0,1,1,12,0,0,10,-,-,4,7,-3,18:32
,288,Johan Linnander,20,HV71,F,10,0,1,1,0,0,0,1,-,-,2,1,1,2:11
,289,Victor Berglind,67,Brynäs,D,11,0,1,1,2,0,0,2,-,-,1,2,-1,2:20
,290,Richard Demén-Willaume,18,Rögle,D,12,0,1,1,10,0,0,13,-,-,0,3,-3,9:47
,290,Per Gustafsson,7,HV71,D,12,0,1,1,16,0,0,16,-,-,7,9,-2,14:19
,292,Erik Lindhagen,29,Linköping,F,13,0,1,1,6,0,0,11,-,-,1,1,0,6:07
,293,Robin Olsson,5,Luleå,D,20,0,1,1,2,0,0,6,-,-,4,4,0,6:32
,294,Jesper Samuelsson,10,Timrå,F,23,0,1,1,8,0,0,4,-,-,4,4,0,3:09
,294,Daniel Hermansson,22,Brynäs,F,23,0,1,1,8,0,0,26,-,-,0,6,-6,6:38
,296,Alexander Deilert,54,Djurgården,D,26,0,1,1,0,0,0,10,-,-,4,9,-5,7:03
,297,Marcus Karlsson,53,Färjestad,D,28,0,1,1,2,0,0,9,-,-,4,8,-4,5:06
,298,Anders Nilsson,31,Luleå,Gk,48,0,1,1,0,0,0,0,-,-,31,45,-14,0:00
,299,Jacob Markström,25,Brynäs,Gk,49,0,1,1,4,0,0,0,-,-,70,61,9,0:00
,300,Anders Lindbäck,39,Timrå,Gk,50,0,1,1,2,0,0,0,-,-,82,73,9,0:00
,301,Nicklas Dahlberg,30,Skellefteå,Gk,52,0,1,1,0,0,0,0,-,-,6,12,-6,0:00
,302,Cristopher Nihlstorp,41,Rögle,Gk,54,0,1,1,4,0,0,0,-,-,45,75,-30,0:00
,303,Andreas Andersson,54,HV71,Gk,55,0,1,1,2,0,0,0,-,-,22,27,-5,0:00
,303,Gustaf Wesslau,32,Djurgården,Gk,55,0,1,1,0,0,0,0,-,-,59,44,15,0:00
,303,Johan Holmqvist,40,Frölunda,Gk,55,0,1,1,2,0,0,0,-,-,105,99,6,0:00
,306,Tim Weber,16,MODO,F,1,0,0,0,0,0,0,0,-,-,0,0,0,0:00
,306,Sebastian Ström,2,Rögle,D,1,0,0,0,0,0,0,0,-,-,0,0,0,0:00
,306,Viktor Huss,26,Timrå,F,1,0,0,0,0,0,0,0,-,-,0,0,0,0:00
,306,Daniel Holmberg,14,Linköping,F,1,0,0,0,0,0,0,0,-,-,0,0,0,0:00
,306,Johan Sundström,28,Frölunda,F,1,0,0,0,0,0,0,0,-,-,0,0,0,3:04
,306,Olle Ericsson,16,MODO,F,1,0,0,0,0,0,0,1,-,-,0,0,0,2:11
,306,Arvid Strömberg,13,Djurgården,F,1,0,0,0,0,0,0,0,-,-,0,0,0,3:31
,306,Joel Lassinantti,34,Luleå,Gk,1,0,0,0,0,0,0,0,-,-,0,0,0,0:00
,306,Jesper Dahlroth,6,Luleå,D,1,0,0,0,0,0,0,0,-,-,0,0,0,0:00
,306,Daniel Magnusson,16,MODO,F,1,0,0,0,0,0,0,0,-,-,0,0,0,0:00
,306,Henrik Petré,79,Timrå,D,1,0,0,0,0,0,0,1,-,-,0,0,0,14:47
,306,Robin Wall,28,Färjestad,F,1,0,0,0,0,0,0,0,-,-,0,0,0,3:49
,306,Axel Brage,33,Linköping,Gk,1,0,0,0,0,0,0,0,-,-,0,0,0,0:00
,306,Petter Granberg,8,Skellefteå,D,1,0,0,0,0,0,0,0,-,-,0,0,0,0:00
,306,Rasmus Edström,32,Skellefteå,D,1,0,0,0,0,0,0,0,-,-,0,0,0,0:00
,306,Simon Mitman,19,Djurgården,F,1,0,0,0,0,0,0,0,-,-,0,0,0,0:00
,306,Patrik Bengtsson,6,Linköping,D,1,0,0,0,0,0,0,0,-,-,0,0,0,0:00
,306,Mats Fröshaug,21,Linköping,F,1,0,0,0,0,0,0,0,-,-,0,0,0,0:00
,306,Joel Åkesson,38,Linköping,F,1,0,0,0,0,0,0,0,-,-,0,0,0,0:00
,306,Paul-Allan Bamberg,,Luleå,F,1,0,0,0,2,0,0,0,-,-,0,0,0,1:38
,306,Mattias Granlund,20,Skellefteå,F,1,0,0,0,0,0,0,0,-,-,0,0,0,0:00
,306,Dennis Bäck,77,SSK,D,1,0,0,0,0,0,0,1,-,-,0,0,0,14:48
,306,Alexander Lagerström,23,SSK,F,1,0,0,0,0,0,0,1,-,-,0,2,-2,14:04
,306,Linus Hultström,33,Linköping,D,1,0,0,0,0,0,0,0,-,-,0,0,0,0:00
,330,Tim Harrysson,1,Linköping,Gk,2,0,0,0,0,0,0,0,-,-,0,0,0,0:00
,330,Jonas Gunnarsson,37,HV71,Gk,2,0,0,0,0,0,0,0,-,-,0,0,0,0:00
,330,Ted Brithén,90,Rögle,F,2,0,0,0,0,0,0,1,-,-,0,0,0,9:46
,330,Johan Alm,,Frölunda,D,2,0,0,0,0,0,0,0,-,-,0,0,0,2:26
,330,Sebastian Larsson,40,SSK,F,2,0,0,0,0,0,0,0,-,-,0,0,0,3:14
,330,Agust Carlsson,35,Rögle,D,2,0,0,0,0,0,0,0,-,-,0,0,0,0:00
,330,Jesper Fasth,18,HV71,F,2,0,0,0,0,0,0,0,-,-,0,0,0,0:00
,330,Carl Ackered,36,Djurgården,D,2,0,0,0,0,0,0,0,-,-,0,0,0,0:00
,330,Jonathan Johansson,26,Frölunda,F,2,0,0,0,0,0,0,0,-,-,0,1,-1,3:48
,330,Pär Lindholm,17,Skellefteå,F,2,0,0,0,0,0,0,0,-,-,0,0,0,1:18
,330,Kim Lennhammer,28,Djurgården,D,2,0,0,0,0,0,0,0,-,-,0,0,0,0:00
,330,Christoffer Bengtsberg,,HV71,Gk,2,0,0,0,0,0,0,0,-,-,0,0,0,0:00
,330,Simon Hermansson,8,MODO,D,2,0,0,0,0,0,0,0,-,-,0,0,0,1:49
,330,Rickard Steijer,1,Timrå,Gk,2,0,0,0,0,0,0,0,-,-,0,0,0,0:00
,344,Gustaf Lindvall,30,Skellefteå,Gk,3,0,0,0,0,0,0,0,-,-,0,0,0,0:00
,344,Mark Owuya,30,Djurgården,Gk,3,0,0,0,0,0,0,0,-,-,0,0,0,0:00
,344,Johan Mattsson,33,SSK,Gk,3,0,0,0,0,0,0,0,-,-,0,0,0,0:00
,344,Daniel Mannberg,79,Luleå,F,3,0,0,0,0,0,0,0,-,-,0,1,-1,0:39
,344,Jonas Brodin,25,Färjestad,D,3,0,0,0,2,0,0,2,-,-,1,2,-1,13:55
,344,Viktor Wahlquist,13,Linköping,F,3,0,0,0,0,0,0,2,-,-,0,1,-1,7:31
,344,Charlie Torstensson,35,Frölunda,Gk,3,0,0,0,0,0,0,0,-,-,0,0,0,0:00
,344,Henrik Lundberg,1,Frölunda,Gk,3,0,0,0,0,0,0,0,-,-,0,0,0,0:00
,344,Fredrik Ljudén,23,Färjestad,D,3,0,0,0,2,0,0,3,-,-,4,1,3,12:21
,353,Erik Thorell,20,Färjestad,F,4,0,0,0,0,0,0,3,-,-,0,0,0,6:52
,353,Gustaf Thorell,12,Färjestad,F,4,0,0,0,0,0,0,5,-,-,1,0,1,2:44
,353,Joakim Lundström,15,Timrå,Gk,4,0,0,0,0,0,0,0,-,-,0,0,0,0:00
,353,Erik Andersson,11,Frölunda,F,4,0,0,0,0,0,0,5,-,-,0,2,-2,11:18
,357,Mattias Bäckman,5,Linköping,D,5,0,0,0,2,0,0,0,-,-,0,0,0,1:27
,357,Emanuel Åström,18,Rögle,F,5,0,0,0,0,0,0,1,-,-,0,0,0,2:50
,357,Johan Nielsen,30,Rögle,Gk,5,0,0,0,0,0,0,0,-,-,0,0,0,0:00
,357,Fredrik Alcén,1,Brynäs,Gk,5,0,0,0,0,0,0,0,-,-,0,0,0,0:00
,357,Martin Sandgren,10,Skellefteå,D,5,0,0,0,0,0,0,0,-,-,0,0,0,0:19
,357,Patrik Nevalainen,17,Timrå,D,5,0,0,0,4,0,0,4,-,-,2,5,-3,13:33
,357,Dennis Bozic,29,Linköping,D,5,0,0,0,2,0,0,0,-,-,3,0,3,5:55
,364,Michal Zajkowski,30,MODO,Gk,6,0,0,0,0,0,0,0,-,-,5,9,-4,0:00
,364,Alexander Sahlin,99,Brynäs,Gk,6,0,0,0,0,0,0,0,-,-,0,0,0,0:00
,364,Stefan Söder,91,Djurgården,F,6,0,0,0,0,0,0,0,-,-,0,0,0,0:02
,364,Marcus Ottosson,1,Luleå,Gk,6,0,0,0,0,0,0,0,-,-,0,0,0,0:00
,364,Klas Dahlbeck,6,Linköping,D,6,0,0,0,0,0,0,3,-,-,0,1,-1,4:09
,364,Marcus Dahlbom,56,Färjestad,Gk,6,0,0,0,0,0,0,0,-,-,0,0,0,0:00
,364,Joachim Rohdin,72,Brynäs,F,6,0,0,0,0,0,0,1,-,-,0,0,0,5:14
,364,Christoffer Aniander,14,Linköping,D,6,0,0,0,0,0,0,1,-,-,0,0,0,0:49
,372,Ludvig Driscoll,14,Linköping,F,7,0,0,0,0,0,0,2,-,-,0,1,-1,5:04
,372,Niklas Andersson,24,Djurgården,D,7,0,0,0,0,0,0,0,-,-,0,0,0,0:09
,372,Pontus Hansson,42,Frölunda,Gk,7,0,0,0,0,0,0,0,-,-,0,0,0,0:00
,372,John Norman,37,Djurgården,F,7,0,0,0,0,0,0,1,-,-,0,3,-3,2:39
,372,Joakim Mattsson,2,MODO,F,7,0,0,0,0,0,0,2,-,-,0,1,-1,5:30
,377,Adam Pettersson,12,Skellefteå,F,8,0,0,0,0,0,0,1,-,-,0,1,-1,2:17
,377,Simon Glimhed,2,Rögle,F,8,0,0,0,0,0,0,0,-,-,0,1,-1,2:48
,377,Andreas Gröndahl,19,SSK,F,8,0,0,0,0,0,0,1,-,-,0,1,-1,0:20
,380,Magnus Nygren,32,Färjestad,D,9,0,0,0,4,0,0,5,-,-,0,4,-4,9:24
,381,Jonas Berglund,14,Luleå,F,10,0,0,0,0,0,0,3,-,-,1,1,0,3:37
,381,Marcus Hurtig,25,Luleå,F,10,0,0,0,4,0,0,8,-,-,1,3,-2,7:26
,381,Adam Rundqvist,23,Färjestad,F,10,0,0,0,0,0,0,2,-,-,0,0,0,0:59
,381,Jonas Engström,17,SSK,F,10,0,0,0,0,0,0,9,-,-,2,2,0,6:56
,385,Sebastian Owuya,6,Timrå,D,11,0,0,0,0,0,0,1,-,-,2,1,1,1:31
,385,Gusten Törnqvist,95,Frölunda,Gk,11,0,0,0,0,0,0,0,-,-,2,4,-2,0:00
,385,Andro Michel,40,Färjestad,Gk,11,0,0,0,0,0,0,0,-,-,3,7,-4,0:00
,385,Niclas Burström,3,Skellefteå,D,11,0,0,0,4,0,0,5,-,-,0,4,-4,6:01
,389,Riku Helenius,1,SSK,Gk,12,0,0,0,0,0,0,0,-,-,16,18,-2,0:00
,389,Carl Gustafsson,28,Djurgården,F,12,0,0,0,0,0,0,2,-,-,0,1,-1,2:33
,391,Jesper Williamsson,34,HV71,D,13,0,0,0,6,0,0,11,-,-,0,2,-2,6:16
,392,Sebastian Ottosson,15,Linköping,F,14,0,0,0,0,0,0,1,-,-,1,2,-1,4:13
,393,Anton Grundel,73,Färjestad,D,15,0,0,0,0,0,0,6,-,-,2,3,-1,7:26
,394,Johan Gustafsson,37,Färjestad,Gk,16,0,0,0,0,0,0,0,-,-,4,7,-3,0:00
,395,Mathias Sjöberg,3,Rögle,D,17,0,0,0,4,0,0,6,-,-,3,7,-4,5:17
,396,Sebastian Wännström,22,Brynäs,F,18,0,0,0,2,0,0,8,-,-,0,3,-3,3:07
,397,Sean-Michel Sunnqvist,8,Timrå,D,24,0,0,0,0,0,0,6,-,-,7,5,2,3:57
,398,Sebastian Idoff,62,Frölunda,Gk,31,0,0,0,0,0,0,0,-,-,1,1,0,0:00
,399,Robin Rahm,35,Färjestad,Gk,37,0,0,0,0,0,0,0,-,-,35,32,3,0:00
,400,Björn Bjurling,31,SSK,Gk,40,0,0,0,0,0,0,0,-,-,54,74,-20,0:00
,400,Henrik Karlsson,1,Färjestad,Gk,40,0,0,0,6,0,0,1,-,-,48,52,-4,0:00
,402,Eddie Läck,28,Brynäs,Gk,50,0,0,0,0,0,0,0,-,-,24,28,-4,0:00
,403,Niklas Svedberg,89,MODO,Gk,51,0,0,0,22,0,0,0,-,-,63,53,10,0:00
,403,Jürgen Penker,29,Rögle,Gk,51,0,0,0,14,0,0,0,-,-,34,50,-16,0:00
,405,Stefan Ridderwall,39,Djurgården,Gk,52,0,0,0,2,0,0,0,-,-,49,37,12,0:00
,406,Christian Engstrand,1,Linköping,Gk,53,0,0,0,0,0,0,0,-,-,30,15,15,0:00
,406,Roman Malek,45,MODO,Gk,53,0,0,0,0,0,0,0,-,-,43,32,11,0:00
,408,Magnus Åkerlund,1,Timrå,Gk,54,0,0,0,0,0,0,0,-,-,24,28,-4,0:00
,409,Andreas Hadelöv,1,Skellefteå,Gk,55,0,0,0,8,0,0,0,-,-,100,90,10,0:00
,409,Mattias Modig,33,Luleå,Gk,55,0,0,0,8,0,0,0,-,-,59,58,1,0:00
,409,Pontus Sjögren,87,SSK,Gk,55,0,0,0,2,0,0,0,-,-,22,26,-4,0:00
,1,Per-Åge Skröder,10,MODO,F,55,30,29,59,78,6,7,211,-,-,58,42,16,20:47
,2,Fredrik Bremberg,73,Djurgården,F,53,17,40,57,26,2,2,97,-,-,36,44,-8,19:10
,3,Linus Omark,67,Luleå,F,53,23,32,55,66,4,5,123,-,-,46,28,18,17:07
,4,Jaroslav Hlinka,71,Linköping,F,54,12,43,55,16,3,2,115,-,-,49,41,8,19:32
,5,Niklas Sundström,24,MODO,F,49,18,35,53,70,2,2,60,-,-,55,33,22,20:20
,6,Johan Davidsson,76,HV71,F,55,13,37,50,24,2,9,108,-,-,32,30,2,21:44
,7,Johan Harju,24,Luleå,F,55,27,22,49,30,6,10,180,-,-,45,33,12,17:34
,8,Jan Hlavac,27,Linköping,F,54,25,23,48,28,5,9,158,-,-,42,36,6,19:07
,9,Jukka Voutilainen,39,HV71,F,52,17,30,47,63,4,7,174,-,-,28,19,9,20:09
,10,Rickard Wallin,51,Färjestad,F,55,18,27,45,56,1,9,143,-,-,37,31,6,19:49
,11,Niko Dimitrakos,13,Skellefteå,F,54,22,22,44,59,2,5,162,-,-,42,36,6,17:10
,12,Mika Pyörälä,27,Timrå,F,55,21,22,43,10,3,6,120,-,-,41,31,10,20:14
,13,Niklas Anger,17,Djurgården,F,51,23,19,42,16,3,11,141,-,-,36,30,6,18:57
,14,Niklas Persson,23,Linköping,F,55,21,21,42,38,4,5,111,-,-,36,34,2,18:30
,15,Brad Moran,20,Skellefteå,F,55,11,31,42,28,0,0,104,-,-,37,37,0,17:35
,16,Tom Wandell,14,Timrå,F,51,15,26,41,26,1,6,134,-,-,36,20,16,20:33
,17,Andreas Dackell,12,Brynäs,F,55,13,27,40,44,4,4,76,-,-,33,30,3,20:52
,18,Mats Zuccarello Aasen,36,MODO,F,35,12,28,40,38,2,2,90,-,-,37,27,10,17:47
,19,Cam Abbott,24,Rögle,F,42,18,21,39,76,5,2,131,-,-,43,29,14,17:23
,20,Björn Melin,9,HV71,F,53,8,31,39,42,0,3,124,-,-,30,15,15,15:47
,21,Martin Thörnberg,10,HV71,F,51,27,11,38,88,5,12,171,-,-,25,18,7,18:50
,22,Chris Abbott,29,Rögle,F,50,18,20,38,46,2,2,88,-,-,41,32,9,16:34
,23,Jesper Mattsson,26,Färjestad,F,45,17,21,38,36,4,5,110,-,-,27,25,2,16:53
,24,Joakim Eriksson,10,Linköping,F,55,6,32,38,14,0,3,76,-,-,33,29,4,19:35
,25,Daniel Widing,41,Brynäs,F,54,23,14,37,97,5,8,166,-,-,29,36,-7,17:05
,26,Niklas Andersson,24,Frölunda,F,52,16,21,37,22,4,4,155,-,-,34,26,8,18:06
,27,Marcus Ragnarsson,10,Djurgården,D,49,12,25,37,38,2,8,129,-,-,37,50,-13,2:14
,28,Anders Söderberg,26,Skellefteå,F,54,11,26,37,12,2,7,110,-,-,24,29,-5,17:21
,29,Fredrik Hynning,12,Timrå,F,47,15,21,36,24,1,2,93,-,-,24,27,-3,17:15
,30,Eero Somervuori,8,Färjestad,F,55,15,21,36,16,3,5,134,-,-,32,30,2,15:00
,31,Mikael Håkanson,51,Linköping,F,53,10,25,35,26,3,6,95,-,-,32,27,5,15:31
,32,Tomi Kallio,71,Frölunda,F,55,19,15,34,95,4,3,186,-,-,36,32,4,19:12
,33,Kris Beech,24,HV71,F,45,17,17,34,106,2,5,101,-,-,29,19,10,18:31
,34,Patrik Zackrisson,26,Linköping,F,54,15,19,34,12,3,0,121,-,-,33,27,6,15:04
,35,Mikael Johansson,85,Färjestad,F,49,6,28,34,20,1,2,104,-,-,28,31,-3,16:41
,36,Jakob Johansson,26,Rögle,F,53,9,24,33,55,2,6,90,-,-,21,47,-26,19:19
,37,Anders Bastiansen,20,Färjestad,F,54,10,22,32,16,0,1,81,-,-,40,20,20,18:17
,38,Lee Goren,37,Färjestad,F,37,18,13,31,129,3,3,125,-,-,31,19,12,19:53
,39,Dragan Umicevic,84,SSK,F,53,12,19,31,41,3,5,147,-,-,22,40,-18,16:03
,40,Riku Hahl,33,Frölunda,F,52,7,24,31,22,1,5,86,-,-,29,28,1,20:00
,41,Pasi Puistola,21,HV71,D,54,6,25,31,52,2,5,97,-,-,30,29,1,22:12
,42,Mikko Lehtonen,26,Timrå,D,41,15,15,30,58,5,12,119,-,-,38,23,15,23:29
,43,Andreas Salomonsson,15,MODO,F,44,13,17,30,44,2,1,86,-,-,29,33,-4,18:00
,44,Gabriel Karlsson,49,Skellefteå,F,53,13,17,30,16,2,3,96,-,-,38,24,14,16:49
,45,Dick Axelsson,31,/,F,39,11,19,30,42,4,5,84,-,-,27,24,3,13:44
,46,Per Svartvadet,39,MODO,F,55,11,19,30,51,1,3,67,-,-,29,33,-4,17:47
,47,Kenny Jönsson,19,Rögle,D,47,6,24,30,26,2,6,92,-,-,33,31,2,22:28
,48,Linus Klasen,86,SSK,F,53,14,15,29,8,1,5,122,-,-,20,25,-5,14:42
,48,Christian Söderström,82,Skellefteå,F,53,14,15,29,14,4,2,104,-,-,39,22,17,15:42
,50,Teemu Laine,92,HV71,F,55,14,15,29,90,4,6,145,-,-,33,20,13,17:10
,51,Lars Eller,61,Frölunda,F,48,12,17,29,28,1,3,66,-,-,28,13,15,10:58
,52,Teemu Aalto,38,Linköping,F,47,11,18,29,36,0,7,132,-,-,30,25,5,19:42
,53,Jaroslav Obsut,43,Luleå,D,54,8,21,29,48,3,3,157,-,-,46,39,7,0:47
,54,Mats Lavander,62,Luleå,F,53,16,12,28,34,4,8,104,-,-,40,30,10,17:53
,55,Andrée Brendheden,65,Rögle,F,55,15,13,28,80,0,8,98,-,-,22,43,-21,16:02
,56,Peter Högardh,12,Rögle,F,55,14,14,28,12,3,5,93,-,-,26,44,-18,16:34
,57,Mathias Månsson,41,Skellefteå,F,54,10,18,28,77,1,2,87,-,-,29,30,-1,16:15
,58,David Petrasek,22,HV71,D,52,6,22,28,91,0,5,121,-,-,33,31,2,23:30
,59,Kristofer Ottosson,9,Djurgården,F,47,16,11,27,12,3,4,117,-,-,29,22,7,19:47
,60,Per Gustafsson,7,HV71,D,49,9,18,27,42,1,7,89,-,-,29,36,-7,19:16
,61,Stephen Dixon,14,Brynäs,F,53,8,19,27,32,0,1,73,-,-,32,39,-7,18:17
,62,Jonathan Granström,31,Brynäs,F,55,10,16,26,112,1,6,65,-,-,17,22,-5,17:02
,63,Fredrik Pettersson,10,Frölunda,F,53,8,18,26,67,2,1,94,-,-,22,24,-2,14:59
,64,Martin Chabada,12,Luleå,F,50,6,20,26,98,1,1,99,-,-,27,20,7,17:06
,65,Kent McDonell,3,Skellefteå,F,55,14,11,25,58,4,9,162,-,-,15,28,-13,14:50
,66,Petri Pakaslahti,20,SSK,F,53,11,14,25,36,2,4,95,-,-,24,25,-1,20:40
,67,Mattias Timander,3,MODO,D,55,10,15,25,70,1,4,131,-,-,65,46,19,0:23
,68,Magnus Kahnberg,11,Frölunda,F,55,9,16,25,16,5,3,139,-,-,18,28,-10,14:24
,69,Ove Molin,21,Brynäs,F,54,8,17,25,22,1,1,83,-,-,24,24,0,17:12
,70,Tomas Kollar,29,SSK,F,55,6,19,25,18,0,2,74,-,-,24,26,-2,15:07
,71,Kristofer Berglund,2,Luleå,D,52,3,22,25,36,0,0,79,-,-,44,37,7,22:15
,72,Nichlas Falk,16,Djurgården,F,53,2,23,25,20,0,1,48,-,-,29,27,2,20:42
,73,Patrick Yetman,24,MODO,F,36,10,14,24,10,0,3,68,-,-,23,26,-3,15:40
,74,Kimmo Koskenkorva,9,Skellefteå,F,55,10,14,24,20,3,0,92,-,-,32,22,10,13:33
,75,Timo Pärssinen,27,Timrå,F,31,6,18,24,38,3,2,39,-,-,26,16,10,13:53
,76,Eric Moe,9,Timrå,D,42,5,19,24,20,2,0,61,-,-,27,16,11,18:19
,77,Eric Beaudoin,28,Linköping,F,53,16,7,23,53,2,7,84,-,-,20,18,2,13:41
,78,Petr Tenkrat,62,Timrå,F,44,14,9,23,34,1,3,109,-,-,25,23,2,16:42
,79,Lubos Bartecko,23,Luleå,F,44,12,11,23,22,2,2,87,-,-,22,22,0,16:44
,80,Martin Cibak,8,SSK,F,49,10,13,23,94,3,2,68,-,-,21,28,-7,16:24
,81,Tommi Miettinen,9,Luleå,F,37,6,17,23,36,0,3,35,-,-,17,25,-8,15:43
,82,Daniel Sondell,50,Rögle,D,54,2,21,23,26,0,0,103,-,-,51,57,-6,23:25
,83,Mads Hansen,24,Brynäs,F,52,14,8,22,38,2,3,108,-,-,27,30,-3,18:57
,84,Mikael Gath,14,Rögle,F,53,11,11,22,66,1,5,87,-,-,21,32,-11,11:00
,85,Björn Svensson,26,Timrå,F,45,8,14,22,20,1,2,63,-,-,20,19,1,14:30
,86,Erik Forssell,20,Skellefteå,F,55,7,15,22,18,2,1,88,-,-,25,22,3,16:12
,87,Mathias Tjärnqvist,71,Rögle,F,40,11,10,21,16,1,4,106,-,-,24,31,-7,21:13
,88,Lars Jonsson,20,Brynäs,D,52,9,12,21,26,4,7,142,-,-,29,35,-6,1:11
,89,Erik Andersson,2,Skellefteå,D,52,8,13,21,22,0,4,72,-,-,32,28,4,18:10
,90,Victor Hedman,41,MODO,D,43,7,14,21,52,4,2,105,-,-,52,30,22,21:16
,91,Nicklas Danielsson,74,Djurgården,F,50,7,14,21,69,0,3,96,-,-,20,27,-7,14:20
,92,Robert Carlsson,14,SSK,F,53,7,14,21,34,1,0,74,-,-,27,38,-11,16:19
,93,Dominik Granak,51,Färjestad,D,53,5,16,21,40,3,1,76,-,-,37,34,3,19:24
,94,Mikko Luoma,5,HV71,D,54,5,16,21,58,1,1,143,-,-,33,31,2,23:51
,95,Linus Videll,55,SSK,F,54,9,11,20,8,0,1,92,-,-,23,24,-1,14:35
,96,Jörgen Jönsson,21,Färjestad,F,42,8,12,20,32,1,2,78,-,-,25,20,5,16:16
,97,André Benoit,3,SSK,D,54,4,16,20,34,0,2,117,-,-,25,42,-17,21:42
,98,Daniel Glimmenvall,6,Rögle,D,53,3,17,20,36,0,2,71,-,-,41,45,-4,22:06
,98,Tuukka Mäntylä,4,Frölunda,D,53,3,17,20,52,0,1,67,-,-,26,26,0,19:48
,100,Janne Niskala,22,Frölunda,D,35,9,10,19,20,2,5,88,-,-,31,26,5,22:17
,101,Michael Holmqvist,18,Djurgården,F,53,9,10,19,78,1,3,104,-,-,21,39,-18,17:03
,102,Jimmie Ericsson,21,Skellefteå,F,46,7,12,19,38,0,0,56,-,-,22,18,4,13:34
,103,Jyri Marttinen,58,Skellefteå,D,38,6,13,19,107,1,2,66,-,-,33,24,9,23:46
,104,Andreas Holmqvist,7,/,D,42,6,13,19,40,1,3,74,-,-,19,30,-11,17:44
,105,Tim Eriksson,26,Djurgården,F,54,4,15,19,22,1,1,76,-,-,17,29,-12,11:55
,106,Andreas Falk,19,HV71,F,55,10,8,18,90,2,0,62,-,-,25,31,-6,17:00
,107,David Schneider,4,Djurgården,D,41,7,11,18,42,2,2,104,-,-,27,29,-2,22:07
,108,Sebastian Lauritzen,16,/,F,48,5,13,18,20,2,0,56,-,-,23,15,8,10:57
,109,Pontus Petterström,18,Linköping,F,55,4,14,18,30,0,0,63,-,-,30,25,5,13:57
,110,Juuso Hietanen,11,Brynäs,D,54,3,15,18,44,1,0,98,-,-,36,35,1,23:29
,111,Stefan Bemström,22,SSK,D,55,2,16,18,22,1,1,83,-,-,33,33,0,20:31
,112,Hannes Hyvönen,23,SSK,F,24,10,7,17,10,0,3,81,-,-,16,15,1,18:40
,113,Magnus Pääjärvi-Svensson,91,Timrå,F,50,7,10,17,4,1,1,103,-,-,21,27,-6,11:13
,114,Emil Sandin,13,Brynäs,F,53,6,11,17,6,0,3,52,-,-,12,19,-7,11:18
,115,Fredrik Warg,29,MODO,F,39,5,12,17,10,1,3,81,-,-,12,30,-18,16:17
,116,Johan Andersson,17,Timrå,F,55,5,12,17,91,1,1,90,-,-,20,29,-9,17:35
,117,Philip Larsen,3,Frölunda,D,53,2,15,17,18,1,2,78,-,-,33,25,8,15:10
,118,Andreas Engqvist,21,Djurgården,F,31,9,7,16,12,1,3,60,-,-,16,14,2,18:06
,119,Jonas Holös,6,Färjestad,D,55,8,8,16,12,1,1,89,-,-,42,35,7,20:52
,120,Thomas Rhodin,25,Färjestad,D,38,7,9,16,18,2,4,99,-,-,24,20,4,20:36
,121,Carl Gunnarsson,6,Linköping,D,53,6,10,16,26,0,3,83,-,-,37,29,8,19:14
,121,Jonas Almtorp,16,Luleå,F,53,6,10,16,38,1,1,82,-,-,19,17,2,16:12
,123,Jacob Josefson,40,Djurgården,F,50,5,11,16,14,2,0,52,-,-,19,22,-3,9:48
,124,Jan Sandström,7,Luleå,D,53,5,11,16,34,1,5,94,-,-,24,28,-4,23:34
,125,Fredrik Emvall,33,Linköping,F,54,5,11,16,40,2,0,76,-,-,33,26,7,16:20
,126,Arto Laatikainen,42,Färjestad,D,39,2,14,16,18,1,0,87,-,-,29,19,10,20:09
,127,Jeff Ulmer,22,MODO,F,27,8,7,15,45,0,4,85,-,-,13,16,-3,16:32
,128,Per Åslund,22,Färjestad,F,50,8,7,15,8,3,2,64,-,-,13,10,3,11:23
,129,Anton Axelsson,6,Timrå,F,52,6,9,15,0,1,1,58,-,-,13,15,-2,12:10
,130,Håkan Bogg,33,Timrå,F,29,4,11,15,20,0,2,30,-,-,14,9,5,13:20
,131,Pavel Skrbek,11,Skellefteå,D,50,4,11,15,64,2,1,49,-,-,39,33,6,23:31
,132,Mathias Porseland,8,Rögle,D,53,4,11,15,26,0,1,84,-,-,25,30,-5,19:01
,133,Emil Kåberg,27,Färjestad,F,55,4,11,15,109,0,0,88,-,-,27,14,13,14:42
,134,Kimmo Lotvonen,29,Timrå,D,46,3,12,15,44,0,1,59,-,-,29,23,6,19:48
,135,Oscar Steen,45,MODO,F,50,3,12,15,40,0,1,57,-,-,16,29,-13,15:26
,136,Ronnie Sundin,23,Frölunda,D,54,3,12,15,34,0,1,69,-,-,27,26,1,18:55
,137,Stefan Pettersson,77,SSK,F,37,8,6,14,30,1,1,96,-,-,16,9,7,14:13
,138,Daniel Hermansson,22,Brynäs,F,51,7,7,14,6,0,1,77,-,-,16,24,-8,13:05
,139,Robin Lindqvist,22,Luleå,F,54,7,7,14,57,2,1,42,-,-,17,11,6,10:55
,140,Anders Burström,21,Luleå,F,54,3,11,14,26,0,0,54,-,-,19,21,-2,15:12
,141,Mikael Johansson,21,Frölunda,F,55,3,11,14,22,1,1,65,-,-,18,27,-9,15:05
,142,Martin Sevc,55,Färjestad,D,52,1,13,14,125,0,0,110,-,-,46,22,24,21:36
,143,Jonas Nordquist,39,Frölunda,F,37,8,5,13,6,3,4,78,-,-,16,17,-1,16:55
,144,Mattias Carlsson,15,Linköping,F,47,8,5,13,6,0,0,54,-,-,17,11,6,8:36
,145,Peter Nordström,19,Färjestad,F,27,6,7,13,14,0,3,43,-,-,15,6,9,16:11
,146,Mattias Sjögren,11,Rögle,F,43,6,7,13,16,1,0,65,-,-,19,26,-7,15:39
,147,Daniel Fernholm,24,Linköping,D,40,5,8,13,22,0,2,103,-,-,34,27,7,21:22
,148,Andreas Pihl,2,Linköping,D,49,5,8,13,108,0,0,75,-,-,41,27,14,18:12
,149,Peter Nolander,70,Brynäs,D,53,5,8,13,32,0,3,35,-,-,29,26,3,17:46
,150,Daniel Grillfors,32,HV71,D,45,4,9,13,16,1,0,44,-,-,29,17,12,17:31
,151,Stefan Gråhns,41,SSK,F,52,2,11,13,12,0,0,35,-,-,14,15,-1,6:56
,152,Joakim Andersson,18,Frölunda,F,49,6,6,12,22,1,1,43,-,-,15,12,3,10:30
,153,John Pohl,67,Frölunda,F,12,5,7,12,6,2,1,21,-,-,13,3,10,18:54
,154,Richard Demén-Willaume,18,Rögle,D,24,5,7,12,32,1,0,36,-,-,13,18,-5,12:53
,155,Yared Hagos,91,/ SSK,F,53,5,7,12,142,0,2,49,-,-,13,24,-11,11:26
,156,Sebastian Karlsson,12,Rögle,F,55,5,7,12,34,1,0,70,-,-,27,20,7,15:35
,157,Nicholas Angell,18,HV71,D,40,4,8,12,34,1,2,63,-,-,20,25,-5,17:20
,158,Kristian Kudroc,4,SSK,D,52,4,8,12,103,0,2,111,-,-,26,39,-13,19:26
,159,Ari Vallin,11,Färjestad,D,39,3,9,12,30,1,1,37,-,-,21,19,2,17:14
,160,Pär Styf,36,Timrå,D,26,6,5,11,36,1,3,41,-,-,17,19,-2,19:30
,161,Johan Lindström,79,HV71,F,46,6,5,11,37,0,0,60,-,-,16,22,-6,11:07
,162,Tomas Surovy,43,Linköping,F,33,5,6,11,12,2,0,62,-,-,12,19,-7,12:31
,163,Oscar Hedman,41,Frölunda,D,55,5,6,11,26,0,0,57,-,-,29,26,3,18:55
,164,Timmy Pettersson,33,Djurgården,D,39,4,7,11,38,1,2,78,-,-,27,18,9,19:00
,165,Radek Philipp,52,Luleå,D,54,4,7,11,50,1,4,58,-,-,36,29,7,21:35
,166,Jason Morgan,17,SSK,F,49,3,8,11,66,2,1,50,-,-,14,28,-14,14:07
,167,Tommy Wargh,86,MODO,D,37,2,9,11,8,0,1,65,-,-,17,21,-4,16:06
,168,Martin Sonnenberg,25,Timrå,F,13,1,10,11,10,0,1,32,-,-,9,4,5,17:38
,169,Topi Jaakola,18,SSK,D,51,0,11,11,22,0,0,76,-,-,25,40,-15,21:41
,170,Emil Lundberg,51,Luleå,F,55,6,4,10,34,0,0,57,-,-,19,13,6,13:41
,171,Christian Eklund,20,Djurgården,F,39,5,5,10,30,0,1,54,-,-,14,20,-6,15:07
,172,Erik Karlsson,65,Frölunda,D,45,5,5,10,10,1,2,59,-,-,12,10,2,10:15
,172,Marcus Johansson,90,Färjestad,F,45,5,5,10,10,1,0,49,-,-,18,14,4,9:53
,174,David Printz,55,Djurgården,D,52,5,5,10,52,1,1,43,-,-,31,32,-1,18:34
,175,Per Hallin,8,SSK,F,53,5,5,10,54,1,1,82,-,-,15,23,-8,11:49
,176,Anton Lander,51,Timrå,F,47,4,6,10,12,0,1,31,-,-,13,15,-2,7:39
,177,Andreas Jämtin,18,Linköping,F,27,3,7,10,86,0,2,32,-,-,11,11,0,10:22
,178,Toni Söderholm,26,Frölunda,D,36,3,7,10,53,0,3,38,-,-,11,13,-2,13:23
,179,Johan Fransson,10,Linköping,D,40,3,7,10,24,1,1,61,-,-,20,21,-1,14:22
,180,Mario Kempe,70,Rögle,F,30,2,8,10,8,0,0,36,-,-,12,13,-1,9:37
,181,Jimmie Ölvestad,19,Djurgården,F,41,1,9,10,101,0,0,66,-,-,11,15,-4,14:43
,182,David Rundblad,7,Skellefteå,D,45,0,10,10,8,0,0,53,-,-,24,21,3,13:37
,183,Johannes Salmonsson,25,Rögle,F,33,5,4,9,12,0,1,38,-,-,9,19,-10,13:41
,184,Jörgen Bemström,24,SSK,F,36,5,4,9,20,0,2,62,-,-,11,23,-12,16:32
,185,Viktor Lindgren,10,Luleå,F,51,5,4,9,12,0,1,52,-,-,15,14,1,12:08
,186,Thomas Enström,11,MODO,F,53,5,4,9,4,2,0,68,-,-,13,20,-7,9:38
,187,Alexander Sundström,,Brynäs,F,36,4,5,9,12,1,1,29,-,-,9,12,-3,11:57
,188,Oscar Sundh,13,Timrå,F,52,4,5,9,46,2,1,93,-,-,11,21,-10,15:40
,189,Robin Figren,23,Djurgården,F,49,3,6,9,28,1,1,66,-,-,11,24,-13,11:49
,190,Ivan Majesky,26,Linköping,D,40,1,8,9,54,0,0,52,-,-,26,28,-2,19:21
,191,Mads Bödker,7,Rögle,D,55,1,8,9,32,0,0,43,-,-,24,36,-12,15:14
,192,Karl Fabricius,52,Frölunda,F,48,5,3,8,30,0,1,70,-,-,13,19,-6,13:22
,193,Mikael Lidhammar,20,Luleå,F,50,5,3,8,39,1,0,35,-,-,15,10,5,8:04
,194,Carl Gustafsson,28,Djurgården,F,41,4,4,8,10,0,0,45,-,-,12,14,-2,8:39
,195,Pierre Hedin,21,MODO,D,53,4,4,8,62,1,1,65,-,-,20,28,-8,18:09
,196,Jörgen Sundqvist,22,Brynäs,D,54,4,4,8,74,3,1,54,-,-,28,35,-7,20:40
,196,Pekka Saravo,14,Linköping,D,54,4,4,8,50,1,0,49,-,-,28,31,-3,17:20
,198,Andreas Karlsson,28,Frölunda,F,11,3,5,8,6,0,2,23,-,-,6,2,4,18:52
,199,Martin Johansson,25,Färjestad,F,44,3,5,8,10,1,0,37,-,-,12,10,2,8:12
,200,Henrik Eriksson,17,Djurgården,F,47,3,5,8,4,0,0,46,-,-,10,11,-1,5:31
,201,Marius Holtet,12,Färjestad,F,49,3,5,8,26,0,0,65,-,-,10,14,-4,9:51
,202,Tobias Viklund,16,Skellefteå,D,51,3,5,8,22,2,0,77,-,-,31,31,0,21:09
,203,Hans Jonsson,5,MODO,D,26,2,6,8,48,1,1,44,-,-,11,23,-12,18:19
,204,Per Hållberg,18,MODO,D,45,2,6,8,34,0,1,47,-,-,19,25,-6,18:27
,205,Niclas Andersén,9,Brynäs,D,55,0,8,8,60,0,0,35,-,-,27,35,-8,19:29
,206,Patric Blomdahl,84,Frölunda,F,48,5,2,7,116,1,0,49,-,-,18,17,1,12:22
,207,Peter Lorentzen,71,Rögle,F,51,4,3,7,12,0,0,29,-,-,13,16,-3,8:19
,208,Sebastian Erixon,50,Timrå,D,48,3,4,7,14,1,1,55,-,-,24,33,-9,17:26
,209,Tim Erixon,4,Skellefteå,D,45,2,5,7,12,0,0,32,-,-,16,11,5,9:57
,210,Johan Ejdepalm,8,Luleå,D,54,2,5,7,24,0,0,33,-,-,26,14,12,11:03
,210,Andreas Molinder,24,MODO,F,54,2,5,7,12,0,0,39,-,-,13,22,-9,12:14
,212,Tomas Skogs,23,Timrå,D,55,1,6,7,44,0,1,66,-,-,30,44,-14,19:39
,213,Toni Mäkiaho,75,Timrå,F,18,3,3,6,31,0,0,36,-,-,7,12,-5,15:04
,214,Mikael Renberg,19,Skellefteå,F,21,3,3,6,16,0,0,38,-,-,10,12,-2,13:22
,215,Simon Önerud,11,HV71,F,51,3,3,6,24,0,1,49,-,-,9,13,-4,8:16
,216,Christopher Liljewall,52,Rögle,F,35,2,4,6,6,0,0,14,-,-,9,7,2,5:34
,217,Jonas Johansson,61,HV71,F,50,2,4,6,18,0,1,58,-,-,9,13,-4,7:40
,218,Kim Staal,28,HV71,F,8,1,5,6,0,0,0,10,-,-,5,5,0,9:32
,219,Martin Strbak,77,Rögle,D,24,1,5,6,24,0,1,40,-,-,18,25,-7,21:04
,220,Dennis Persson,29,Timrå,D,46,1,5,6,24,1,1,28,-,-,10,18,-8,12:09
,221,Joe DiPenta,6,Frölunda,D,47,1,5,6,71,0,1,32,-,-,26,20,6,18:21
,222,Janos Vas,19,Brynäs,F,52,1,5,6,10,0,0,48,-,-,12,14,-2,8:09
,223,Robin Jonsson,39,Timrå,D,51,0,6,6,60,0,0,72,-,-,17,24,-7,18:26
,224,Nate DiCasmirro,14,Timrå,F,10,3,2,5,4,0,1,12,-,-,6,4,2,10:15
,225,David Fredriksson,54,HV71,F,34,3,2,5,53,0,0,25,-,-,12,16,-4,9:08
,226,Stefan Erkgärds,4,Rögle,D,39,3,2,5,12,0,0,21,-,-,21,29,-8,13:21
,227,Ville Snellman,81,MODO,F,49,3,2,5,18,0,1,54,-,-,7,13,-6,7:27
,228,Mikael Lind,36,Brynäs,F,18,2,3,5,10,0,0,37,-,-,8,7,1,17:39
,229,Jens Skåhlberg,40,Färjestad,D,39,2,3,5,20,0,0,33,-,-,13,7,6,9:07
,230,Tommy Enström,63,Rögle,F,48,2,3,5,16,0,0,28,-,-,8,12,-4,6:48
,231,Johan Andersson,32,Frölunda,F,51,1,4,5,37,0,0,27,-,-,10,3,7,5:09
,232,Jonas Johnson,30,Frölunda,F,14,0,5,5,0,0,0,6,-,-,6,9,-3,10:46
,233,Pierre Johnsson,2,Luleå,D,37,0,5,5,60,0,0,19,-,-,23,18,5,16:40
,234,Marcus Paulsson,53,Färjestad,F,8,3,1,4,6,2,0,26,-,-,6,6,0,14:22
,235,Nicklas Lasu,31,Frölunda,F,14,3,1,4,4,1,0,14,-,-,6,3,3,12:09
,236,Jakob Silfverberg,33,Brynäs,F,16,3,1,4,2,1,1,23,-,-,2,3,-1,7:26
,237,Daniel Olofsson,17,Luleå,F,20,3,1,4,8,0,0,8,-,-,4,4,0,7:38
,238,Mattias Tedenby,21,HV71,F,32,3,1,4,6,0,0,47,-,-,11,16,-5,10:03
,239,Jonas Höglund,28,SSK,F,7,2,2,4,2,2,1,22,-,-,1,3,-2,15:52
,240,Marcus Krüger,32,Djurgården,F,15,2,2,4,2,0,0,20,-,-,7,5,2,9:06
,241,Magnus Wernblom,9,MODO,F,17,2,2,4,30,0,1,23,-,-,4,4,0,12:04
,242,Atvars Tribuncovs,32,Skellefteå,D,9,1,3,4,12,0,0,11,-,-,9,7,2,18:08
,243,David Ullström,29,HV71,F,19,1,3,4,6,0,0,10,-,-,4,7,-3,4:59
,244,Marco Tuokko,13,MODO,F,35,1,3,4,61,0,0,41,-,-,4,13,-9,10:58
,245,Thomas Larsson,24,Skellefteå,F,38,0,4,4,37,0,0,16,-,-,4,6,-2,5:48
,246,Carl Klingberg,97,Frölunda,F,10,2,1,3,0,0,0,8,-,-,3,2,1,6:44
,247,Kyle Wanvig,8,Brynäs,F,18,2,1,3,53,0,0,19,-,-,7,7,0,12:30
,248,Jesper Samuelsson,10,Timrå,F,40,2,1,3,10,1,1,19,-,-,5,9,-4,5:14
,249,Peter Forsberg,21,MODO,F,3,1,2,3,0,0,0,5,-,-,4,0,4,10:51
,250,Kamil Piros,26,HV71,F,8,1,2,3,12,1,0,11,-,-,2,1,1,10:40
,251,Pavel Rosa,59,Rögle,F,10,1,2,3,0,0,0,20,-,-,5,12,-7,15:45
,252,Mikael Ahlén,13,Djurgården,F,25,1,2,3,29,1,0,18,-,-,4,4,0,5:26
,253,Fredrik Krekula,10,Skellefteå,F,36,1,2,3,28,0,0,39,-,-,8,10,-2,11:55
,254,Tobias Forsberg,19,MODO,F,38,1,2,3,10,0,0,34,-,-,5,10,-5,7:54
,255,Daniel Josefsson,12,SSK,D,26,0,3,3,10,0,0,11,-,-,9,6,3,13:29
,256,Ronnie Pettersson,6,Djurgården,D,45,0,3,3,34,0,0,31,-,-,21,25,-4,14:29
,257,Daniel Ljungkvist,16,SSK,D,46,0,3,3,18,0,0,24,-,-,20,15,5,11:31
,258,Johan Motin,57,Färjestad,D,52,0,3,3,28,0,0,28,-,-,20,17,3,11:19
,259,Dieter Kalt,74,Luleå,F,7,2,0,2,4,0,0,16,-,-,3,3,0,14:07
,260,Christofer Löfberg,44,Rögle,F,15,2,0,2,6,0,0,12,-,-,5,2,3,3:59
,261,Mathias Sjöberg,3,Rögle,D,31,2,0,2,14,0,0,16,-,-,7,11,-4,7:22
,262,Martin Richter,5,SSK,D,38,2,0,2,36,0,1,17,-,-,8,18,-10,11:02
,263,Martin Lundberg,27,Skellefteå,F,47,1,1,2,12,0,0,24,-,-,5,10,-5,6:40
,264,Jens Westin,3,MODO,D,48,1,1,2,16,1,0,26,-,-,10,26,-16,9:41
,265,Johan Alcén,14,Brynäs,F,50,1,1,2,20,0,0,30,-,-,2,14,-12,7:36
,266,Martin Laumann Ylven,35,Linköping,F,55,1,1,2,38,1,0,40,-,-,5,12,-7,6:16
,267,Johan Björk,55,HV71,D,7,0,2,2,0,0,0,11,-,-,5,3,2,15:16
,268,Jonathan Hedström,71,Timrå,F,11,0,2,2,8,0,0,21,-,-,3,8,-5,16:49
,269,Cristopher Nihlstorp,41,Rögle,Gk,23,0,2,2,0,0,0,0,-,-,33,33,0,0:00
,270,Niklas Andersson,24,Djurgården,D,33,0,2,2,12,0,0,18,-,-,5,13,-8,8:19
,271,Mats Fröshaug,21,/,F,34,0,2,2,0,0,0,10,-,-,4,5,-1,4:00
,272,Robin Olsson,5,Luleå,D,39,0,2,2,8,0,0,16,-,-,7,8,-1,8:38
,273,Jürgen Penker,29,Rögle,Gk,41,0,2,2,0,0,0,0,-,-,46,64,-18,0:00
,274,Ola Svanberg,4,Brynäs,D,43,0,2,2,18,0,0,8,-,-,10,11,-1,5:56
,275,Nichlas Torp,38,HV71,D,44,0,2,2,43,0,0,25,-,-,11,12,-1,9:07
,276,Jacob Markström,25,Brynäs,Gk,48,0,2,2,2,0,0,0,-,-,49,48,1,0:00
,277,Mikko Kurvinen,4,MODO,D,49,0,2,2,22,0,0,42,-,-,25,27,-2,17:14
,278,Jonas Gustavsson,50,Färjestad,Gk,50,0,2,2,2,0,0,0,-,-,91,56,35,0:00
,279,Jens Olsson,28,SSK,D,53,0,2,2,32,0,0,54,-,-,16,26,-10,14:39
,280,Mattias Lindström,17,Skellefteå,F,7,1,0,1,0,1,0,4,-,-,2,3,-1,4:47
,281,Fredric Andersson,13,SSK,F,30,1,0,1,0,0,0,7,-,-,1,2,-1,2:03
,282,Gabriel Landeskog,36,Djurgården,F,3,0,1,1,2,0,0,4,-,-,2,0,2,10:41
,283,Josef Hrabal,7,MODO,D,6,0,1,1,2,0,0,4,-,-,2,7,-5,9:29
,284,Oscar Ackeström,25,Frölunda,D,7,0,1,1,2,0,0,0,-,-,1,2,-1,6:37
,285,Niklas Strandberg,8,Skellefteå,D,9,0,1,1,2,0,0,2,-,-,3,3,0,11:11
,285,Tero Konttinen,7,Djurgården,D,9,0,1,1,2,0,0,3,-,-,1,1,0,7:13
,285,Björn Danielsson,23,Brynäs,F,9,0,1,1,10,0,0,9,-,-,5,1,4,12:10
,288,André Petersson,40,HV71,F,10,0,1,1,0,0,0,1,-,-,1,1,0,1:09
,289,Viktor Ekbom,8,Linköping,D,14,0,1,1,6,0,0,12,-,-,6,12,-6,15:04
,290,Dennis Bozic,29,Linköping,D,21,0,1,1,2,0,0,1,-,-,5,5,0,4:32
,290,Simon Bertilsson,15,Brynäs,D,21,0,1,1,2,0,0,1,-,-,3,4,-1,2:38
,292,Fredrik Styrman,2,Luleå,D,25,0,1,1,8,0,0,15,-,-,5,3,2,8:25
,292,Sacha Treille,35,Färjestad,F,25,0,1,1,6,0,0,9,-,-,5,4,1,4:52
,294,Christoffer Norgren,29,Skellefteå,D,33,0,1,1,22,0,0,10,-,-,16,20,-4,17:43
,295,Stefan Ridderwall,39,Djurgården,Gk,38,0,1,1,2,0,0,0,-,-,43,51,-8,0:00
,296,Gustaf Wesslau,32,Djurgården,Gk,53,0,1,1,0,0,0,1,-,-,50,57,-7,0:00
,297,Gusten Törnqvist,95,Luleå,Gk,54,0,1,1,0,0,0,0,-,-,29,33,-4,0:00
,297,Mattias Modig,33,Luleå,Gk,54,0,1,1,24,0,0,0,-,-,73,50,23,0:00
,297,Johan Backlund,26,Timrå,Gk,54,0,1,1,4,0,0,0,-,-,88,83,5,0:00
,300,Jonathan Carlsson,36,Brynäs,D,55,0,1,1,78,0,0,31,-,-,10,15,-5,8:28
,300,Johan Holmqvist,40,Frölunda,Gk,55,0,1,1,2,0,0,1,-,-,82,67,15,0:00
,302,Adam Larsson,5,Skellefteå,D,1,0,0,0,0,0,0,0,-,-,0,0,0,0:00
,302,Johan Halvardsson,27,HV71,D,1,0,0,0,0,0,0,0,-,-,0,0,0,1:52
,302,Marcus Hurtig,25,Skellefteå,F,1,0,0,0,0,0,0,0,-,-,0,0,0,2:01
,302,Andreas Byström,1,MODO,Gk,1,0,0,0,0,0,0,0,-,-,0,0,0,0:00
,302,Andreas Gröndahl,19,SSK,F,1,0,0,0,0,0,0,0,-,-,0,0,0,0:00
,302,Rok Ticar,24,Timrå,F,1,0,0,0,0,0,0,0,-,-,0,0,0,0:00
,302,Niclas Burström,3,Skellefteå,D,1,0,0,0,0,0,0,0,-,-,0,0,0,0:00
,302,Peter Wennerström,13,Färjestad,F,1,0,0,0,0,0,0,0,-,-,0,0,0,3:03
,302,Adam Eriksson,16,MODO,F,1,0,0,0,0,0,0,0,-,-,0,0,0,0:00
,302,Jesper Williamsson,34,HV71,D,1,0,0,0,0,0,0,0,-,-,0,0,0,0:00
,302,Filip Gunnarsson,14,Färjestad,F,1,0,0,0,0,0,0,1,-,-,1,0,1,7:43
,302,Adam Nilsson,28,Timrå,F,1,0,0,0,0,0,0,0,-,-,0,0,0,0:00
,302,Robert Tellberg,29,Färjestad,F,1,0,0,0,0,0,0,3,-,-,0,0,0,8:48
,302,Joakim Molin,10,SSK,F,1,0,0,0,0,0,0,0,-,-,0,0,0,0:00
,302,Joakim Toivonen,34,Timrå,D,1,0,0,0,0,0,0,1,-,-,0,0,0,3:27
,302,Lukas Kihlström,81,SSK,D,1,0,0,0,0,0,0,0,-,-,0,0,0,0:00
,302,Simon Löf,14,Brynäs,D,1,0,0,0,0,0,0,0,-,-,0,0,0,0:00
,302,Daniel Brodin,34,Djurgården,F,1,0,0,0,0,0,0,0,-,-,0,0,0,0:00
,320,Marcus Ottosson,1,Skellefteå,Gk,2,0,0,0,0,0,0,0,-,-,0,0,0,0:00
,320,Anders Nilsson,31,Luleå,Gk,2,0,0,0,0,0,0,0,-,-,0,0,0,0:00
,320,Marcus Karlsson,53,Färjestad,D,2,0,0,0,0,0,0,1,-,-,0,0,0,4:48
,320,Sebastian Harrysson,11,Linköping,F,2,0,0,0,0,0,0,0,-,-,0,0,0,2:37
,320,Casper Carning,,Frölunda,F,2,0,0,0,0,0,0,0,-,-,0,1,-1,1:40
,320,Erik Karlberg,28,Skellefteå,F,2,0,0,0,0,0,0,0,-,-,0,0,0,0:00
,320,Patrick Cehlin,71,Djurgården,F,2,0,0,0,0,0,0,0,-,-,0,0,0,1:12
,320,Ted Brithén,90,Rögle,F,2,0,0,0,0,0,0,0,-,-,0,0,0,0:51
,320,Marcus Kristoffersson,38,Djurgården,F,2,0,0,0,6,0,0,2,-,-,2,1,1,11:30
,320,Christoffer Holmström Coox,28,Timrå,F,2,0,0,0,0,0,0,0,-,-,0,0,0,0:00
,320,Magnus Holm,19,MODO,D,2,0,0,0,0,0,0,0,-,-,0,0,0,0:00
,320,Markus Hedström,17,Skellefteå,D,2,0,0,0,0,0,0,0,-,-,0,0,0,1:11
,332,Christian Engstrand,1,Linköping,Gk,3,0,0,0,0,0,0,0,-,-,0,0,0,0:00
,332,Jan Hrdina,24,HV71,F,3,0,0,0,0,0,0,2,-,-,1,0,1,14:41
,332,Sean-Michel Sunnqvist,8,Timrå,D,3,0,0,0,0,0,0,0,-,-,0,0,0,3:03
,332,Tim Sandberg,31,Djurgården,Gk,3,0,0,0,0,0,0,0,-,-,0,0,0,0:00
,332,Johannes Tornberg,19,Luleå,F,3,0,0,0,0,0,0,2,-,-,0,0,0,6:30
,337,Kim Lennhammer,28,Djurgården,D,4,0,0,0,0,0,0,0,-,-,0,0,0,0:18
,337,Martin Röymark,27,Frölunda,F,4,0,0,0,0,0,0,6,-,-,1,4,-3,14:09
,337,Sebastian Hård Af Segerstad,14,Timrå,F,4,0,0,0,0,0,0,0,-,-,0,0,0,0:00
,337,Petter Söderström,25,Timrå,Gk,4,0,0,0,0,0,0,0,-,-,0,0,0,0:00
,337,Melker Karlsson,15,Skellefteå,F,4,0,0,0,0,0,0,4,-,-,0,0,0,4:41
,342,Andro Michel,40,Färjestad,Gk,5,0,0,0,0,0,0,0,-,-,0,0,0,0:00
,342,Kim Karlsson,,Luleå,F,5,0,0,0,2,0,0,2,-,-,0,1,-1,5:34
,342,Tim Bränholm,87,Frölunda,F,5,0,0,0,0,0,0,2,-,-,0,0,0,0:52
,345,Jonas Berglund,14,Luleå,F,6,0,0,0,0,0,0,0,-,-,0,2,-2,2:18
,345,Peter Hirsch,15,Timrå,Gk,6,0,0,0,0,0,0,0,-,-,0,2,-2,0:00
,345,Alexander Deilert,54,Djurgården,D,6,0,0,0,0,0,0,6,-,-,2,2,0,7:30
,348,Henrik Karlsson,1,SSK,Gk,7,0,0,0,0,0,0,0,-,-,9,12,-3,0:00
,348,Christoffer Bengtsberg,,HV71,Gk,7,0,0,0,0,0,0,0,-,-,2,0,2,0:00
,348,Petri Liimatainen,73,Linköping,D,7,0,0,0,10,0,0,5,-,-,3,1,2,14:00
,351,Robin Persson,11,Linköping,D,8,0,0,0,6,0,0,7,-,-,4,4,0,11:38
,351,Sami Torkki,25,MODO,F,8,0,0,0,0,0,0,9,-,-,1,2,-1,11:23
,351,Jimmy Andersson,84,HV71,F,8,0,0,0,0,0,0,0,-,-,0,0,0,0:00
,351,Martin Pettersson,30,HV71,Gk,8,0,0,0,0,0,0,0,-,-,0,0,0,0:00
,355,Anton Grundel,73,Färjestad,D,9,0,0,0,0,0,0,0,-,-,0,0,0,0:23
,355,Tim Weber,16,MODO,F,9,0,0,0,0,0,0,1,-,-,0,1,-1,1:54
,357,Eric Persson,7,MODO,D,10,0,0,0,0,0,0,1,-,-,1,1,0,2:23
,357,Henrik Björklund,14,Färjestad,F,10,0,0,0,0,0,0,14,-,-,0,1,-1,3:58
,357,Mika Noronen,1,Linköping,Gk,10,0,0,0,0,0,0,0,-,-,8,7,1,0:00
,357,Martin Signal-Bergius,14,MODO,D,10,0,0,0,0,0,0,0,-,-,0,0,0,0:03
,361,Henrik Tömmernes,7,Frölunda,D,11,0,0,0,0,0,0,0,-,-,0,0,0,0:00
,361,Niklas Svedberg,89,MODO,Gk,11,0,0,0,0,0,0,0,-,-,6,14,-8,0:00
,361,Joakim Mattsson,2,MODO,F,11,0,0,0,2,0,0,0,-,-,0,0,0,1:49
,364,Joacim Eriksson,30,Brynäs,Gk,12,0,0,0,0,0,0,0,-,-,0,0,0,0:00
,364,Veli-Pekka Laitinen,33,HV71,F,12,0,0,0,0,0,0,4,-,-,0,3,-3,6:15
,366,Tuomo Karjalainen,15,Timrå,Gk,13,0,0,0,0,0,0,0,-,-,2,1,1,0:00
,366,Mike Morrison,33,MODO,Gk,13,0,0,0,0,0,0,0,-,-,2,7,-5,0:00
,368,Anton Persson,27,Brynäs,F,14,0,0,0,0,0,0,2,-,-,1,2,-1,4:02
,369,Johan Nielsen,30,Rögle,Gk,15,0,0,0,0,0,0,0,-,-,0,0,0,0:00
,369,Stefan Espeland,17,MODO,D,15,0,0,0,2,0,0,5,-,-,2,1,1,3:25
,371,Mark Owuya,30,Djurgården,Gk,16,0,0,0,0,0,0,0,-,-,0,0,0,0:00
,371,Fredrik Lindgren,61,Skellefteå,D,16,0,0,0,2,0,0,18,-,-,12,15,-3,19:28
,373,Gustaf Thorell,12,Färjestad,F,17,0,0,0,0,0,0,8,-,-,0,3,-3,3:31
,373,Erik Andersson,11,Timrå,F,17,0,0,0,8,0,0,6,-,-,2,2,0,5:36
,375,Daniel Despotovic,15,SSK,F,18,0,0,0,0,0,0,4,-,-,0,1,-1,1:59
,376,Fredrik Sonntag,6,SSK,D,19,0,0,0,0,0,0,0,-,-,0,0,0,0:43
,377,Robin Karlsson,33,HV71,D,20,0,0,0,2,0,0,2,-,-,0,1,-1,1:14
,378,Oscar Eklund,16,Djurgården,D,21,0,0,0,8,0,0,14,-,-,5,8,-3,8:58
,379,Henrik Eriksson,37,HV71,F,22,0,0,0,0,0,0,11,-,-,1,4,-3,2:38
,380,Sebastian Ström,2,Rögle,D,23,0,0,0,6,0,0,4,-,-,1,3,-2,3:27
,381,Alexander Urbom,55,Djurgården,D,28,0,0,0,2,0,0,9,-,-,3,8,-5,6:20
,382,Jere Myllyniemi,35,Rögle,Gk,31,0,0,0,0,0,0,0,-,-,27,34,-7,0:00
,382,Karol Krizan,60,MODO,Gk,31,0,0,0,22,0,0,0,-,-,52,48,4,0:00
,382,Johan Burlin,38,Skellefteå,D,31,0,0,0,2,0,0,4,-,-,4,2,2,2:49
,385,Magnus Åkerlund,1,Timrå,Gk,33,0,0,0,0,0,0,0,-,-,10,9,1,0:00
,386,Stefan Liv,1,HV71,Gk,42,0,0,0,0,0,0,0,-,-,51,53,-2,0:00
,387,Jonas Fransson,32,Linköping,Gk,43,0,0,0,2,0,0,0,-,-,20,20,0,0:00
,388,Björn Bjurling,31,SSK,Gk,49,0,0,0,6,0,0,0,-,-,51,73,-22,0:00
,389,Anders Lindbäck,39,Brynäs,Gk,50,0,0,0,2,0,0,0,-,-,36,47,-11,0:00
,390,Andreas Hadelöv,1,Skellefteå,Gk,53,0,0,0,4,0,0,0,-,-,68,55,13,0:00
,390,Andreas Andersson,54,HV71,Gk,53,0,0,0,0,0,0,0,-,-,38,35,3,0:00
,392,Pontus Sjögren,87,SSK,Gk,54,0,0,0,6,0,0,0,-,-,23,22,1,0:00
,392,Michal Zajkowski,30,MODO,Gk,54,0,0,0,2,0,0,0,-,-,50,46,4,0:00
,392,Daniel Henriksson,40,Linköping,Gk,54,0,0,0,12,0,0,0,-,-,88,76,12,0:00
,395,Ari Ahonen,31,Frölunda,Gk,55,0,0,0,0,0,0,0,-,-,17,16,1,0:00
,395,Reinhard Divis,38,Färjestad,Gk,55,0,0,0,2,0,0,0,-,-,24,27,-3,0:00
,395,Nicklas Dahlberg,30,Skellefteå,Gk,55,0,0,0,0,0,0,0,-,-,44,42,2,0:00
,1,Tony Mårtensson,9,Linköping,F,55,17,50,67,36,3,8,159,-,-,44,40,4,21:16
,2,Mattias Weinhandl,80,Linköping,F,54,35,27,62,69,9,12,176,-,-,44,37,7,18:20
,3,Pavel Brendl,28,Brynäs,F,54,31,24,55,110,4,12,211,-,-,32,40,-8,17:36
,4,Niklas Andersson,24,Frölunda,F,48,12,37,49,50,2,5,139,-,-,39,27,12,20:20
,5,Tomi Kallio,71,Frölunda,F,54,27,20,47,54,3,8,217,-,-,38,33,5,17:27
,6,Jukka Voutilainen,39,HV71,F,51,26,20,46,30,5,11,149,-,-,33,12,21,18:00
,7,Anders Söderberg,26,Skellefteå,F,54,21,25,46,12,4,8,119,-,-,30,34,-4,17:57
,8,Fredrik Bremberg,73,Djurgården,F,52,11,34,45,22,1,3,65,-,-,36,28,8,19:32
,9,Andreas Salomonsson,15,MODO,F,48,15,28,43,83,3,6,101,-,-,24,26,-2,18:25
,10,Johan Davidsson,76,HV71,F,47,9,34,43,18,4,3,91,-,-,34,16,18,20:44
,11,Jan Hrdina,24,HV71,F,51,18,24,42,60,3,6,84,-,-,34,27,7,17:12
,12,Riku Hahl,33,Timrå,F,48,10,31,41,22,1,4,73,-,-,31,19,12,21:16
,13,Rickard Wallin,51,Färjestad,F,55,17,23,40,54,4,7,109,-,-,31,26,5,19:00
,14,Mikael Johansson,85,Färjestad,F,53,15,24,39,80,4,3,96,-,-,32,21,11,14:45
,15,Magnus Wernblom,9,MODO,F,54,27,11,38,98,7,19,200,-,-,20,29,-9,16:10
,16,Pelle Prestberg,10,Färjestad,F,54,26,12,38,34,3,12,166,-,-,26,17,9,13:18
,17,Esa Pirnes,10,Färjestad,F,52,15,23,38,74,2,4,110,-,-,34,32,2,18:25
,18,Per-Åge Skröder,10,MODO,F,51,21,16,37,127,5,13,159,-,-,23,20,3,18:18
,19,Martin Thörnberg,10,HV71,F,51,20,17,37,68,4,9,138,-,-,29,14,15,18:23
,20,Mikael Lind,36,Brynäs,F,42,16,21,37,30,2,8,91,-,-,25,34,-9,18:25
,21,Lubos Bartecko,23,Luleå,F,48,16,21,37,79,1,6,122,-,-,33,36,-3,18:51
,22,Magnus Kahnberg,11,Frölunda,F,52,16,21,37,30,2,4,124,-,-,30,22,8,15:09
,23,Fabian Brunnström,54,Färjestad,F,54,9,28,37,16,1,1,91,-,-,30,28,2,12:59
,24,Niklas Sundström,24,MODO,F,45,7,30,37,128,0,2,45,-,-,26,19,7,19:26
,25,Lee Goren,37,Skellefteå,F,47,16,20,36,73,2,5,160,-,-,32,23,9,21:29
,26,Mikko Luoma,5,HV71,D,49,10,25,35,58,2,6,151,-,-,36,29,7,22:05
,27,Daniel Widing,41,Brynäs,F,54,23,11,34,99,6,7,157,-,-,28,37,-9,14:58
,28,Petri Pakaslahti,20,SSK,F,54,18,16,34,48,2,10,98,-,-,35,17,18,20:06
,29,Linus Klasen,86,SSK,F,52,14,20,34,24,4,2,103,-,-,23,18,5,14:28
,30,Per Svartvadet,39,MODO,F,54,8,26,34,34,2,3,62,-,-,28,31,-3,19:05
,31,Mika Pyörälä,27,Timrå,F,46,17,16,33,18,2,3,114,-,-,33,22,11,19:03
,32,Per Ledin,97,HV71,F,52,16,17,33,137,3,7,89,-,-,32,19,13,16:46
,33,Martin Chabada,12,Luleå,F,44,14,19,33,130,2,7,96,-,-,27,28,-1,19:04
,34,Mikael Renberg,19,Skellefteå,F,41,13,20,33,30,3,5,101,-,-,23,26,-3,14:45
,35,Johan Åkerman,4,HV71,D,45,9,24,33,38,2,7,107,-,-,27,26,1,22:06
,36,Kent McDonell,3,Skellefteå,F,49,18,14,32,56,1,5,172,-,-,26,32,-6,16:54
,37,Nicklas Danielsson,74,Djurgården,F,53,14,18,32,60,2,4,109,-,-,32,22,10,14:08
,38,Mikael Håkanson,51,Linköping,F,44,11,21,32,40,2,5,104,-,-,32,23,9,17:49
,39,Pasi Puistola,21,HV71,D,55,11,21,32,99,2,7,87,-,-,36,27,9,22:23
,39,Joakim Eriksson,10,Linköping,F,55,11,21,32,64,3,5,97,-,-,30,28,2,18:37
,39,Linus Omark,67,Luleå,F,55,11,21,32,46,0,3,120,-,-,23,26,-3,14:57
,42,Fredrik Öberg,48,Skellefteå,F,53,10,22,32,90,2,2,108,-,-,33,26,7,18:09
,43,Niklas Persson,23,Linköping,F,54,10,22,32,44,2,1,83,-,-,32,27,5,16:44
,44,Peter Regin,13,Timrå,F,55,12,19,31,36,3,5,130,-,-,22,28,-6,19:58
,45,Niklas Anger,17,Djurgården,F,53,9,22,31,26,2,3,73,-,-,21,22,-1,17:24
,45,Oscar Steen,45,MODO,F,53,9,22,31,63,0,3,65,-,-,25,19,6,16:47
,47,Patric Hörnqvist,10,Djurgården,F,53,18,12,30,60,2,11,174,-,-,25,24,1,17:49
,48,Andreas Jämtin,18,HV71,F,51,17,13,30,167,2,6,94,-,-,27,17,10,13:39
,49,Patrick Yetman,24,MODO,F,35,11,19,30,24,5,6,72,-,-,16,17,-1,16:14
,50,Kristofer Ottosson,9,Djurgården,F,51,11,19,30,34,4,4,108,-,-,27,26,1,20:00
,51,Anders Bastiansen,20,Mora,F,55,7,23,30,58,2,2,90,-,-,32,26,6,19:50
,52,Quinn Hancock,54,SSK,F,46,13,16,29,12,4,8,77,-,-,26,16,10,17:57
,53,Mathias Månsson,41,Brynäs,F,46,8,21,29,79,1,4,66,-,-,25,32,-7,18:42
,54,Daniel Fernholm,24,Linköping,D,54,8,21,29,28,0,3,121,-,-,38,31,7,21:12
,55,Johan Harju,24,Luleå,F,51,20,8,28,55,0,5,124,-,-,30,30,0,16:21
,56,Tomas Surovy,43,Linköping,F,42,15,13,28,14,2,2,117,-,-,25,23,2,14:46
,57,Cory Larose,18,Luleå,F,47,10,18,28,83,4,5,99,-,-,28,35,-7,17:49
,58,Jonas Nordquist,39,Frölunda,F,45,9,19,28,32,1,6,93,-,-,24,22,2,17:01
,59,Tommi Miettinen,9,Luleå,F,46,9,19,28,80,2,2,91,-,-,26,28,-2,19:29
,60,Jesper Mattsson,26,Färjestad,F,46,4,24,28,71,0,1,68,-,-,18,23,-5,17:03
,61,Jonas Johnson,30,Frölunda,F,53,16,11,27,38,3,8,80,-,-,29,20,9,18:07
,62,Timo Pärssinen,27,Timrå,F,34,11,16,27,28,3,6,65,-,-,19,19,0,16:31
,63,Eric Beaudoin,28,Mora,F,52,11,16,27,95,0,3,84,-,-,30,29,1,19:01
,64,Fredrik Warg,29,MODO,F,51,9,18,27,24,2,5,106,-,-,18,26,-8,17:58
,65,Linus Videll,55,SSK,F,53,13,13,26,6,0,4,133,-,-,23,26,-3,19:11
,66,Eero Somervuori,8,Färjestad,F,54,10,16,26,24,4,6,104,-,-,26,32,-6,14:00
,67,Jörgen Jönsson,21,Färjestad,F,42,6,20,26,24,0,4,82,-,-,25,19,6,17:20
,68,Juuso Hietanen,11,Brynäs,D,54,6,20,26,59,0,2,67,-,-,29,38,-9,19:51
,69,Andreas Holmqvist,7,Frölunda,D,49,3,23,26,40,0,1,107,-,-,33,29,4,17:41
,70,Martin Plüss,28,Frölunda,F,50,16,9,25,32,4,4,118,-,-,22,40,-18,17:18
,71,Dick Axelsson,31,Djurgården,F,47,12,13,25,42,2,6,62,-,-,17,22,-5,12:53
,72,Teemu Elomo,49,Mora,F,53,11,14,25,26,1,3,106,-,-,20,33,-13,14:42
,73,Andreas Dackell,12,Brynäs,F,54,7,18,25,40,1,2,86,-,-,23,39,-16,19:26
,74,Karl Fabricius,52,Frölunda,F,55,12,12,24,22,1,2,129,-,-,27,21,6,16:12
,74,Stefan Pettersson,77,/ SSK,F,55,12,12,24,38,0,4,116,-,-,24,23,1,12:11
,76,Toni Dahlman,16,Mora,F,50,8,16,24,14,2,1,72,-,-,19,21,-2,13:23
,77,Ivan Huml,36,Mora,F,48,13,10,23,32,0,5,96,-,-,20,27,-7,14:30
,78,Thomas Rhodin,25,Färjestad,D,55,9,14,23,60,0,6,137,-,-,31,36,-5,21:03
,79,Petr Tenkrat,62,Timrå,F,42,10,12,22,72,1,2,105,-,-,21,30,-9,17:01
,80,Pär Bäcker,24,Djurgården,F,49,9,13,22,44,2,1,61,-,-,22,21,1,14:48
,81,Richard Lintner,22,Färjestad,D,42,8,14,22,50,2,3,100,-,-,32,24,8,20:57
,82,Janne Hauhtonen,15,Brynäs,F,46,7,15,22,54,0,4,55,-,-,19,36,-17,16:08
,83,Duane Harmer,28,SSK,D,55,5,17,22,38,2,3,124,-,-,18,21,-3,15:33
,84,Johan Lindström,79,/,F,50,4,18,22,22,1,1,62,-,-,18,21,-3,12:13
,85,Stefan Bemström,22,SSK,D,52,4,18,22,22,1,1,101,-,-,30,22,8,20:42
,86,Petri Kokko,32,Timrå,D,55,4,18,22,70,2,2,81,-,-,25,20,5,18:22
,87,David Petrasek,22,HV71,D,52,2,20,22,76,0,2,91,-,-,34,20,14,21:12
,88,Christian Eklund,20,Djurgården,F,48,10,11,21,91,1,3,75,-,-,22,26,-4,16:31
,89,Mats Lavander,62,Luleå,F,55,9,12,21,18,1,2,89,-,-,27,32,-5,16:18
,90,Yared Hagos,91,Mora,F,48,8,13,21,52,3,3,58,-,-,19,27,-8,14:42
,91,Kalle Koskinen,9,Timrå,D,52,4,17,21,50,2,3,59,-,-,24,26,-2,20:01
,92,Kim Staal,28,Linköping,F,51,12,8,20,30,2,4,105,-,-,23,23,0,13:15
,93,Anton Axelsson,6,Timrå,F,54,10,10,20,10,2,4,55,-,-,17,10,7,12:19
,94,Johan Andersson,17,Timrå,F,55,10,10,20,50,1,0,103,-,-,27,32,-5,19:04
,95,Dominik Granak,51,Färjestad,D,53,7,13,20,38,1,6,81,-,-,43,31,12,21:49
,96,Erik Forssell,20,Skellefteå,F,46,6,14,20,18,1,2,65,-,-,23,21,2,16:08
,97,Toni Söderholm,26,Frölunda,D,53,6,14,20,66,2,4,69,-,-,30,32,-2,20:33
,98,Mads Hansen,24,Brynäs,F,53,5,15,20,58,0,2,83,-,-,30,26,4,19:15
,99,Håkan Bogg,33,Mora,F,50,4,16,20,34,1,1,41,-,-,19,30,-11,13:51
,100,Jonas Junland,44,Linköping,D,52,3,17,20,42,2,0,97,-,-,38,32,6,19:55
,101,Kimmo Koskenkorva,9,Skellefteå,F,55,10,9,19,36,0,4,78,-,-,16,19,-3,15:20
,102,Björn Melin,9,HV71,F,40,9,10,19,32,3,4,95,-,-,13,20,-7,15:47
,103,Robert Carlsson,14,SSK,F,55,8,11,19,66,2,2,102,-,-,21,28,-7,18:11
,104,Nicholas Angell,18,Brynäs,D,42,6,13,19,42,1,2,65,-,-,27,29,-2,18:07
,105,Jari Kauppila,33,HV71,F,54,5,14,19,63,0,1,87,-,-,21,20,1,14:17
,106,Nichlas Falk,16,Djurgården,F,46,9,9,18,20,1,0,38,-,-,27,19,8,17:38
,107,Tomas Skogs,23,Mora,D,52,9,9,18,93,1,2,77,-,-,32,19,13,20:59
,108,Pekka Saravo,14,Luleå,D,55,8,10,18,52,1,1,82,-,-,34,38,-4,21:09
,109,Jyri Marttinen,58,/,D,53,6,12,18,91,2,4,106,-,-,33,31,2,22:22
,110,Ronnie Sundin,23,Frölunda,D,54,3,15,18,64,1,2,69,-,-,44,40,4,21:17
,111,Steven Kariya,18,Frölunda,F,41,1,17,18,18,0,0,59,-,-,20,32,-12,13:55
,112,Dragan Umicevic,84,SSK,F,39,10,7,17,28,1,4,104,-,-,14,19,-5,15:20
,113,Michael Holmqvist,18,Frölunda,F,53,7,10,17,51,0,0,84,-,-,27,34,-7,12:43
,113,Marco Tuokko,13,Mora,F,53,7,10,17,64,1,4,87,-,-,15,21,-6,13:13
,115,Per Hållberg,18,MODO,D,40,2,15,17,48,2,2,64,-,-,22,16,6,21:55
,116,Christian Söderström,82,Färjestad,F,45,10,6,16,24,1,2,72,-,-,19,18,1,13:49
,117,Jan Sandström,7,Luleå,D,53,7,9,16,44,2,4,120,-,-,29,29,0,0:55
,118,Jiri Marusak,29,Djurgården,D,44,6,10,16,26,2,2,95,-,-,26,23,3,18:42
,119,Andreas Molinder,24,MODO,F,53,6,10,16,14,0,0,42,-,-,19,17,2,9:20
,120,Martti Järventie,44,Mora,D,39,5,11,16,50,1,1,86,-,-,26,33,-7,21:23
,121,Jaroslav Obsut,43,Luleå,D,52,5,11,16,78,0,1,104,-,-,34,36,-2,21:20
,122,Ove Molin,21,Brynäs,F,44,4,12,16,26,0,0,35,-,-,15,18,-3,12:54
,123,Fredrik Krekula,10,Skellefteå,F,48,4,12,16,44,0,0,68,-,-,13,22,-9,15:24
,124,Björn Danielsson,23,Brynäs,F,47,3,13,16,45,0,2,52,-,-,20,29,-9,15:34
,125,Per Åslund,22,Färjestad,F,41,8,7,15,10,0,2,54,-,-,20,12,8,13:03
,126,Oscar Sundh,13,Timrå,F,55,8,7,15,28,1,4,103,-,-,18,20,-2,14:25
,127,Ossi Väänänen,4,Djurgården,D,45,7,8,15,102,1,3,51,-,-,33,19,14,21:11
,128,David Printz,55,Djurgården,D,54,6,9,15,71,2,2,38,-,-,30,37,-7,19:05
,129,Pierre Hedin,21,MODO,D,55,6,9,15,72,1,1,100,-,-,31,29,2,21:22
,129,Mikael Johansson,21,Frölunda,F,55,6,9,15,34,0,0,57,-,-,23,18,5,10:48
,131,Johan Fransson,10,Linköping,D,48,5,10,15,24,1,3,101,-,-,31,29,2,20:39
,132,Pavel Skrbek,11,Luleå,D,43,4,11,15,34,1,1,53,-,-,28,34,-6,23:17
,133,Jimmie Ericsson,21,Skellefteå,F,44,4,11,15,69,1,0,66,-,-,20,21,-1,15:40
,134,Pär Styf,36,Timrå,D,47,4,11,15,62,2,2,87,-,-,22,26,-4,19:11
,135,Mikko Kurvinen,4,Mora,D,55,4,11,15,22,2,3,52,-,-,28,30,-2,21:11
,136,Daniel Hermansson,22,Brynäs,F,53,7,7,14,16,1,0,67,-,-,22,30,-8,10:08
,137,Jörgen Bemström,24,SSK,F,47,6,8,14,32,0,0,68,-,-,17,14,3,17:05
,138,Adam Masuhr,38,/,D,51,6,8,14,16,1,4,108,-,-,23,36,-13,17:15
,139,Erik Andersson,2,Skellefteå,D,50,5,9,14,32,2,1,67,-,-,19,12,7,15:24
,140,Thomas Johansson,18,Djurgården,D,55,5,9,14,24,0,2,89,-,-,30,36,-6,19:29
,141,Timmy Pettersson,33,Djurgården,D,54,1,13,14,40,0,0,106,-,-,36,20,16,20:28
,142,Jonathan Hedström,71,Timrå,F,27,7,6,13,50,4,3,66,-,-,9,16,-7,19:49
,143,Anders Nilsson,43,Mora,F,51,7,6,13,24,1,0,41,-,-,18,13,5,10:18
,144,Fredrik Pettersson,10,Frölunda,F,53,6,7,13,38,2,0,45,-,-,16,10,6,8:00
,145,Tomas Kollar,29,SSK,F,47,5,8,13,34,0,0,56,-,-,15,22,-7,11:48
,146,Eric Johansson,20,HV71,F,47,4,9,13,24,1,1,39,-,-,15,16,-1,11:31
,147,Peter Nolander,70,Brynäs,D,51,4,9,13,28,2,3,56,-,-,25,33,-8,17:36
,148,Oscar Hedman,41,MODO,D,53,4,9,13,30,1,1,77,-,-,28,30,-2,20:01
,149,Patrik Zackrisson,26,Linköping,F,55,4,9,13,35,1,0,48,-,-,22,13,9,9:38
,150,Sanny Lindström,8,Timrå,D,54,3,10,13,99,0,3,63,-,-,31,32,-1,20:14
,151,Björn Svensson,26,Timrå,F,54,8,4,12,10,1,1,65,-,-,18,27,-9,13:42
,152,Andreas Engqvist,21,Djurgården,F,51,5,7,12,16,0,0,48,-,-,15,19,-4,11:31
,153,Tim Eriksson,26,Linköping,F,54,5,7,12,6,0,0,60,-,-,18,14,4,9:03
,154,Kimmo Lotvonen,29,Timrå,D,47,4,8,12,42,1,2,62,-,-,21,25,-4,20:45
,155,Viktor Lindgren,10,Luleå,F,49,4,8,12,12,0,1,58,-,-,23,17,6,11:02
,156,Ville Vahalahti,28,Linköping,F,53,4,8,12,8,0,2,79,-,-,20,18,2,12:18
,157,Atvars Tribuncovs,32,MODO,D,33,3,9,12,62,0,1,53,-,-,24,22,2,0:21
,158,Andreas Falk,19,HV71,F,55,2,10,12,81,0,0,62,-,-,16,19,-3,14:43
,159,Jonathan Granström,31,Mora,F,54,7,4,11,34,0,3,51,-,-,19,23,-4,15:02
,160,Tero Määttä,22,Mora,D,53,6,5,11,65,0,4,47,-,-,29,28,1,18:03
,161,Jussi Tarvainen,40,Luleå,F,39,5,6,11,26,2,3,71,-,-,13,24,-11,13:22
,162,Jari Tolsa,17,MODO,F,52,5,6,11,87,0,1,59,-,-,21,21,0,14:23
,162,Jonas Esbjörs,22,Frölunda,F,52,5,6,11,40,1,0,32,-,-,17,11,6,9:18
,164,Tobias Viklund,16,Skellefteå,D,53,4,7,11,14,0,2,108,-,-,14,33,-19,15:57
,165,Martin Cibak,8,SSK,F,51,3,8,11,62,0,0,70,-,-,19,24,-5,15:52
,166,Tommy Sjödin,7,Brynäs,D,52,2,9,11,92,1,0,88,-,-,29,39,-10,20:09
,167,Tuukka Mäntylä,4,Frölunda,D,45,1,10,11,46,0,1,59,-,-,26,27,-1,20:43
,168,Patric Blomdahl,84,Linköping,F,52,7,3,10,100,1,1,73,-,-,16,17,-1,8:47
,169,Rob Hisey,72,Mora,F,12,6,4,10,10,1,3,25,-,-,7,11,-4,15:26
,170,Mathias Johansson,75,Färjestad,F,46,6,4,10,54,2,0,56,-,-,19,17,2,14:04
,171,Fredrik Emvall,33,Linköping,F,55,6,4,10,26,1,2,76,-,-,25,25,0,17:25
,172,Pontus Petterström,18,Skellefteå,F,53,5,5,10,28,2,0,76,-,-,19,24,-5,14:26
,173,Marcus Jonasén,13,MODO,F,55,5,5,10,63,1,0,32,-,-,18,20,-2,7:16
,174,Andre Lakos,64,Färjestad,D,33,4,6,10,130,1,1,35,-,-,22,14,8,17:15
,175,Johan Alcén,14,Brynäs,F,39,4,6,10,14,1,0,28,-,-,15,17,-2,7:29
,176,Emil Kåberg,27,Färjestad,F,45,4,6,10,96,1,1,58,-,-,11,16,-5,12:11
,177,Per Gustafsson,7,HV71,D,38,3,7,10,28,0,2,61,-,-,19,13,6,16:34
,178,Andreas Pihl,2,Linköping,D,49,3,7,10,98,0,1,61,-,-,34,17,17,16:31
,179,Mikael Simons,78,Mora,F,49,2,8,10,55,0,1,55,-,-,12,13,-1,9:01
,180,Martin Jansson,77,Mora,F,53,2,8,10,24,1,0,53,-,-,13,13,0,11:15
,181,Tommy Wargh,86,MODO,D,41,5,4,9,4,0,0,45,-,-,15,21,-6,11:07
,182,Jörgen Sundqvist,22,Brynäs,D,55,5,4,9,72,0,2,57,-,-,26,33,-7,16:41
,183,Oscar Ackeström,25,Frölunda,D,47,4,5,9,93,2,1,48,-,-,24,19,5,13:33
,184,Lars-Erik Spets,27,Brynäs,F,33,3,6,9,27,0,0,20,-,-,9,10,-1,8:14
,185,Daniel Glimmenvall,6,Brynäs,D,34,3,6,9,30,0,0,26,-,-,17,18,-1,14:01
,186,Robin Lindqvist,22,Luleå,F,52,3,6,9,18,0,0,47,-,-,12,9,3,11:38
,187,Johan Ryno,61,Djurgården,F,30,2,7,9,18,0,0,36,-,-,7,14,-7,9:16
,188,Jonas Höglund,28,Färjestad,F,36,2,7,9,32,0,1,57,-,-,7,12,-5,10:04
,189,Kristian Kudroc,4,SSK,D,51,2,7,9,156,1,0,89,-,-,35,21,14,18:32
,189,Marcus Kristoffersson,38,Skellefteå,F,51,2,7,9,60,0,1,70,-,-,11,15,-4,10:06
,191,Carl Gunnarsson,6,Linköping,D,53,2,7,9,26,0,1,51,-,-,24,19,5,14:16
,192,Magnus Isaksson,9,Luleå,F,54,2,7,9,20,0,0,18,-,-,12,11,1,7:28
,193,Jani Tuppurainen,28,Färjestad,F,13,4,4,8,6,1,3,20,-,-,5,2,3,15:14
,194,Tomas Harant,7,Mora,D,53,3,5,8,64,1,0,62,-,-,27,32,-5,18:36
,195,Ivan Majesky,26,Linköping,D,44,2,6,8,60,1,1,47,-,-,25,28,-3,16:28
,196,Anders Burström,21,Luleå,F,47,2,6,8,52,0,0,48,-,-,12,15,-3,15:40
,197,Daniel Josefsson,12,SSK,D,51,2,6,8,16,0,1,68,-,-,28,24,4,22:13
,198,Per-Anton Lundström,8,Skellefteå,D,53,2,6,8,111,0,0,60,-,-,36,25,11,18:24
,199,Robin Jonsson,39,Timrå,D,54,2,6,8,68,0,2,61,-,-,22,26,-4,18:23
,200,Peter Öberg,27,MODO,F,48,1,7,8,28,0,0,44,-,-,13,15,-2,12:14
,201,Josef Melichar,25,Linköping,D,50,0,8,8,74,0,0,70,-,-,30,31,-1,19:17
,202,Robert Carlsson,12,Timrå,F,42,4,3,7,16,0,1,32,-,-,10,16,-6,10:34
,203,Mikko Mäenpää,27,Skellefteå,D,11,3,4,7,12,0,1,35,-,-,9,7,2,21:42
,204,Per Hallin,8,SSK,F,32,3,4,7,67,1,0,51,-,-,11,13,-2,12:44
,205,Jimmie Ölvestad,19,Djurgården,F,37,3,4,7,111,0,0,37,-,-,12,15,-3,13:29
,206,Alexander Sundström,,Brynäs,F,44,3,4,7,14,0,1,28,-,-,10,17,-7,9:47
,207,Jonas Ahnelöv,55,Frölunda,D,51,3,4,7,30,0,0,31,-,-,18,28,-10,11:38
,208,Morten Ask,21,Djurgården,F,15,2,5,7,8,0,0,13,-,-,8,10,-2,12:50
,209,Mattias Timander,3,MODO,D,23,1,6,7,16,0,0,45,-,-,16,13,3,22:12
,210,Thomas Larsson,24,Skellefteå,F,34,1,6,7,42,1,1,30,-,-,8,11,-3,9:17
,211,Lance Ward,47,HV71,D,52,0,7,7,212,0,0,41,-,-,25,19,6,13:02
,212,Mattias Carlsson,15,Linköping,F,33,4,2,6,18,0,0,40,-,-,8,7,1,7:28
,213,Mattias Tedenby,21,HV71,F,23,3,3,6,6,0,0,29,-,-,11,6,5,7:54
,214,Edvin Frylén,36,Djurgården,D,45,3,3,6,32,1,2,59,-,-,15,25,-10,18:53
,215,Stefan Gråhns,41,SSK,F,52,3,3,6,38,1,0,35,-,-,6,3,3,5:42
,216,Johan Ejdepalm,8,Luleå,D,55,3,3,6,38,1,1,54,-,-,30,31,-1,16:26
,217,Peter Nordström,19,Färjestad,F,17,2,4,6,4,1,1,28,-,-,5,6,-1,16:03
,218,Markus Kankaanperä,18,Brynäs,D,45,2,4,6,114,0,0,37,-,-,26,30,-4,19:23
,219,Kalle Kerman,23,Luleå,F,31,1,5,6,22,0,0,59,-,-,4,14,-10,11:19
,220,Jarno Kultanen,21,SSK,D,50,1,5,6,36,0,0,75,-,-,24,26,-2,21:05
,221,Jens Olsson,28,SSK,D,55,1,5,6,36,0,0,50,-,-,21,16,5,15:17
,221,Daniel Grillfors,32,HV71,D,55,1,5,6,24,1,1,56,-,-,24,18,6,14:24
,223,Fredrik Lindgren,61,Skellefteå,D,54,0,6,6,40,0,0,87,-,-,43,40,3,21:18
,223,Christoffer Norgren,29,Skellefteå,D,54,0,6,6,63,0,0,19,-,-,24,28,-4,16:45
,225,Kenneth Bergqvist,41,Mora,F,34,4,1,5,4,0,0,24,-,-,7,5,2,5:28
,226,Jonas Johansson,61,HV71,F,47,4,1,5,12,1,0,46,-,-,11,15,-4,7:59
,227,Ragnar Karlsson,27,SSK,F,53,2,3,5,30,1,0,35,-,-,8,7,1,10:14
,228,Antti-Jussi Niemi,7,Frölunda,D,54,1,4,5,79,0,0,59,-,-,31,29,2,18:26
,229,Jens Skåhlberg,40,Färjestad,D,53,0,5,5,26,0,0,32,-,-,17,27,-10,12:23
,230,Fredrik Hynning,12,Timrå,F,18,4,0,4,4,1,3,15,-,-,1,8,-7,10:31
,231,Sebastian Karlsson,12,Brynäs,F,32,3,1,4,10,0,0,26,-,-,7,5,2,7:13
,232,Mikael Lidhammar,20,Luleå,F,40,3,1,4,24,2,0,20,-,-,5,6,-1,4:13
,233,Hans Jonsson,5,MODO,D,41,3,1,4,30,1,0,59,-,-,18,24,-6,19:53
,234,Mattias Karlsson,20,Färjestad,D,13,2,2,4,4,0,0,15,-,-,13,3,10,19:46
,235,Pierre Johnsson,2,Mora,D,38,2,2,4,28,0,0,28,-,-,11,13,-2,13:48
,236,Victor Hedman,41,MODO,D,39,2,2,4,44,0,0,39,-,-,15,14,1,10:45
,237,Justin Morrison,15,Frölunda,F,11,1,3,4,6,0,1,12,-,-,2,8,-6,13:37
,238,Per Savilahti-Nagander,,Luleå,D,34,1,3,4,22,0,1,17,-,-,14,13,1,8:21
,239,Andreas Andersson,54,HV71,Gk,51,1,3,4,0,0,0,1,-,-,21,14,7,0:00
,240,David Cullen,44,Färjestad,D,18,0,4,4,22,0,0,16,-,-,11,7,4,14:06
,241,Eric Moe,9,Timrå,D,19,0,4,4,4,0,0,9,-,-,5,5,0,9:13
,241,Emil Sandin,13,Brynäs,F,19,0,4,4,0,0,0,4,-,-,6,6,0,5:16
,243,Miroslav Kovacik,47,Skellefteå,F,16,2,1,3,6,0,0,18,-,-,4,6,-2,9:55
,244,Johan Ramstedt,11,Skellefteå,F,29,2,1,3,14,0,0,31,-,-,6,11,-5,10:41
,245,Jens Westin,3,MODO,D,33,2,1,3,16,0,0,21,-,-,9,16,-7,9:42
,246,Johan Andersson,32,Frölunda,F,49,2,1,3,14,1,0,38,-,-,6,12,-6,5:22
,247,Burke Henry,4,Linköping,D,9,1,2,3,6,0,0,5,-,-,4,4,0,14:09
,248,Anton Lander,51,Timrå,F,32,1,2,3,4,0,0,14,-,-,4,2,2,5:08
,249,Magnus Pääjärvi-Svensson,91,Timrå,F,35,1,2,3,2,1,0,25,-,-,6,6,0,7:43
,250,Emil Lundberg,51,Luleå,F,7,0,3,3,8,0,0,11,-,-,4,8,-4,18:35
,251,Niclas Andersén,9,Brynäs,D,38,0,3,3,26,0,0,10,-,-,18,18,0,8:38
,252,Johan Backlund,26,Timrå,Gk,54,0,3,3,0,0,0,1,-,-,68,69,-1,0:00
,253,Niklas Olausson,16,Linköping,F,12,1,1,2,0,0,0,7,-,-,3,2,1,7:45
,254,Mika Niskanen,99,HV71,D,17,1,1,2,6,0,0,6,-,-,6,4,2,8:56
,255,Ronald Petrovicky,26,MODO,F,18,1,1,2,10,1,0,19,-,-,5,5,0,10:32
,256,Ronnie Pettersson,6,Djurgården,D,22,1,1,2,20,0,0,14,-,-,10,10,0,15:26
,257,Henrik Eriksson,37,HV71,F,23,1,1,2,2,0,0,10,-,-,2,1,1,3:37
,258,Pär Arlbrandt,40,SSK,F,26,1,1,2,6,0,1,9,-,-,2,6,-4,6:35
,259,Robin Olsson,5,Luleå,D,34,1,1,2,0,0,0,9,-,-,7,8,-1,5:40
,259,Carl Gustafsson,28,Djurgården,F,34,1,1,2,6,0,0,19,-,-,2,6,-4,6:18
,261,Lars Eller,61,Frölunda,F,14,0,2,2,4,0,0,12,-,-,2,4,-2,8:43
,262,Johan Motin,57,Färjestad,D,28,0,2,2,10,0,0,10,-,-,4,13,-9,10:43
,263,Jhonas Enroth,1,SSK,Gk,46,0,2,2,0,0,0,0,-,-,31,29,2,0:00
,264,Karol Krizan,60,MODO,Gk,53,0,2,2,58,0,0,0,-,-,75,81,-6,0:00
,265,Björn Bjurling,31,SSK,Gk,54,0,2,2,0,0,0,0,-,-,50,44,6,0:00
,266,Stefan Liv,1,HV71,Gk,55,0,2,2,2,0,0,0,-,-,82,59,23,0:00
,267,Erik Karlsson,65,Frölunda,D,7,1,0,1,0,1,1,8,-,-,2,0,2,5:58
,268,Joakim Andersson,18,Frölunda,F,9,1,0,1,2,0,0,8,-,-,1,3,-2,6:52
,269,Erik Karlberg,28,Skellefteå,F,18,1,0,1,8,0,0,6,-,-,3,3,0,3:39
,270,Martin Johansson,25,Färjestad,F,30,1,0,1,0,0,0,16,-,-,5,7,-2,6:27
,271,Mikko Pukka,8,Luleå,D,48,1,0,1,40,0,0,20,-,-,8,18,-10,8:34
,272,Anton Grundel,73,Färjestad,D,1,0,1,1,0,0,0,1,-,-,1,1,0,6:09
,273,Tomek Valtonen,10,SSK,F,4,0,1,1,6,0,0,5,-,-,0,0,0,14:15
,273,Daniel Wessner,62,Mora,F,4,0,1,1,2,0,0,1,-,-,1,0,1,3:07
,273,Rok Ticar,24,Timrå,F,4,0,1,1,0,0,0,0,-,-,1,0,1,0:47
,276,Antti Bruun,33,Mora,D,5,0,1,1,0,0,0,4,-,-,2,1,1,11:53
,277,Jacob Markström,25,Brynäs,Gk,8,0,1,1,2,0,0,0,-,-,11,16,-5,0:00
,278,Johan Halvardsson,27,HV71,D,9,0,1,1,2,0,0,4,-,-,2,2,0,10:22
,278,Johannes Salmonsson,25,Brynäs,F,9,0,1,1,2,0,0,4,-,-,2,5,-3,5:19
,280,Jan Novak,17,Skellefteå,D,10,0,1,1,8,0,0,12,-,-,3,6,-3,13:22
,281,Martin Lundberg,27,Skellefteå,F,11,0,1,1,2,0,0,0,-,-,1,1,0,1:57
,281,Ossi-Petteri Grönholm,3,Frölunda,D,11,0,1,1,12,0,0,9,-,-,6,4,2,15:20
,283,Nick Kuiper,37,Luleå,D,12,0,1,1,10,0,0,10,-,-,5,8,-3,16:39
,284,Anders Danielsson,70,Mora,D,13,0,1,1,0,0,0,4,-,-,1,4,-3,4:15
,285,Per Johnsson,3,Färjestad,D,16,0,1,1,0,0,0,8,-,-,0,1,-1,5:09
,286,Patrik Cedergren,28,Mora,D,19,0,1,1,0,0,0,3,-,-,2,6,-4,5:00
,287,Kari Haakana,32,Skellefteå,D,21,0,1,1,20,0,0,5,-,-,5,8,-3,13:08
,287,Dennis Persson,29,Djurgården,D,21,0,1,1,6,0,0,4,-,-,3,6,-3,7:22
,289,Martin Richter,5,SSK,D,29,0,1,1,30,0,0,9,-,-,9,6,3,13:28
,289,Erik Andersson,11,Timrå,F,29,0,1,1,8,0,0,14,-,-,5,9,-4,8:35
,291,Rodrigo Lavins,32,SSK,D,34,0,1,1,10,0,0,8,-,-,2,9,-7,6:23
,292,Christopher Heino-Lindberg,40,Färjestad,Gk,39,0,1,1,6,0,0,0,-,-,61,44,17,0:00
,293,Stefan Ridderwall,39,Djurgården,Gk,45,0,1,1,0,0,0,0,-,-,17,21,-4,0:00
,294,Jonas Frögren,24,Färjestad,D,47,0,1,1,38,0,0,22,-,-,23,21,2,17:24
,295,Jonas Lennartsson,5,Skellefteå,D,49,0,1,1,22,0,0,8,-,-,9,6,3,7:55
,296,Daniel Sperrle,1,Brynäs,Gk,52,0,1,1,14,0,0,0,-,-,53,58,-5,0:00
,296,Jonas Gustavsson,50,Färjestad,Gk,52,0,1,1,2,0,0,0,-,-,32,28,4,0:00
,298,Juha Pitkämäki,31,Mora,Gk,53,0,1,1,2,0,0,0,-,-,76,82,-6,0:00
,299,Simon Hjalmarsson,59,Frölunda,F,1,0,0,0,2,0,0,0,-,-,0,0,0,3:05
,299,Jimmy Andersson,84,HV71,F,1,0,0,0,0,0,0,1,-,-,1,2,-1,7:28
,299,Daniel Despotovic,15,SSK,F,1,0,0,0,0,0,0,0,-,-,0,0,0,5:37
,299,Anton Gustafsson,58,Frölunda,F,1,0,0,0,0,0,0,2,-,-,0,0,0,5:03
,299,Markus Hedström,17,Skellefteå,D,1,0,0,0,0,0,0,0,-,-,0,0,0,7:51
,299,Johan Burlin,38,Skellefteå,D,1,0,0,0,0,0,0,0,-,-,0,0,0,0:00
,299,Pontus Hansson,42,Frölunda,Gk,1,0,0,0,0,0,0,0,-,-,0,0,0,0:00
,299,Petter Söderström,25,Timrå,Gk,1,0,0,0,0,0,0,0,-,-,0,0,0,0:00
,299,Mattias Ekholm,14,Mora,D,1,0,0,0,0,0,0,0,-,-,0,0,0,0:00
,299,Richard Gynge,10,Brynäs,F,1,0,0,0,0,0,0,0,-,-,0,0,0,1:28
,299,Fredrik Bringnäs,48,Linköping,D,1,0,0,0,0,0,0,0,-,-,0,0,0,0:00
,299,Anders Nilsson,31,Luleå,Gk,1,0,0,0,0,0,0,0,-,-,0,0,0,0:00
,299,Joel Vikberg,17,Skellefteå,F,1,0,0,0,0,0,0,0,-,-,0,0,0,1:19
,299,Peter Andersson,44,Frölunda,D,1,0,0,0,0,0,0,0,-,-,0,0,0,0:17
,299,Henrik Björklund,14,Färjestad,F,1,0,0,0,0,0,0,0,-,-,0,1,-1,4:03
,299,Marcus Dahlbom,56,Färjestad,Gk,1,0,0,0,0,0,0,0,-,-,0,0,0,0:00
,299,Jacob Josefson,40,Djurgården,F,1,0,0,0,0,0,0,0,-,-,0,0,0,2:14
,316,Peter Skoggård,1,Luleå,Gk,2,0,0,0,0,0,0,0,-,-,0,0,0,0:00
,316,Rickard Eriksson,34,Brynäs,D,2,0,0,0,0,0,0,1,-,-,0,0,0,0:00
,316,Simon Önerud,11,HV71,F,2,0,0,0,2,0,0,2,-,-,0,1,-1,4:00
,316,Mats Fröshaug,21,Linköping,F,2,0,0,0,0,0,0,0,-,-,0,0,0,0:48
,316,Daniel Viksten,13,Mora,F,2,0,0,0,0,0,0,0,-,-,0,0,0,0:00
,316,Oskar Johansson,46,Timrå,F,2,0,0,0,0,0,0,0,-,-,0,0,0,1:00
,316,Sebastian Lauritzen,16,Linköping,F,2,0,0,0,0,0,0,0,-,-,0,0,0,0:00
,316,Dennis Bozic,29,Linköping,D,2,0,0,0,0,0,0,0,-,-,0,0,0,0:00
,316,Tim Erixon,4,Skellefteå,D,2,0,0,0,0,0,0,2,-,-,0,0,0,9:38
,316,Nicklas Lasu,31,Frölunda,F,2,0,0,0,0,0,0,0,-,-,1,0,1,3:56
,316,Patrik Wallon,7,Skellefteå,D,2,0,0,0,0,0,0,0,-,-,0,0,0,1:12
,316,Stefan Espeland,17,MODO,D,2,0,0,0,0,0,0,0,-,-,0,0,0,0:26
,328,Daniel Hansén,15,Mora,Gk,3,0,0,0,0,0,0,0,-,-,0,0,0,0:00
,328,Antti Hulkkonen,5,Brynäs,D,3,0,0,0,0,0,0,0,-,-,0,0,0,0:00
,328,Sebastian Hård Af Segerstad,14,Timrå,F,3,0,0,0,0,0,0,0,-,-,1,0,1,0:38
,328,Tobias Lindström,97,Djurgården,F,3,0,0,0,0,0,0,1,-,-,0,0,0,5:20
,328,Mattias Guter,44,Djurgården,F,3,0,0,0,0,0,0,1,-,-,0,0,0,0:28
,328,Kim Karlsson,,Luleå,F,3,0,0,0,0,0,0,0,-,-,0,0,0,1:04
,328,Anders Lindbäck,39,Brynäs,Gk,3,0,0,0,0,0,0,0,-,-,0,0,0,0:00
,335,Andro Michel,40,Färjestad,Gk,4,0,0,0,0,0,0,0,-,-,5,4,1,0:00
,335,Alexander Hermansson,30,Färjestad,Gk,4,0,0,0,0,0,0,0,-,-,0,0,0,0:00
,335,Stefan Erkgärds,4,Färjestad,D,4,0,0,0,4,0,0,2,-,-,0,0,0,5:36
,335,Christoffer Bengtsberg,,HV71,Gk,4,0,0,0,0,0,0,0,-,-,0,0,0,0:00
,335,Anton Persson,27,Brynäs,F,4,0,0,0,0,0,0,1,-,-,1,0,1,5:07
,335,Joakim Hillding,24,HV71,F,4,0,0,0,0,0,0,0,-,-,0,1,-1,2:10
,341,Lukas Sandström,99,Mora,F,5,0,0,0,0,0,0,0,-,-,0,1,-1,1:19
,341,Thomas Enström,11,MODO,F,5,0,0,0,0,0,0,0,-,-,0,2,-2,3:48
,341,Jesse Niinimäki,8,Luleå,F,5,0,0,0,0,0,0,1,-,-,0,0,0,6:30
,341,Viktor Amnér,4,Mora,D,5,0,0,0,0,0,0,0,-,-,0,0,0,0:00
,341,Mattias Remstam,75,HV71,F,5,0,0,0,0,0,0,6,-,-,1,2,-1,9:18
,346,Elias Bjuhr,33,MODO,F,6,0,0,0,0,0,0,2,-,-,0,2,-2,2:12
,346,Christian Engstrand,1,Linköping,Gk,6,0,0,0,0,0,0,0,-,-,0,0,0,0:00
,346,David Rundblad,7,Skellefteå,D,6,0,0,0,2,0,0,2,-,-,0,0,0,3:12
,346,David Fredriksson,54,HV71,F,6,0,0,0,6,0,0,6,-,-,1,3,-2,7:41
,350,David Ullström,29,HV71,F,7,0,0,0,0,0,0,1,-,-,0,0,0,2:47
,350,Johan Erkgärds,77,Färjestad,F,7,0,0,0,25,0,0,0,-,-,0,1,-1,4:07
,350,Fredrik Sonntag,6,SSK,D,7,0,0,0,0,0,0,0,-,-,0,0,0,0:06
,350,Jere Myllyniemi,35,Luleå,Gk,7,0,0,0,0,0,0,0,-,-,6,10,-4,0:00
,350,Linus Persson,25,Djurgården,F,7,0,0,0,2,0,0,1,-,-,1,0,1,2:27
,355,Linus Kjell,26,Djurgården,D,8,0,0,0,2,0,0,2,-,-,0,1,-1,3:06
,356,Emil Bejmo,13,Färjestad,F,9,0,0,0,0,0,0,3,-,-,0,5,-5,2:29
,356,Krisjanis Redlihs,25,Linköping,D,9,0,0,0,0,0,0,1,-,-,1,4,-3,4:09
,356,Lukas Ericsson,53,HV71,F,9,0,0,0,0,0,0,0,-,-,1,2,-1,2:32
,359,Juuso Riksman,30,Färjestad,Gk,10,0,0,0,2,0,0,0,-,-,6,14,-8,0:00
,359,Mark Owuya,30,Djurgården,Gk,10,0,0,0,0,0,0,0,-,-,1,1,0,0:00
,359,Pontus Sjögren,87,SSK,Gk,10,0,0,0,0,0,0,0,-,-,0,0,0,0:00
,359,Daniel Ljungkvist,16,SSK,D,10,0,0,0,6,0,0,4,-,-,0,3,-3,11:13
,363,Niklas Svedberg,89,MODO,Gk,11,0,0,0,0,0,0,0,-,-,0,1,-1,0:00
,364,Henrik Eriksson,17,Djurgården,F,15,0,0,0,0,0,0,4,-,-,0,2,-2,3:09
,365,Philip Larsen,3,Frölunda,D,16,0,0,0,2,0,0,2,-,-,2,3,-1,3:25
,366,Patrick Bovim,28,HV71,D,17,0,0,0,2,0,0,0,-,-,0,1,-1,1:28
,367,Jonathan Carlsson,36,Brynäs,D,26,0,0,0,27,0,0,6,-,-,4,11,-7,7:40
,368,Sebastian Erixon,50,Timrå,D,27,0,0,0,2,0,0,5,-,-,4,5,-1,4:32
,369,Fredric Andersson,13,SSK,F,28,0,0,0,0,0,0,2,-,-,0,0,0,0:50
,370,Fredrik Ericson,38,Djurgården,D,29,0,0,0,14,0,0,8,-,-,8,9,-1,7:36
,371,Oscar Eklund,16,Djurgården,D,31,0,0,0,10,0,0,5,-,-,4,8,-4,5:57
,372,Johan Wiklander,56,SSK,F,32,0,0,0,8,0,0,21,-,-,0,4,-4,5:08
,373,Tobias Forsberg,19,MODO,F,37,0,0,0,6,0,0,9,-,-,2,7,-5,3:15
,374,Michal Zajkowski,30,MODO,Gk,46,0,0,0,0,0,0,0,-,-,14,6,8,0:00
,375,Markus Korhonen,1,Brynäs,Gk,47,0,0,0,2,0,0,0,-,-,35,45,-10,0:00
,375,Mattias Modig,33,Luleå,Gk,47,0,0,0,0,0,0,0,-,-,20,24,-4,0:00
,377,Jonas Fransson,32,Linköping,Gk,51,0,0,0,0,0,0,0,-,-,32,26,6,0:00
,378,Rastislav Stana,31,Linköping,Gk,53,0,0,0,0,0,0,0,-,-,78,73,5,0:00
,378,Gusten Törnqvist,95,Luleå,Gk,53,0,0,0,4,0,0,0,-,-,64,66,-2,0:00
,380,Lars Johansson,1,Mora,Gk,54,0,0,0,0,0,0,0,-,-,12,14,-2,0:00
,380,Ari Ahonen,31,Frölunda,Gk,54,0,0,0,12,0,0,0,-,-,95,78,17,0:00
,382,Magnus Åkerlund,1,Timrå,Gk,55,0,0,0,0,0,0,0,-,-,14,13,1,0:00
,382,Nicklas Dahlberg,30,Skellefteå,Gk,55,0,0,0,0,0,0,0,-,-,7,9,-2,0:00
,382,Andreas Hadelöv,1,Skellefteå,Gk,55,0,0,0,0,0,0,1,-,-,81,86,-5,0:00
,382,Daniel Larsson,,Djurgården,Gk,55,0,0,0,4,0,0,0,-,-,74,66,8,0:00
,382,Joel Gistedt,31,Frölunda,Gk,55,0,0,0,0,0,0,0,-,-,10,25,-15,0:00
,1,Fredrik Bremberg,73,Djurgården,F,53,23,41,64,20,5,5,123,-,-,44,35,9,21:26
,2,Pavel Brendl,28,Mora,F,54,34,23,57,34,4,16,211,-,-,30,36,-6,18:33
,3,Peter Nordström,19,Färjestad,F,51,26,29,55,58,3,12,140,-,-,40,24,16,17:58
,4,Tomas Surovy,43,Luleå,F,55,23,32,55,38,2,5,198,-,-,51,39,12,19:49
,5,Tony Mårtensson,9,Linköping,F,55,18,36,54,20,3,10,154,-,-,40,40,0,21:48
,5,Tomi Kallio,71,Frölunda,F,55,18,36,54,103,2,8,202,-,-,33,33,0,18:53
,7,Mikael Renberg,19,Luleå,F,48,18,32,50,34,3,8,127,-,-,34,27,7,14:55
,8,Martin Plüss,28,Frölunda,F,54,17,33,50,96,2,8,129,-,-,40,34,6,19:53
,9,Lubos Bartecko,23,Luleå,F,44,22,27,49,46,3,9,100,-,-,43,34,9,19:52
,10,Janne Niskala,22,Färjestad,D,53,19,30,49,62,5,9,154,-,-,61,36,25,21:16
,11,Per-Åge Skröder,10,MODO,F,54,30,18,48,97,4,7,174,-,-,44,25,19,19:08
,12,Niklas Andersson,24,Frölunda,F,51,21,27,48,75,4,8,154,-,-,30,27,3,20:15
,13,Pelle Prestberg,10,Färjestad,F,54,19,29,48,38,6,7,110,-,-,37,20,17,12:06
,14,Johan Åkerman,4,HV71,D,55,10,38,48,48,2,6,148,-,-,43,38,5,22:53
,15,Jörgen Jönsson,21,Färjestad,F,48,15,32,47,44,3,7,90,-,-,42,22,20,18:34
,16,Johan Davidsson,76,HV71,F,55,15,31,46,22,4,6,100,-,-,39,28,11,20:57
,17,Niklas Sundström,24,MODO,F,47,9,36,45,116,2,3,65,-,-,43,22,21,19:53
,18,Thomas Rhodin,25,Färjestad,D,55,9,36,45,50,2,8,111,-,-,47,38,9,20:45
,19,Esa Pirnes,10,Färjestad,F,43,17,26,43,28,2,8,110,-,-,33,34,-1,18:56
,20,Fredrik Hynning,12,Luleå,F,53,17,26,43,30,2,5,129,-,-,39,32,7,18:35
,21,Anders Söderberg,26,Skellefteå,F,54,13,28,41,10,3,4,100,-,-,27,30,-3,20:09
,22,Nicklas Bäckström,19,Brynäs,F,45,12,28,40,46,1,7,84,-,-,30,31,-1,19:41
,23,Steven Kariya,18,Frölunda,F,55,23,16,39,34,4,5,128,-,-,35,32,3,15:20
,24,Martin Chabada,12,Luleå,F,42,18,21,39,102,2,7,127,-,-,31,33,-2,20:08
,25,Jonathan Hedström,71,Timrå,F,54,13,25,38,74,4,5,119,-,-,25,38,-13,20:29
,26,Joakim Eriksson,10,Linköping,F,55,12,25,37,42,0,3,95,-,-,34,28,6,19:47
,27,Jesper Mattsson,26,Färjestad,F,51,10,26,36,79,1,5,86,-,-,21,23,-2,16:35
,28,Teemu Elomo,49,Mora,F,55,10,26,36,28,1,4,94,-,-,24,32,-8,15:04
,29,Magnus Johansson,7,Linköping,D,52,8,28,36,46,2,5,163,-,-,34,38,-4,1:02
,30,Magnus Wernblom,9,Skellefteå,F,49,25,10,35,79,3,19,204,-,-,23,24,-1,17:55
,31,Jonas Johnson,30,Frölunda,F,55,17,18,35,46,2,10,83,-,-,28,30,-2,19:33
,32,Per Svartvadet,39,MODO,F,52,13,22,35,30,2,2,76,-,-,39,25,14,18:52
,33,Patric Hörnqvist,10,Djurgården,F,49,23,11,34,38,1,12,136,-,-,26,28,-2,16:01
,34,Jukka Voutilainen,39,HV71,F,50,15,19,34,26,2,7,121,-,-,28,25,3,16:28
,35,Pasi Puistola,21,HV71,D,53,11,23,34,60,1,7,134,-,-,38,37,1,22:02
,36,Sean Bergenheim,10,Frölunda,F,36,16,17,33,80,2,4,117,-,-,29,20,9,14:50
,37,Pär Bäcker,24,Djurgården,F,55,9,24,33,32,1,3,76,-,-,29,25,4,19:44
,38,Jonas Höglund,28,Färjestad,F,55,20,12,32,18,3,13,152,-,-,19,28,-9,14:44
,39,Mikael Wahlberg,23,Malmö,F,53,15,17,32,80,0,4,87,-,-,28,35,-7,20:26
,40,Niklas Persson,23,Linköping,F,55,15,17,32,32,0,4,118,-,-,32,29,3,18:12
,41,Jaroslav Obsut,43,Luleå,D,51,11,21,32,26,3,7,141,-,-,44,39,5,23:53
,42,Fredrik Warg,29,Timrå,F,48,10,21,31,53,0,3,101,-,-,20,28,-8,19:06
,43,Håkan Bogg,33,Mora,F,50,10,21,31,42,0,5,55,-,-,24,26,-2,15:19
,44,Anders Bastiansen,20,Mora,F,55,7,24,31,58,1,0,73,-,-,39,33,6,19:03
,45,Carl Söderberg,17,Malmö,F,31,12,18,30,14,2,4,76,-,-,22,22,0,19:21
,46,Mikael Håkanson,51,Linköping,F,53,12,18,30,72,1,2,105,-,-,32,30,2,17:13
,47,Mathias Månsson,41,Brynäs,F,48,14,15,29,66,1,5,84,-,-,25,22,3,16:52
,48,Richard Lintner,22,Skellefteå,D,52,9,20,29,46,2,6,163,-,-,29,42,-13,22:17
,49,Justin Morrison,15,MODO,F,34,18,10,28,38,2,6,79,-,-,27,18,9,15:37
,50,Dragan Umicevic,84,Djurgården,F,51,13,15,28,18,3,4,99,-,-,24,25,-1,14:54
,51,Andreas Holmqvist,7,Linköping,D,49,7,21,28,54,2,1,118,-,-,37,32,5,21:36
,52,Andreas Dackell,12,Brynäs,F,54,7,21,28,67,1,1,66,-,-,28,24,4,19:00
,53,Tobias Enström,37,MODO,D,55,7,21,28,52,1,5,113,-,-,36,32,4,21:15
,54,Nicholas Angell,18,Brynäs,D,49,14,13,27,62,5,8,130,-,-,29,24,5,20:48
,55,Eric Beaudoin,28,Mora,F,55,14,12,26,64,4,5,83,-,-,29,33,-4,17:17
,55,Martin Thörnberg,10,HV71,F,55,14,12,26,34,2,0,108,-,-,31,26,5,12:16
,57,Tim Eriksson,26,Linköping,F,54,10,16,26,32,1,1,94,-,-,28,24,4,14:14
,57,Lasse Pirjetä,11,Malmö,F,54,10,16,26,44,1,3,129,-,-,20,33,-13,17:43
,59,Jan Hrdina,24,HV71,F,41,7,19,26,66,1,4,64,-,-,23,33,-10,17:02
,60,Tommy Sjödin,7,Brynäs,D,50,6,20,26,66,1,3,133,-,-,46,26,20,0:31
,61,Andreas Jämtin,18,HV71,F,49,14,11,25,150,1,10,92,-,-,25,20,5,13:19
,62,Juha Riihijärvi,19,Malmö,F,51,11,14,25,18,0,7,81,-,-,17,34,-17,16:30
,63,Johan Lindström,79,Linköping,F,54,10,15,25,36,3,3,84,-,-,27,26,1,13:46
,64,Johan Andersson,17,Timrå,F,54,9,16,25,56,1,2,89,-,-,25,29,-4,17:34
,65,Fredrik Öberg,48,Skellefteå,F,37,8,17,25,42,0,1,53,-,-,18,18,0,15:50
,66,Per Gustafsson,7,HV71,D,52,7,18,25,56,3,4,96,-,-,41,35,6,21:10
,67,Kristofer Ottosson,9,Djurgården,F,51,12,12,24,26,2,2,108,-,-,30,28,2,20:41
,68,Per Ledin,97,Färjestad,F,55,9,15,24,148,1,4,83,-,-,24,17,7,17:02
,69,Björn Danielsson,23,Brynäs,F,54,7,17,24,46,1,3,55,-,-,26,27,-1,14:28
,70,Mikael Lind,36,Brynäs,F,42,14,9,23,36,2,5,77,-,-,16,19,-3,17:13
,71,Robert Döme,59,MODO,F,50,13,10,23,66,3,2,100,-,-,29,26,3,14:32
,72,Martin Cibak,8,Frölunda,F,55,10,13,23,94,1,3,59,-,-,27,24,3,14:44
,72,Jari Kauppila,33,HV71,F,55,10,13,23,22,1,2,91,-,-,23,30,-7,15:18
,74,Mikko Luoma,5,Linköping,D,55,7,16,23,60,1,2,138,-,-,42,36,6,22:16
,75,Pekka Saravo,14,Luleå,D,55,6,17,23,62,0,5,97,-,-,33,37,-4,21:22
,76,Johan Harju,24,Luleå,F,55,12,10,22,30,6,1,90,-,-,26,18,8,14:04
,76,Fredrik Emvall,33,Linköping,F,55,12,10,22,52,2,3,72,-,-,31,26,5,18:01
,78,Jimmie Ölvestad,19,Djurgården,F,54,9,13,22,104,0,5,124,-,-,20,26,-6,17:36
,79,Jan Sandström,7,Luleå,D,51,7,15,22,52,0,2,79,-,-,39,30,9,22:18
,80,Timmy Pettersson,33,Djurgården,D,52,7,15,22,62,1,2,88,-,-,34,36,-2,20:25
,81,Mathias Johansson,75,Färjestad,F,54,5,17,22,60,0,0,89,-,-,29,28,1,16:48
,82,Christian Söderström,82,Färjestad,F,53,11,10,21,36,2,1,79,-,-,22,20,2,12:13
,83,Anton Strålman,6,Timrå,D,53,10,11,21,34,2,9,140,-,-,27,35,-8,1:14
,84,Daniel Hermansson,22,Brynäs,F,50,8,13,21,24,1,4,91,-,-,19,13,6,12:43
,85,Oscar Steen,45,MODO,F,55,8,13,21,72,1,1,74,-,-,17,28,-11,16:23
,85,Johan Ramstedt,11,Skellefteå,F,55,8,13,21,24,2,0,84,-,-,27,29,-2,14:34
,85,Markus Matthiasson,92,Malmö,F,55,8,13,21,50,1,2,76,-,-,19,33,-14,17:06
,88,Nichlas Falk,16,Djurgården,F,54,7,14,21,40,1,2,55,-,-,23,26,-3,17:38
,89,Kenneth Bergqvist,41,Mora,F,42,6,15,21,8,1,2,46,-,-,14,19,-5,11:31
,90,Ove Molin,21,Brynäs,F,50,6,15,21,26,2,2,72,-,-,21,25,-4,15:14
,91,Miroslav Blatak,44,Mora,F,53,6,15,21,30,1,3,93,-,-,41,37,4,20:13
,92,David Petrasek,22,HV71,D,54,10,10,20,108,4,4,130,-,-,36,41,-5,23:00
,93,Andreas Salomonsson,15,MODO,F,30,9,11,20,24,4,0,75,-,-,24,11,13,18:35
,94,Eric Johansson,20,Mora,F,40,8,12,20,12,0,2,52,-,-,15,21,-6,15:41
,95,Karl Fabricius,52,Frölunda,F,55,8,12,20,47,1,2,127,-,-,22,23,-1,14:43
,95,Edvin Frylén,36,Malmö,D,55,8,12,20,36,1,5,93,-,-,28,49,-21,22:43
,97,Jason King,17,Skellefteå,F,55,15,4,19,20,2,5,172,-,-,23,32,-9,16:25
,98,Mads Hansen,24,Brynäs,F,54,8,11,19,32,3,0,82,-,-,31,19,12,17:00
,99,Pavel Skrbek,11,Luleå,D,44,5,14,19,54,1,2,68,-,-,34,27,7,21:08
,100,Morten Ask,21,Djurgården,F,49,5,14,19,62,1,2,86,-,-,21,23,-2,15:48
,100,Markus Seikola,21,Frölunda,D,49,5,14,19,46,1,5,112,-,-,14,22,-8,17:13
,102,Anders Burström,21,Luleå,F,53,4,15,19,62,0,1,48,-,-,21,19,2,15:47
,103,Martin Lindman,4,Djurgården,D,54,4,15,19,80,0,1,72,-,-,30,35,-5,19:01
,104,Stefan Pettersson,77,HV71,F,46,12,6,18,83,2,3,125,-,-,19,33,-14,14:08
,105,Miloslav Horava,28,MODO,F,55,9,9,18,30,3,1,121,-,-,30,24,6,15:02
,106,Per Hallin,8,Timrå,F,54,8,10,18,60,1,1,84,-,-,17,20,-3,12:56
,107,Fredrik Krekula,10,Skellefteå,F,55,8,10,18,52,2,0,82,-,-,28,34,-6,16:45
,108,Peter Öberg,27,MODO,F,48,6,12,18,44,1,1,57,-,-,18,20,-2,13:44
,109,Oscar Sundh,13,Timrå,F,52,6,12,18,80,0,2,81,-,-,17,22,-5,15:18
,110,Mattias Timander,3,MODO,D,55,6,12,18,90,0,3,89,-,-,46,36,10,22:48
,111,Jan-Axel Alavaara,55,Frölunda,D,54,5,13,18,80,2,1,60,-,-,38,35,3,18:17
,112,Mikael Simons,78,Mora,F,53,11,6,17,72,2,2,70,-,-,19,13,6,10:01
,113,Jiri Bicek,34,Brynäs,F,35,8,9,17,34,0,3,62,-,-,15,18,-3,14:31
,114,Robert Kantor,5,Färjestad,D,38,8,9,17,48,1,5,79,-,-,21,22,-1,20:21
,115,Linus Omark,67,Luleå,F,50,8,9,17,32,0,2,89,-,-,23,24,-1,13:22
,116,Peter Nolander,70,Brynäs,D,52,7,10,17,38,0,2,66,-,-,35,21,14,17:52
,117,Jimmie Ericsson,21,Skellefteå,F,52,6,11,17,72,1,2,77,-,-,21,26,-5,16:48
,118,Adam Masuhr,38,MODO,D,54,6,11,17,40,0,5,144,-,-,22,19,3,17:25
,119,Martin Jansson,77,Mora,F,55,6,11,17,26,0,1,68,-,-,23,21,2,13:03
,120,Riku Hahl,33,Timrå,F,31,4,13,17,16,2,2,43,-,-,17,18,-1,21:24
,121,Pontus Petterström,18,Skellefteå,F,50,10,6,16,38,3,0,78,-,-,26,30,-4,14:10
,122,Ulf Söderström,12,Linköping,F,41,9,7,16,36,3,1,59,-,-,20,16,4,15:14
,123,Peter Regin,13,Timrå,F,51,9,7,16,16,2,4,94,-,-,14,23,-9,17:04
,124,Timo Pärssinen,27,Timrå,F,27,8,8,16,26,4,3,64,-,-,14,8,6,16:39
,125,Mikael Johansson,85,Färjestad,F,55,7,9,16,42,0,0,58,-,-,20,18,2,11:29
,126,Pär Styf,36,Timrå,D,53,6,10,16,118,4,2,98,-,-,24,21,3,21:47
,127,Björn Svensson,26,Timrå,F,55,6,10,16,30,2,2,79,-,-,16,18,-2,13:23
,128,Daniel Fernholm,24,Djurgården,D,32,4,12,16,16,1,4,52,-,-,21,15,6,20:45
,129,Anders Nilsson,43,Mora,F,48,4,12,16,16,0,0,61,-,-,23,17,6,12:32
,130,Andreas Thuresson,12,Malmö,F,48,10,5,15,26,1,2,87,-,-,21,19,2,11:12
,131,Mika Hannula,33,HV71,F,18,9,6,15,64,2,2,61,-,-,16,8,8,18:44
,132,Daniel Welser,20,Skellefteå,F,51,9,6,15,48,2,2,64,-,-,21,21,0,12:49
,133,Mikael Pettersson,19,MODO,F,55,8,7,15,53,1,3,90,-,-,16,22,-6,13:50
,134,Tomas Vlasak,21,Linköping,F,22,7,8,15,4,1,2,46,-,-,12,15,-3,13:48
,135,Jesse Niinimäki,8,Luleå,F,37,7,8,15,20,2,0,50,-,-,14,15,-1,14:36
,136,Thomas Johansson,18,Djurgården,D,44,4,11,15,30,3,3,67,-,-,30,25,5,21:49
,137,Emil Kåberg,27,Färjestad,F,55,7,7,14,106,0,0,77,-,-,20,12,8,13:13
,138,Andrej Nedorost,28,/,F,35,6,8,14,30,3,0,46,-,-,14,24,-10,14:01
,139,Andreas Falk,19,HV71,F,55,6,8,14,63,0,0,58,-,-,22,21,1,13:17
,140,Ronnie Sundin,23,Frölunda,D,55,5,9,14,60,0,5,76,-,-,29,36,-7,23:04
,141,Jyrki Välivaara,39,/,D,42,3,11,14,44,1,2,56,-,-,21,21,0,20:17
,142,Antti-Jussi Niemi,7,Frölunda,D,48,3,11,14,110,0,2,71,-,-,33,33,0,20:42
,143,Fredrik Eriksson,8,Malmö,D,25,2,12,14,10,0,0,37,-,-,11,14,-3,16:57
,144,Petri Kokko,32,Timrå,D,51,2,12,14,52,0,1,90,-,-,25,27,-2,19:58
,145,Brett Harkins,44,Skellefteå,F,32,1,13,14,18,0,1,24,-,-,4,10,-6,13:44
,146,Lubomir Sekeras,77,Malmö,D,23,3,10,13,28,0,2,22,-,-,13,10,3,20:06
,147,Jaroslav Balastik,31,HV71,F,25,3,10,13,4,0,2,75,-,-,16,20,-4,16:01
,148,Magnus Kahnberg,11,Frölunda,F,26,3,10,13,8,1,0,51,-,-,12,13,-1,11:58
,149,Hans Jonsson,5,MODO,D,44,3,10,13,86,0,1,37,-,-,30,28,2,17:59
,150,Andreas Johansson,10,Färjestad,F,19,2,11,13,20,0,2,34,-,-,8,10,-2,16:59
,151,Marcus Paulsson,53,Malmö,F,50,9,3,12,51,2,3,54,-,-,15,23,-8,11:38
,152,Sami Torkki,25,Linköping,F,43,8,4,12,161,1,2,72,-,-,19,18,1,13:11
,153,Christian Eklund,20,Djurgården,F,49,7,5,12,67,1,0,73,-,-,17,25,-8,15:34
,154,Linus Fagemo,,Malmö,F,51,6,6,12,28,0,0,95,-,-,14,19,-5,14:15
,154,Jens Svensson,22,HV71,F,51,6,6,12,22,0,0,32,-,-,18,12,6,7:17
,156,Ivan Huml,36,Mora,F,32,5,7,12,24,3,1,50,-,-,11,16,-5,15:56
,157,Anton Axelsson,6,Frölunda,F,52,5,7,12,14,0,1,36,-,-,13,13,0,8:31
,158,Timo Vertala,37,HV71,F,50,4,8,12,40,0,0,51,-,-,22,25,-3,12:23
,159,Markku Tähtinen,39,Skellefteå,F,52,3,9,12,46,0,0,29,-,-,16,19,-3,10:37
,160,Robert Carlsson,12,Timrå,F,37,2,10,12,34,0,0,34,-,-,16,7,9,13:24
,161,Kari Haakana,32,Skellefteå,D,43,1,11,12,56,0,0,24,-,-,31,31,0,17:07
,162,Peter Nylander,11,Timrå,F,42,10,1,11,32,2,4,62,-,-,13,11,2,12:59
,163,Johannes Salmonsson,25,Brynäs,F,45,8,3,11,28,2,1,37,-,-,11,7,4,7:54
,164,Nicklas Danielsson,74,Djurgården,F,50,6,5,11,30,3,3,69,-,-,9,13,-4,8:14
,165,Johan Ryno,61,/,F,39,5,6,11,22,0,3,37,-,-,8,14,-6,9:06
,166,Daniel Glimmenvall,6,Brynäs,D,53,5,6,11,52,1,3,75,-,-,26,25,1,21:43
,167,Sanny Lindström,8,Timrå,D,42,4,7,11,88,0,1,52,-,-,25,23,2,20:25
,168,Jonas Almtorp,16,Brynäs,F,46,4,7,11,30,0,0,49,-,-,16,14,2,11:03
,169,Oscar Ackeström,25,/,D,54,4,7,11,70,0,3,80,-,-,36,30,6,19:10
,170,Magnus Nilsson,24,Timrå,F,40,3,8,11,40,0,0,59,-,-,11,10,1,9:47
,171,Daniel Sondell,50,Skellefteå,D,52,3,8,11,18,0,3,58,-,-,21,20,1,16:10
,172,Roger Åkerström,28,Luleå,D,47,2,9,11,42,0,1,37,-,-,35,28,7,18:23
,173,Jarno Kultanen,21,Mora,D,55,2,9,11,64,0,1,70,-,-,26,42,-16,22:48
,174,Mikko Laine,14,Timrå,F,33,7,3,10,6,1,0,37,-,-,11,10,1,7:55
,175,Lance Ward,47,HV71,D,50,6,4,10,273,1,0,47,-,-,24,28,-4,14:27
,176,Thomas Larsson,24,Skellefteå,F,46,5,5,10,12,0,0,26,-,-,11,8,3,5:31
,177,Jiri Marusak,29,Djurgården,D,19,4,6,10,14,1,2,47,-,-,11,7,4,21:50
,178,Jussi Tarvainen,40,Malmö,F,24,4,6,10,24,1,1,42,-,-,9,12,-3,18:03
,179,Arto Tukio,8,Frölunda,D,50,2,8,10,36,0,1,63,-,-,19,27,-8,19:11
,180,Antti Bruun,33,Mora,D,53,2,8,10,38,1,1,37,-,-,30,23,7,15:29
,181,Jan Öberg,9,Malmö,F,55,0,10,10,58,0,0,41,-,-,26,32,-6,16:07
,182,Mattias Remstam,75,HV71,F,45,5,4,9,40,1,2,46,-,-,16,19,-3,14:03
,183,Mikko Kurvinen,4,Mora,D,47,4,5,9,49,0,2,57,-,-,17,31,-14,19:31
,184,Pierre Johnsson,2,Mora,D,48,4,5,9,30,1,2,35,-,-,24,31,-7,17:46
,185,Ari Vallin,11,Frölunda,D,23,3,6,9,20,0,1,12,-,-,29,14,15,15:36
,186,Niklas Olausson,16,Linköping,F,38,3,6,9,12,2,0,18,-,-,15,8,7,6:56
,187,Marcus Kristoffersson,38,Skellefteå,F,48,3,6,9,108,1,1,61,-,-,8,15,-7,9:41
,188,Jonas Esbjörs,22,Frölunda,F,54,3,6,9,24,1,0,53,-,-,15,18,-3,12:31
,189,Per-Anton Lundström,8,Skellefteå,D,54,2,7,9,74,0,0,54,-,-,27,27,0,18:13
,190,Oscar Hedman,41,MODO,D,55,2,7,9,42,0,1,65,-,-,29,30,-1,15:25
,191,David Moravec,22,Malmö,F,30,1,8,9,22,0,1,43,-,-,6,19,-13,16:21
,192,Ryan Jardine,15,Mora,F,51,1,8,9,28,0,0,39,-,-,8,16,-8,6:40
,193,Erik Andersson,11,HV71,F,31,0,9,9,14,0,0,28,-,-,12,10,2,11:36
,194,Christopher Thörn,34,Djurgården,F,46,4,4,8,20,0,1,24,-,-,10,9,1,6:15
,195,Jonas Frögren,24,Färjestad,D,53,4,4,8,40,0,2,38,-,-,20,23,-3,17:15
,196,Robin Jonsson,39,Färjestad,D,35,3,5,8,44,1,1,33,-,-,11,12,-1,17:58
,197,Tomas Skogs,23,Mora,D,44,3,5,8,62,1,2,40,-,-,25,23,2,19:38
,198,Mikael Johansson,21,Malmö,F,50,3,5,8,28,0,0,30,-,-,13,20,-7,11:50
,198,Lars-Erik Spets,27,Brynäs,F,50,3,5,8,10,1,0,24,-,-,9,6,3,8:31
,200,Sebastian Karlsson,12,Brynäs,F,52,3,5,8,26,0,1,37,-,-,11,11,0,9:41
,200,Tero Määttä,22,Mora,D,52,3,5,8,56,1,1,29,-,-,27,23,4,13:51
,202,Tobias Viklund,16,MODO,D,55,3,5,8,28,2,0,65,-,-,36,23,13,15:47
,203,Kimmo Lotvonen,29,Timrå,D,30,2,6,8,26,0,1,39,-,-,11,19,-8,22:45
,204,Pasi Tuominen,11,MODO,F,22,5,2,7,2,1,3,35,-,-,5,8,-3,9:47
,205,Kalle Kerman,23,Luleå,F,46,5,2,7,10,1,1,77,-,-,11,17,-6,12:06
,206,Marco Tuokko,13,Mora,F,39,4,3,7,122,1,0,64,-,-,11,21,-10,12:07
,207,Daniel Widing,41,Brynäs,F,31,3,4,7,32,1,1,32,-,-,8,12,-4,7:57
,208,Daniel Grillfors,32,HV71,D,50,2,5,7,18,0,0,33,-,-,24,29,-5,11:37
,209,Duane Harmer,28,Skellefteå,D,11,1,6,7,10,0,1,19,-,-,1,10,-9,21:47
,210,Atvars Tribuncovs,32,Färjestad,D,16,1,6,7,34,0,0,18,-,-,12,8,4,19:00
,211,Pierre Hedin,21,MODO,D,31,0,7,7,30,0,0,30,-,-,18,16,2,19:43
,212,Martin Samuelsson,14,Linköping,F,33,4,2,6,14,1,0,27,-,-,7,6,1,6:35
,213,Fredrik Lindgren,61,Skellefteå,D,52,3,3,6,52,0,1,73,-,-,29,27,2,23:46
,214,Viktor Lindgren,10,Luleå,F,53,3,3,6,10,1,0,38,-,-,12,13,-1,8:35
,215,Jörgen Sundqvist,22,Brynäs,D,55,3,3,6,60,0,0,47,-,-,26,34,-8,17:37
,216,Fedor Fedorov,81,Malmö,F,8,2,4,6,51,0,0,15,-,-,4,3,1,17:16
,217,Kristian Kuusela,17,MODO,F,11,2,4,6,8,0,0,27,-,-,4,6,-2,15:36
,218,Ross Lupaschuk,8,Malmö,D,18,2,4,6,51,0,1,34,-,-,7,17,-10,22:12
,219,Jonas Liwing,23,Djurgården,D,34,2,4,6,22,0,2,26,-,-,14,17,-3,18:50
,220,Jason Woolley,7,Malmö,D,31,1,5,6,46,0,1,26,-,-,16,16,0,20:34
,221,Fredrik Olausson,20,Färjestad,F,12,0,6,6,6,0,0,9,-,-,10,6,4,16:56
,222,Johan Fransson,10,/,D,43,0,6,6,22,0,0,37,-,-,16,17,-1,10:10
,223,Ronnie Pettersson,6,Djurgården,D,51,0,6,6,68,0,0,39,-,-,24,19,5,18:44
,224,Mika Niskanen,99,Timrå,D,13,3,2,5,14,1,2,11,-,-,2,9,-7,18:38
,225,Alexander Ribbenstrand,7,Djurgården,D,45,2,3,5,60,0,0,10,-,-,8,14,-6,9:32
,226,Johan Björk,55,Malmö,D,46,2,3,5,59,1,1,52,-,-,18,32,-14,18:10
,227,Per Savilahti-Nagander,,Luleå,D,55,2,3,5,44,0,1,18,-,-,16,13,3,8:24
,228,Janne Hauhtonen,15,Brynäs,F,9,1,4,5,6,0,1,19,-,-,2,6,-4,15:46
,229,Milan Bartovic,27,Malmö,F,24,1,4,5,26,0,0,33,-,-,10,17,-7,11:13
,230,Christopher Kelleher,4,Linköping,F,25,1,4,5,24,0,1,30,-,-,11,5,6,15:22
,231,Per Åslund,22,Färjestad,F,34,1,4,5,6,0,0,22,-,-,5,7,-2,7:14
,232,Robin Lindqvist,22,Luleå,F,35,1,4,5,18,0,0,30,-,-,12,10,2,12:25
,233,Jonas Junland,44,Linköping,D,41,1,4,5,22,1,1,55,-,-,15,18,-3,11:43
,234,Fredrik Johansson,12,Frölunda,F,53,1,4,5,20,0,0,24,-,-,7,14,-7,7:01
,235,Jonathan Granström,31,Mora,F,50,3,1,4,18,1,1,38,-,-,6,17,-11,10:16
,236,Carl Gunnarsson,6,Linköping,D,30,2,2,4,8,0,0,27,-,-,11,8,3,12:21
,237,Antti Hulkkonen,5,Brynäs,D,32,2,2,4,36,1,0,26,-,-,7,13,-6,12:52
,238,Stefan Erkgärds,4,Färjestad,D,42,2,2,4,22,0,0,26,-,-,15,10,5,9:07
,239,Mattias Wennerberg,26,Timrå,F,24,1,3,4,14,0,1,22,-,-,3,8,-5,7:12
,240,Andreas Engqvist,21,Djurgården,F,43,1,3,4,16,0,0,30,-,-,9,4,5,6:51
,241,Jonas Ahnelöv,55,Frölunda,D,46,1,3,4,20,0,0,15,-,-,10,6,4,7:59
,242,Johan Motin,57,Färjestad,D,22,0,4,4,8,0,0,9,-,-,11,7,4,13:09
,243,Christofer Löfberg,44,Djurgården,F,34,0,4,4,6,0,0,7,-,-,4,5,-1,4:06
,244,Libor Prochazka,55,Skellefteå,F,43,0,4,4,73,0,0,27,-,-,18,22,-4,16:15
,245,Magnus Isaksson,9,Luleå,F,50,0,4,4,28,0,0,26,-,-,8,16,-8,9:07
,246,Zdenek Blatny,23,MODO,F,16,2,1,3,44,0,0,37,-,-,4,7,-3,15:21
,247,Daniel Casselståhl,52,/,D,30,2,1,3,22,0,0,21,-,-,11,9,2,13:10
,248,Vladimir Sicak,24,Malmö,D,10,1,2,3,2,0,0,9,-,-,5,4,1,17:00
,248,Pat Kavanagh,26,HV71,F,10,1,2,3,6,1,0,9,-,-,3,6,-3,14:40
,250,Antti Virtanen,42,Skellefteå,F,9,0,3,3,2,0,0,13,-,-,3,0,3,10:27
,251,Jonas Westerling,93,Malmö,F,18,0,3,3,0,0,0,0,-,-,4,5,-1,4:10
,252,Fredrik Bergquist,22,Skellefteå,D,36,0,3,3,20,0,0,15,-,-,6,10,-4,7:16
,253,Johan Norgren,45,Malmö,D,40,0,3,3,32,0,0,20,-,-,5,18,-13,10:51
,254,Johan Svedberg,7,Timrå,D,42,0,3,3,78,0,0,26,-,-,17,17,0,13:56
,255,Erik Ersberg,40,HV71,Gk,54,0,3,3,16,0,0,0,-,-,76,73,3,0:00
,256,Markus Schlacher,14,Skellefteå,F,9,2,0,2,0,0,1,3,-,-,1,1,0,3:07
,257,Niklas Hjalmarsson,28,HV71,D,37,2,0,2,24,0,0,27,-,-,9,13,-4,10:21
,258,Radek Duda,69,Malmö,F,9,1,1,2,20,0,1,16,-,-,1,3,-2,13:02
,259,Martin Johansson,25,Färjestad,F,14,1,1,2,0,1,0,11,-,-,4,3,1,11:06
,260,Patrik Hersley,6,Malmö,D,28,1,1,2,10,0,0,26,-,-,2,4,-2,7:47
,261,Nicklas Jadeland,55,Malmö,F,33,1,1,2,8,0,0,10,-,-,5,7,-2,3:19
,262,Mikael Lidhammar,20,Luleå,F,18,0,2,2,4,0,0,5,-,-,2,4,-2,3:42
,263,Rami Alanko,3,Färjestad,D,19,0,2,2,20,0,0,15,-,-,7,4,3,10:58
,264,Tomas Wallgren,8,Luleå,F,21,0,2,2,20,0,0,25,-,-,4,6,-2,9:37
,265,Paul Healey,19,Linköping,F,24,0,2,2,22,0,0,35,-,-,5,9,-4,11:02
,266,Mikko Pukka,8,Luleå,D,32,0,2,2,46,0,0,22,-,-,14,22,-8,15:58
,267,Rodrigo Lavins,32,Brynäs,D,43,0,2,2,42,0,0,35,-,-,14,19,-5,15:07
,267,Andreas Molinder,24,MODO,F,43,0,2,2,8,0,0,22,-,-,7,9,-2,6:27
,269,Ivan Majesky,26,Linköping,D,46,0,2,2,83,0,0,66,-,-,28,19,9,17:07
,270,Tero Leinonen,1,Luleå,Gk,54,0,2,2,2,0,0,0,-,-,53,49,4,0:00
,271,Jonathan Carlsson,36,Brynäs,D,6,1,0,1,2,0,0,1,-,-,1,1,0,2:06
,272,Jyri Marttinen,58,Malmö,D,7,1,0,1,28,0,1,24,-,-,5,5,0,21:25
,272,Erik Lindhagen,29,Linköping,F,7,1,0,1,0,0,0,3,-,-,2,1,1,3:41
,274,Henrik Eriksson,37,HV71,F,10,1,0,1,2,0,0,6,-,-,1,5,-4,4:35
,275,Kalle Koskinen,9,Timrå,D,28,1,0,1,42,0,1,24,-,-,11,10,1,18:38
,276,Atte Pentikäinen,15,Färjestad,D,44,1,0,1,60,0,0,21,-,-,8,11,-3,11:51
,277,Cristian Swärd,23,Färjestad,F,4,0,1,1,2,0,0,4,-,-,2,1,1,5:48
,278,Johan Halvardsson,27,HV71,D,8,0,1,1,10,0,0,7,-,-,4,2,2,15:42
,279,Patrik Cedergren,28,Mora,D,9,0,1,1,2,0,0,2,-,-,2,0,2,6:22
,279,Martin Öhrstedt,11,Linköping,D,9,0,1,1,4,0,0,6,-,-,2,1,1,11:15
,281,Robert Tomik,44,Malmö,F,11,0,1,1,4,0,0,14,-,-,0,3,-3,7:57
,281,Per Johnsson,3,Färjestad,D,11,0,1,1,0,0,0,4,-,-,2,0,2,4:05
,283,David Fredriksson,54,HV71,F,12,0,1,1,4,0,0,7,-,-,1,6,-5,7:24
,284,Pavel Trnka,26,Malmö,D,20,0,1,1,36,0,0,21,-,-,11,17,-6,18:05
,285,Daniel Wessner,62,Mora,F,27,0,1,1,30,0,0,11,-,-,2,6,-4,6:11
,285,Ola Svanberg,4,HV71,D,27,0,1,1,6,0,0,5,-,-,7,7,0,8:00
,287,Marcus Nyberg,2,Luleå,D,40,0,1,1,18,0,0,9,-,-,7,7,0,6:19
,288,Eric Moe,9,Timrå,D,44,0,1,1,12,0,0,12,-,-,13,17,-4,7:55
,288,Roman Cechmanek,22,Linköping,Gk,44,0,1,1,24,0,0,0,-,-,44,44,0,0:00
,290,Patric Blomdahl,84,Linköping,F,47,0,1,1,106,0,0,46,-,-,8,7,1,8:14
,291,Robert Kristan,1,Brynäs,Gk,48,0,1,1,6,0,0,0,-,-,56,44,12,0:00
,292,Daniel Larsson,,Djurgården,Gk,49,0,1,1,0,0,0,0,-,-,33,36,-3,0:00
,293,Christopher Heino-Lindberg,40,Färjestad,Gk,50,0,1,1,0,0,0,0,-,-,33,26,7,0:00
,294,Henrik Malmström,9,/,F,51,0,1,1,16,0,0,40,-,-,4,8,-4,5:30
,295,Mattias Modig,33,Luleå,Gk,52,0,1,1,2,0,0,0,-,-,55,49,6,0:00
,296,Teemu Lassila,35,Djurgården,Gk,55,0,1,1,14,0,0,0,-,-,57,48,9,0:00
,296,Jonas Fransson,32,Linköping,Gk,55,0,1,1,0,0,0,5,-,-,44,33,11,0:00
,296,Karol Krizan,60,MODO,Gk,55,0,1,1,8,0,0,0,-,-,102,73,29,0:00
,299,Joakim Larson,18,Linköping,D,1,0,0,0,0,0,0,0,-,-,0,0,0,0:00
,299,Henrik Bankelius,13,Linköping,F,1,0,0,0,0,0,0,0,-,-,0,0,0,0:00
,299,Robin Gartner,2,HV71,D,1,0,0,0,0,0,0,0,-,-,0,0,0,0:00
,299,Mikael Ahlén,13,Djurgården,F,1,0,0,0,0,0,0,0,-,-,0,0,0,0:00
,299,Christoffer Bengtsberg,,HV71,Gk,1,0,0,0,0,0,0,0,-,-,0,0,0,0:00
,299,Henrik Olsson,45,Timrå,D,1,0,0,0,0,0,0,0,-,-,0,0,0,0:00
,299,,,Skellefteå,,1,0,0,0,0,0,0,1,-,-,1,0,1,12:51
,299,Joakim Andersson,18,Frölunda,F,1,0,0,0,0,0,0,0,-,-,0,0,0,0:00
,299,Isaac Haag,41,Frölunda,F,1,0,0,0,0,0,0,0,-,-,0,0,0,0:00
,299,Fredrik Gräsvik,29,Skellefteå,Gk,1,0,0,0,0,0,0,0,-,-,0,0,0,0:00
,299,Henrik Björklund,14,Färjestad,F,1,0,0,0,0,0,0,2,-,-,0,0,0,10:01
,299,Markus Bergkvist,11,Linköping,D,1,0,0,0,0,0,0,0,-,-,0,0,0,0:00
,299,Linus Persson,25,Djurgården,F,1,0,0,0,0,0,0,0,-,-,0,0,0,1:16
,299,Christoffer From-Björk,28,Djurgården,D,1,0,0,0,2,0,0,1,-,-,0,1,-1,6:04
,299,Andro Michel,40,Färjestad,Gk,1,0,0,0,0,0,0,0,-,-,0,0,0,0:00
,299,Marcus Götz,2,Brynäs,D,1,0,0,0,0,0,0,1,-,-,0,2,-2,11:41
,299,Jimmy Jensen,3,Djurgården,F,1,0,0,0,0,0,0,0,-,-,0,0,0,4:00
,299,Vladimir Machulda,99,Timrå,F,1,0,0,0,0,0,0,0,-,-,0,0,0,2:46
,317,Jim Karlsson,26,Luleå,Gk,2,0,0,0,0,0,0,0,-,-,0,1,-1,0:00
,317,Mikkel Bödker,27,Frölunda,F,2,0,0,0,0,0,0,0,-,-,0,0,0,2:08
,317,Sebastian Erixon,50,Timrå,D,2,0,0,0,0,0,0,0,-,-,0,0,0,7:24
,317,Andreas Andersson,54,Frölunda,Gk,2,0,0,0,0,0,0,0,-,-,0,0,0,0:00
,317,David Rautio,30,Luleå,Gk,2,0,0,0,0,0,0,0,-,-,0,0,0,0:00
,317,Jesper Backlund,1,Timrå,Gk,2,0,0,0,0,0,0,0,-,-,0,0,0,0:00
,317,Mats Lavander,62,Luleå,F,2,0,0,0,0,0,0,4,-,-,0,1,-1,15:28
,317,Emil Axelsson,8,Linköping,D,2,0,0,0,0,0,0,1,-,-,0,1,-1,2:04
,317,Nicholas Philips,70,Mora,F,2,0,0,0,0,0,0,0,-,-,0,0,0,0:00
,317,Erik Karlberg,28,Skellefteå,F,2,0,0,0,0,0,0,0,-,-,0,0,0,0:16
,317,Martin Ylvén Laumann,99,Linköping,D,2,0,0,0,0,0,0,0,-,-,0,1,-1,0:18
,317,Kim Sunna,27,Brynäs,F,2,0,0,0,0,0,0,0,-,-,0,1,-1,3:30
,317,Patrik Magnusson,77,HV71,D,2,0,0,0,0,0,0,0,-,-,0,0,0,0:00
,330,Victor Ringberg,8,Linköping,D,3,0,0,0,0,0,0,1,-,-,0,0,0,0:45
,330,Emil Bejmo,13,Färjestad,F,3,0,0,0,0,0,0,0,-,-,0,0,0,1:24
,330,Jere Myllyniemi,35,Frölunda,Gk,3,0,0,0,0,0,0,0,-,-,0,0,0,0:00
,330,Erik Belin,91,Brynäs,D,3,0,0,0,0,0,0,0,-,-,0,0,0,0:01
,330,Victor Tisell,35,Malmö,Gk,3,0,0,0,0,0,0,0,-,-,0,0,0,0:00
,330,Oskar Johansson,46,Timrå,F,3,0,0,0,0,0,0,0,-,-,0,0,0,0:00
,330,Sebastian Eriksson,31,Brynäs,D,3,0,0,0,0,0,0,0,-,-,0,0,0,0:45
,330,Lukas Ericsson,53,HV71,F,3,0,0,0,0,0,0,0,-,-,0,0,0,1:57
,330,Patrik Wallon,7,Skellefteå,D,3,0,0,0,0,0,0,0,-,-,0,0,0,0:02
,330,Levente Szuper,99,Malmö,Gk,3,0,0,0,0,0,0,0,-,-,3,5,-2,0:00
,330,Richard Gynge,10,Brynäs,F,3,0,0,0,0,0,0,0,-,-,0,0,0,0:16
,341,Alexander Larsson,20,Timrå,F,4,0,0,0,0,0,0,0,-,-,0,2,-2,3:30
,341,Pontus Hansson,42,Frölunda,Gk,4,0,0,0,0,0,0,0,-,-,0,0,0,0:00
,341,Magnus Nyberg,18,Timrå,D,4,0,0,0,0,0,0,0,-,-,0,0,0,0:00
,344,Niclas Levein,23,Färjestad,D,5,0,0,0,0,0,0,0,-,-,1,0,1,3:01
,344,Niklas Sjölund,39,Timrå,F,5,0,0,0,0,0,0,1,-,-,0,2,-2,1:19
,344,Philip Larsen,3,Frölunda,D,5,0,0,0,0,0,0,0,-,-,2,1,1,6:25
,344,Niklas Sjödin,27,MODO,D,5,0,0,0,0,0,0,0,-,-,0,0,0,0:26
,348,Stefan Ridderwall,39,Djurgården,Gk,6,0,0,0,0,0,0,0,-,-,0,0,0,0:00
,348,Tomas Slovak,54,Mora,D,6,0,0,0,51,0,0,3,-,-,0,0,0,4:12
,348,Daniel Ström,15,Brynäs,D,6,0,0,0,14,0,0,4,-,-,2,5,-3,10:12
,348,Alexander Hermansson,30,Färjestad,Gk,6,0,0,0,0,0,0,0,-,-,0,0,0,0:00
,352,Marcus Johansson,18,Luleå,F,7,0,0,0,0,0,0,0,-,-,0,0,0,2:03
,352,Lars Johansson,1,Mora,Gk,7,0,0,0,0,0,0,0,-,-,0,0,0,0:00
,354,Anders Lindbäck,39,Brynäs,Gk,8,0,0,0,0,0,0,0,-,-,0,0,0,0:00
,354,Kimmo Kapanen,35,HV71,Gk,8,0,0,0,0,0,0,0,-,-,4,8,-4,0:00
,354,Johan Erkgärds,77,Färjestad,F,8,0,0,0,0,0,0,2,-,-,0,2,-2,2:38
,354,Anders Danielsson,70,Mora,D,8,0,0,0,4,0,0,3,-,-,2,0,2,5:46
,358,Mattias Erlander,1,MODO,Gk,9,0,0,0,0,0,0,0,-,-,0,2,-2,0:00
,358,Patrik Lundh,79,Djurgården,F,9,0,0,0,2,0,0,4,-,-,0,1,-1,2:15
,358,Dennis Persson,29,Djurgården,D,9,0,0,0,2,0,0,3,-,-,1,1,0,2:45
,358,Nicklas Dahlberg,30,Skellefteå,Gk,9,0,0,0,0,0,0,0,-,-,3,1,2,0:00
,362,Tomas Sinisalo,44,Malmö,F,10,0,0,0,2,0,0,5,-,-,0,2,-2,10:08
,363,Simon Skoog,98,Malmö,D,11,0,0,0,4,0,0,2,-,-,1,2,-1,4:59
,363,Magnus Åkerlund,1,HV71,Gk,11,0,0,0,0,0,0,0,-,-,1,0,1,0:00
,363,Henrik Österholm,21,Timrå,D,11,0,0,0,0,0,0,0,-,-,0,0,0,2:07
,366,Linus Morin,29,Brynäs,D,14,0,0,0,4,0,0,5,-,-,1,4,-3,6:04
,366,André Hult,23,Mora,F,14,0,0,0,2,0,0,0,-,-,0,2,-2,0:47
,366,Tommy Wargh,86,MODO,D,14,0,0,0,2,0,0,5,-,-,1,4,-3,6:49
,369,Patrik Carlsson,72,Frölunda,F,16,0,0,0,4,0,0,8,-,-,2,4,-2,6:32
,370,Oscar Eklund,16,Djurgården,D,17,0,0,0,0,0,0,1,-,-,0,2,-2,3:44
,371,Christian Sjögren,14,Djurgården,F,18,0,0,0,33,0,0,4,-,-,1,1,0,3:27
,371,Magnus Gästrin,40,MODO,F,18,0,0,0,18,0,0,7,-,-,0,5,-5,6:13
,373,Markus Korhonen,1,Malmö,Gk,20,0,0,0,0,0,0,0,-,-,20,28,-8,0:00
,373,Niklas Öhman,43,MODO,D,20,0,0,0,2,0,0,3,-,-,1,1,0,2:05
,375,Tomi Pettinen,25,Frölunda,D,27,0,0,0,14,0,0,12,-,-,4,7,-3,9:57
,376,Johan Alcén,14,Brynäs,F,32,0,0,0,0,0,0,7,-,-,3,1,2,3:23
,377,Scott Langkow,40,HV71,Gk,36,0,0,0,0,0,0,0,-,-,28,27,1,0:00
,378,Johan Nilsson,33,MODO,F,41,0,0,0,6,0,0,15,-,-,1,5,-4,3:10
,379,Michal Zajkowski,30,MODO,Gk,46,0,0,0,0,0,0,0,-,-,8,15,-7,0:00
,379,Gustaf Wesslau,32,Malmö,Gk,46,0,0,0,0,0,0,0,-,-,12,23,-11,0:00
,381,Andreas Hadelöv,1,Skellefteå,Gk,48,0,0,0,0,0,0,0,-,-,63,62,1,0:00
,381,Per Helmersson,5,Skellefteå,D,48,0,0,0,59,0,0,19,-,-,11,14,-3,8:00
,383,Rastislav Stana,31,/,Gk,49,0,0,0,18,0,0,0,-,-,59,72,-13,0:00
,384,Joel Gistedt,31,Frölunda,Gk,50,0,0,0,0,0,0,0,-,-,66,51,15,0:00
,384,Mikko Rämö,35,Mora,Gk,50,0,0,0,0,0,0,1,-,-,17,31,-14,0:00
,386,Fredrik Ericson,38,Djurgården,D,51,0,0,0,32,0,0,12,-,-,5,11,-6,7:52
,386,Mattias Hellström,4,MODO,F,51,0,0,0,4,0,0,22,-,-,6,11,-5,7:33
,386,Tommy Salo,31,Frölunda,Gk,51,0,0,0,10,0,0,1,-,-,33,44,-11,0:00
,389,Dave Stathos,75,Skellefteå,Gk,52,0,0,0,2,0,0,0,-,-,21,36,-15,0:00
,390,Juha Pitkämäki,31,Mora,Gk,53,0,0,0,4,0,0,0,-,-,77,66,11,0:00
,391,Daniel Henriksson,40,Färjestad,Gk,54,0,0,0,6,0,0,0,-,-,76,60,16,0:00
,391,Johan Backlund,26,Timrå,Gk,54,0,0,0,2,0,0,5,-,-,65,69,-4,0:00
,391,Johan Asplund,35,Timrå,Gk,54,0,0,0,0,0,0,0,-,-,12,14,-2,0:00
,391,Daniel Sperrle,1,Brynäs,Gk,54,0,0,0,2,0,0,0,-,-,38,42,-4,0:00
,1,Andreas Karlsson,28,HV71,F,50,26,29,55,30,9,6,0,0,0,0,0,0,0:00
,2,Tomi Kallio,71,Frölunda,F,49,26,25,51,68,10,8,0,0,0,0,0,0,0:00
,3,Niklas Andersson,24,Frölunda,F,50,13,38,51,53,4,5,0,0,0,0,0,0,0:00
,4,Fredrik Bremberg,73,Djurgården,F,49,14,35,49,6,1,4,0,0,0,0,0,0,0:00
,5,Tony Mårtensson,9,Linköping,F,49,16,30,46,32,4,3,0,0,0,0,0,0,0:00
,6,Jonas Nordquist,39,Luleå,F,46,19,22,41,30,5,7,0,0,0,0,0,0,0:00
,7,Stefan Pettersson,77,HV71,F,45,18,22,40,59,1,10,0,0,0,0,0,0,0:00
,8,Lubos Bartecko,23,Luleå,F,50,14,26,40,32,3,7,0,0,0,0,0,0,0:00
,9,Jonas Johnson,30,Frölunda,F,49,20,17,37,36,2,12,0,0,0,0,0,0,0:00
,10,Björn Melin,9,HV71,F,49,17,19,36,48,4,9,0,0,0,0,0,0,0:00
,11,Patrick Thoresen,41,Djurgården,F,50,17,19,36,44,1,5,0,0,0,0,0,0,0:00
,12,Daniel Rudslätt,14,Djurgården,F,47,14,22,36,20,2,3,0,0,0,0,0,0,0:00
,13,Johan Davidsson,76,HV71,F,50,14,22,36,16,2,5,0,0,0,0,0,0,0:00
,14,Mikael Renberg,19,Luleå,F,44,15,19,34,32,5,8,0,0,0,0,0,0,0:00
,15,Magnus Kahnberg,11,Frölunda,F,45,18,15,33,26,2,1,0,0,0,0,0,0,0:00
,16,Jörgen Jönsson,21,Färjestad,F,48,17,16,33,60,5,5,0,0,0,0,0,0,0:00
,17,Jesper Mattsson,26,Färjestad,F,45,19,13,32,50,5,9,0,0,0,0,0,0,0:00
,18,Mathias Johansson,75,Färjestad,F,47,16,16,32,30,2,5,0,0,0,0,0,0,0:00
,19,Eric Johansson,20,Mora,F,50,13,19,32,40,3,3,0,0,0,0,0,0,0:00
,20,Ulf Söderström,12,Linköping,F,50,11,21,32,61,2,1,0,0,0,0,0,0,0:00
,21,Rastislav Pavlikovsky,14,MODO,F,48,10,22,32,42,0,1,0,0,0,0,0,0,0:00
,22,Joel Lundqvist,20,Frölunda,F,49,10,22,32,87,2,4,0,0,0,0,0,0,0:00
,23,Mika Hannula,33,HV71,F,45,13,18,31,62,3,3,0,0,0,0,0,0,0:00
,24,Ross Lupaschuk,8,Mora,D,49,13,18,31,168,1,6,0,0,0,0,0,0,0:00
,25,Andreas Salomonsson,15,MODO,F,46,12,19,31,105,1,4,0,0,0,0,0,0,0:00
,26,Per Gustafsson,7,HV71,D,48,6,25,31,48,2,2,0,0,0,0,0,0,0:00
,27,Rickard Wallin,51,Färjestad,F,50,11,19,30,82,1,5,0,0,0,0,0,0,0:00
,28,Kalle Kerman,23,Mora,F,50,19,9,28,10,1,4,0,0,0,0,0,0,0:00
,29,Jiri Bicek,34,Leksand,F,50,16,12,28,48,1,9,0,0,0,0,0,0,0:00
,30,Jussi Tarvainen,40,Linköping,F,50,12,16,28,24,1,8,0,0,0,0,0,0,0:00
,31,Fredrik Olausson,20,HV71,F,46,7,21,28,26,0,5,0,0,0,0,0,0,0:00
,32,Miloslav Horava,28,MODO,F,50,19,8,27,20,5,8,0,0,0,0,0,0,0:00
,33,Tim Eriksson,26,Linköping,F,47,14,13,27,20,4,3,0,0,0,0,0,0,0:00
,34,Lars Jonsson,20,HV71,D,50,11,16,27,46,2,6,0,0,0,0,0,0,0:00
,35,Johan Lindström,79,Linköping,F,50,16,10,26,10,7,8,0,0,0,0,0,0,0:00
,36,Per Svartvadet,39,MODO,F,46,13,13,26,26,3,0,0,0,0,0,0,0,0:00
,37,Vladimir Machulda,99,Luleå,F,48,12,14,26,32,3,4,0,0,0,0,0,0,0:00
,38,Nicklas Bäckström,19,Brynäs,F,46,10,16,26,30,3,4,0,0,0,0,0,0,0:00
,39,Mikko Luoma,5,Linköping,D,50,7,19,26,105,2,4,0,0,0,0,0,0,0:00
,40,Radek Hamr,1032,Färjestad,F,49,5,21,26,32,1,3,0,0,0,0,0,0,0:00
,41,Per Eklund,,Djurgården,F,50,17,8,25,24,2,8,0,0,0,0,0,0,0:00
,42,Miroslav Zalesak,20,SSK,F,43,16,9,25,28,1,8,0,0,0,0,0,0,0:00
,43,Jaroslav Obsut,43,Luleå,D,48,8,17,25,40,3,6,0,0,0,0,0,0,0:00
,44,Jan Huokko,,SSK,F,50,12,12,24,48,2,6,0,0,0,0,0,0,0:00
,45,Mathias Månsson,41,Brynäs,F,49,11,13,24,38,2,8,0,0,0,0,0,0,0:00
,46,Jonas Höglund,28,Färjestad,F,49,10,14,24,24,3,4,0,0,0,0,0,0,0:00
,47,Peter Högardh,12,Frölunda,F,50,8,16,24,30,2,2,0,0,0,0,0,0,0:00
,48,Nichlas Falk,16,Djurgården,F,50,7,17,24,34,1,2,0,0,0,0,0,0,0:00
,49,Per Ledin,97,Färjestad,F,46,8,15,23,123,2,2,0,0,0,0,0,0,0:00
,50,Jonas Esbjörs,22,Frölunda,F,44,13,9,22,18,2,4,0,0,0,0,0,0,0:00
,51,Fredrik Warg,29,Timrå,F,49,13,9,22,22,0,4,0,0,0,0,0,0,0:00
,52,Magnus Hedlund,,Leksand,D,47,12,10,22,36,2,6,0,0,0,0,0,0,0:00
,53,Mattias Remstam,75,HV71,F,46,11,11,22,86,1,2,0,0,0,0,0,0,0:00
,54,Magnus Johansson,7,Linköping,D,50,11,11,22,30,2,6,0,0,0,0,0,0,0:00
,54,Karl Fabricius,52,Luleå,F,50,11,11,22,14,0,3,0,0,0,0,0,0,0:00
,56,Martin Plüss,28,Frölunda,F,45,10,12,22,36,1,0,0,0,0,0,0,0,0:00
,57,Henrik Malmström,9,Brynäs,F,50,9,13,22,28,4,2,0,0,0,0,0,0,0:00
,58,Jan Pardavy,,MODO,F,47,8,14,22,36,0,2,0,0,0,0,0,0,0:00
,59,Tom Koivisto,,Frölunda,D,40,6,16,22,76,0,2,0,0,0,0,0,0,0:00
,60,Dragan Umicevic,84,SSK,F,43,6,16,22,14,1,4,0,0,0,0,0,0,0:00
,61,Andreas Holmqvist,7,Linköping,D,46,6,16,22,64,0,3,0,0,0,0,0,0,0:00
,62,Jan Sandström,7,Luleå,D,49,6,16,22,60,1,1,0,0,0,0,0,0,0:00
,63,Ove Molin,21,Brynäs,F,48,5,17,22,46,1,2,0,0,0,0,0,0,0:00
,64,Justin Mapletoft,12,SSK,F,31,14,7,21,34,1,4,0,0,0,0,0,0,0:00
,65,Per-Åge Skröder,10,SSK,F,47,13,8,21,50,1,9,0,0,0,0,0,0,0:00
,66,Mikael Håkanson,51,Linköping,F,40,9,12,21,46,0,7,0,0,0,0,0,0,0:00
,67,Oscar Steen,45,Leksand,F,44,8,13,21,42,1,3,0,0,0,0,0,0,0:00
,68,Thomas Rhodin,25,Färjestad,D,43,5,16,21,38,0,2,0,0,0,0,0,0,0:00
,69,Kent Manderville,1028,Timrå,F,43,11,9,20,79,0,3,0,0,0,0,0,0,0:00
,70,Pelle Prestberg,10,Färjestad,F,44,10,10,20,32,2,3,0,0,0,0,0,0,0:00
,71,Sami Torkki,25,Linköping,F,50,10,10,20,128,1,1,0,0,0,0,0,0,0:00
,72,Adam Masuhr,38,Djurgården,D,46,8,12,20,46,2,6,0,0,0,0,0,0,0:00
,73,Anze Kopitar,,SSK,F,47,8,12,20,28,2,2,0,0,0,0,0,0,0:00
,74,Morten Green,13,MODO,F,50,8,12,20,20,2,1,0,0,0,0,0,0,0:00
,75,Mikko Peltola,,Linköping,F,36,6,14,20,22,1,2,0,0,0,0,0,0,0:00
,76,Andreas Dackell,12,Brynäs,F,40,6,14,20,22,0,3,0,0,0,0,0,0,0:00
,77,Teemu Aalto,38,Timrå,F,49,3,17,20,52,1,3,0,0,0,0,0,0,0:00
,78,Josef Boumedienne,78,SSK,D,26,1,19,20,62,0,0,0,0,0,0,0,0,0:00
,79,Pasi Tuominen,11,MODO,F,50,14,5,19,26,4,6,0,0,0,0,0,0,0:00
,80,Jimmie Ölvestad,19,Djurgården,F,50,10,9,19,90,5,2,0,0,0,0,0,0,0:00
,81,Tommy Sjödin,7,Brynäs,D,48,9,10,19,60,2,4,0,0,0,0,0,0,0:00
,82,Mikael Simons,78,Mora,F,50,9,10,19,40,3,6,0,0,0,0,0,0,0:00
,82,Marco Tuokko,13,Mora,F,50,9,10,19,143,0,3,0,0,0,0,0,0,0:00
,84,Johnny Oduya,,Frölunda,D,47,8,11,19,95,2,3,0,0,0,0,0,0,0:00
,85,Teemu Elomo,49,Mora,F,50,7,12,19,44,1,4,0,0,0,0,0,0,0:00
,86,Peter Smrek,6,Mora,D,45,6,13,19,102,3,3,0,0,0,0,0,0,0:00
,87,Mikael Lind,36,Brynäs,F,35,5,14,19,14,0,2,0,0,0,0,0,0,0:00
,88,Calle Steen,,Leksand,F,44,4,15,19,74,1,2,0,0,0,0,0,0,0:00
,89,Ronnie Sundin,23,Frölunda,D,50,4,15,19,65,1,3,0,0,0,0,0,0,0:00
,90,Fredrik Hynning,12,Luleå,F,49,11,7,18,14,2,3,0,0,0,0,0,0,0:00
,91,Fredrik Emvall,33,Linköping,F,48,9,9,18,44,0,3,0,0,0,0,0,0,0:00
,92,Mikael Pettersson,19,MODO,F,50,6,12,18,24,2,1,0,0,0,0,0,0,0:00
,93,Frans Nielsen,1015,Timrå,F,50,5,13,18,22,2,2,0,0,0,0,0,0,0:00
,94,Magnus Gästrin,40,MODO,F,48,4,14,18,38,0,0,0,0,0,0,0,0,0:00
,95,Martin Thörnberg,10,HV71,F,50,10,7,17,64,1,2,0,0,0,0,0,0,0:00
,96,Jens Karlsson,58,HV71,F,45,9,8,17,101,2,2,0,0,0,0,0,0,0:00
,97,Pekka Saravo,14,Luleå,D,44,8,9,17,52,2,5,0,0,0,0,0,0,0:00
,98,Niklas Persson,23,Leksand,F,34,7,10,17,30,1,2,0,0,0,0,0,0,0:00
,99,Kristofer Ottosson,9,Djurgården,F,31,6,11,17,22,0,3,0,0,0,0,0,0,0:00
,100,Pavel Skrbek,11,Luleå,D,49,5,12,17,88,1,1,0,0,0,0,0,0,0:00
,101,Håkan Bogg,33,Mora,F,39,3,14,17,30,0,0,0,0,0,0,0,0,0:00
,102,Robert Carlsson,12,Timrå,F,49,11,5,16,22,3,4,0,0,0,0,0,0,0:00
,103,Björn Danielsson,23,Brynäs,F,39,7,9,16,12,0,1,0,0,0,0,0,0,0:00
,104,Thomas Koch,,Luleå,F,50,7,9,16,34,0,2,0,0,0,0,0,0,0:00
,105,Erik Andersson,11,HV71,F,41,6,10,16,12,2,1,0,0,0,0,0,0,0:00
,106,Thomas Johansson,18,Linköping,D,46,6,10,16,58,0,1,0,0,0,0,0,0,0:00
,107,Johan Witehall,,Frölunda,F,48,5,11,16,43,1,1,0,0,0,0,0,0,0:00
,108,Henrik Nordfeldt,,Djurgården,F,45,8,7,15,26,0,5,0,0,0,0,0,0,0:00
,109,Tomas Kollar,29,SSK,F,50,7,8,15,111,0,1,0,0,0,0,0,0,0:00
,110,David Petrasek,22,HV71,D,44,5,10,15,87,3,2,0,0,0,0,0,0,0:00
,111,Anders Burström,21,SSK,F,48,4,11,15,50,1,0,0,0,0,0,0,0,0:00
,112,Jörgen Bemström,24,SSK,F,45,3,12,15,34,0,1,0,0,0,0,0,0,0:00
,113,Petri Liimatainen,73,SSK,D,38,2,13,15,67,0,1,0,0,0,0,0,0,0:00
,114,Jyrki Välivaara,39,Linköping,D,42,2,13,15,28,0,0,0,0,0,0,0,0,0:00
,115,Patrik Wallenberg,,Leksand,F,47,8,6,14,52,1,3,0,0,0,0,0,0,0:00
,116,Jesper Damgaard,7,MODO,D,50,7,7,14,38,1,2,0,0,0,0,0,0,0:00
,117,Magnus Nilsson,24,Timrå,F,44,6,8,14,52,3,4,0,0,0,0,0,0,0:00
,118,Mattias Timander,3,MODO,D,48,5,9,14,48,1,1,0,0,0,0,0,0,0:00
,119,Daniel Glimmenvall,6,Brynäs,D,50,5,9,14,34,1,1,0,0,0,0,0,0,0:00
,120,Vladimir Orszagh,,Luleå,F,19,8,5,13,42,0,2,0,0,0,0,0,0,0:00
,121,Carl-Johan Johansson,1052,Timrå,F,50,6,7,13,30,1,5,0,0,0,0,0,0,0:00
,122,Jarno Kultanen,21,Mora,D,50,5,8,13,44,2,4,0,0,0,0,0,0,0:00
,123,Robin Jonsson,39,Färjestad,D,49,4,9,13,62,1,0,0,0,0,0,0,0,0:00
,124,Mika Strömberg,,Djurgården,D,34,2,11,13,40,0,1,0,0,0,0,0,0,0:00
,125,Per Hallin,8,Timrå,F,38,9,3,12,53,2,2,0,0,0,0,0,0,0:00
,126,Jens Bergenström,32,Leksand,F,49,8,4,12,16,1,4,0,0,0,0,0,0,0:00
,127,Jörgen Sundqvist,22,Brynäs,D,50,8,4,12,48,2,2,0,0,0,0,0,0,0:00
,128,Anders Bastiansen,20,Mora,F,32,7,5,12,20,1,0,0,0,0,0,0,0,0:00
,129,Peter Öberg,27,MODO,F,47,6,6,12,22,1,1,0,0,0,0,0,0,0:00
,130,Jonas Almtorp,16,Brynäs,F,50,6,6,12,42,3,0,0,0,0,0,0,0,0:00
,130,Jesper Ollas,17,Leksand,F,50,6,6,12,24,0,0,0,0,0,0,0,0,0:00
,132,Valeri Krykov,1051,Timrå,F,30,5,7,12,10,0,4,0,0,0,0,0,0,0:00
,133,Fredrik Eriksson,8,Färjestad,D,46,4,8,12,52,0,1,0,0,0,0,0,0,0:00
,134,Ragnar Karlsson,27,Luleå,F,49,4,8,12,28,0,1,0,0,0,0,0,0,0:00
,135,Tommy Wargh,86,MODO,D,40,3,9,12,18,1,0,0,0,0,0,0,0,0:00
,136,Kristian Gahn,1017,Timrå,F,48,1,11,12,30,0,1,0,0,0,0,0,0,0:00
,137,Peter Nordström,19,Färjestad,F,18,6,5,11,16,0,3,0,0,0,0,0,0,0:00
,138,Kenneth Bergqvist,41,Mora,F,42,6,5,11,35,0,3,0,0,0,0,0,0,0:00
,139,Atvars Tribuncovs,32,Mora,D,39,4,7,11,50,0,1,0,0,0,0,0,0,0:00
,140,Peter Regin,13,Timrå,F,44,4,7,11,14,2,2,0,0,0,0,0,0,0:00
,141,Emil Kåberg,27,Färjestad,F,46,4,7,11,85,1,3,0,0,0,0,0,0,0:00
,142,Tobias Enström,37,MODO,D,47,4,7,11,48,2,2,0,0,0,0,0,0,0:00
,143,Robert Carlsson,14,SSK,F,50,4,7,11,42,1,2,0,0,0,0,0,0,0:00
,143,Peter Ström,1047,Timrå,F,50,4,7,11,10,0,0,0,0,0,0,0,0,0:00
,145,Eric Beaudoin,28,Mora,F,32,2,9,11,24,0,0,0,0,0,0,0,0,0:00
,146,Gabriel Karlsson,49,SSK,F,47,2,9,11,20,1,1,0,0,0,0,0,0,0:00
,147,Erik Norbäck,,SSK,F,45,5,5,10,22,1,0,0,0,0,0,0,0,0:00
,148,Anders Nilsson,43,Mora,F,48,5,5,10,41,2,0,0,0,0,0,0,0,0:00
,149,Christian Söderström,82,/,F,49,5,5,10,12,1,0,0,0,0,0,0,0,0:00
,150,Arto Tukio,8,Frölunda,D,38,4,6,10,71,0,1,0,0,0,0,0,0,0:00
,151,Jan-Axel Alavaara,55,Frölunda,D,50,4,6,10,76,1,1,0,0,0,0,0,0,0:00
,152,Per Hållberg,18,Färjestad,D,48,3,7,10,56,0,0,0,0,0,0,0,0,0:00
,153,Jan Nemecek,,Leksand,D,40,2,8,10,6,0,1,0,0,0,0,0,0,0:00
,154,Johan Svedberg,7,Timrå,D,50,2,8,10,42,0,1,0,0,0,0,0,0,0:00
,155,Mattias Hellström,4,MODO,F,46,0,10,10,4,0,0,0,0,0,0,0,0,0:00
,156,Martin Jansson,77,Mora,F,48,6,3,9,75,2,1,0,0,0,0,0,0,0:00
,157,David Fredriksson,54,HV71,F,37,5,4,9,34,0,0,0,0,0,0,0,0,0:00
,158,Jarrod Skalde,27,Leksand,F,36,4,5,9,120,0,0,0,0,0,0,0,0,0:00
,159,Jari Tolsa,17,Frölunda,F,29,3,6,9,18,0,2,0,0,0,0,0,0,0:00
,160,Jimmie Ericsson,21,Leksand,F,40,3,6,9,64,0,1,0,0,0,0,0,0,0:00
,161,Johan Eneqvist,,Djurgården,F,49,2,7,9,6,2,1,0,0,0,0,0,0,0:00
,162,Johan Andersson,17,Linköping,F,50,2,7,9,40,0,0,0,0,0,0,0,0,0:00
,163,Magnus Österby,,Leksand,D,30,4,4,8,69,0,3,0,0,0,0,0,0,0:00
,164,Markus Seikola,21,Frölunda,D,9,3,5,8,6,1,1,0,0,0,0,0,0,0:00
,165,Brian Felsner,,Brynäs,F,17,3,5,8,14,0,1,0,0,0,0,0,0,0:00
,166,Hans Jonsson,5,MODO,D,28,3,5,8,48,0,1,0,0,0,0,0,0,0:00
,167,Mattias Wennerberg,26,Timrå,F,50,3,5,8,20,0,2,0,0,0,0,0,0,0:00
,167,Johan Fransson,10,Luleå,D,50,3,5,8,74,0,2,0,0,0,0,0,0,0:00
,169,Rami Alanko,3,Färjestad,D,41,2,6,8,67,2,0,0,0,0,0,0,0,0:00
,170,Andreas Pihl,2,Linköping,D,46,1,7,8,146,0,0,0,0,0,0,0,0,0:00
,171,Stefan Bemström,22,Leksand,D,48,1,7,8,55,0,0,0,0,0,0,0,0,0:00
,172,Tobias Viklund,16,MODO,D,46,0,8,8,20,0,0,0,0,0,0,0,0,0:00
,173,Ola Svanberg,4,HV71,D,50,0,8,8,30,0,0,0,0,0,0,0,0,0:00
,174,Mike Watt,9,Leksand,F,23,5,2,7,30,1,2,0,0,0,0,0,0,0:00
,175,Rodrigo Lavins,32,Brynäs,D,45,5,2,7,26,0,4,0,0,0,0,0,0,0:00
,175,Daniel Casselståhl,52,Brynäs,D,45,5,2,7,28,0,3,0,0,0,0,0,0,0:00
,177,Jonas Soling,1011,Linköping,F,46,5,2,7,55,2,2,0,0,0,0,0,0,0:00
,178,Patric Hörnqvist,10,Djurgården,F,47,5,2,7,36,0,1,0,0,0,0,0,0,0:00
,179,Mikael Wahlberg,,Brynäs,F,17,4,3,7,18,0,2,0,0,0,0,0,0,0:00
,180,Tommi Miettinen,9,Brynäs,F,19,4,3,7,12,2,1,0,0,0,0,0,0,0:00
,181,Kalle Koskinen,9,Timrå,D,34,3,4,7,55,0,1,0,0,0,0,0,0,0:00
,182,Emil Lundberg,51,Luleå,F,39,3,4,7,34,0,1,0,0,0,0,0,0,0:00
,183,Martin Samuelsson,14,Linköping,F,44,3,4,7,45,2,0,0,0,0,0,0,0,0:00
,184,Ronnie Pettersson,6,Djurgården,D,46,2,5,7,46,1,1,0,0,0,0,0,0,0:00
,185,Lars-Erik Spets,27,Brynäs,F,50,2,5,7,14,0,1,0,0,0,0,0,0,0:00
,186,Jason Krog,9,Frölunda,F,7,5,1,6,6,0,2,0,0,0,0,0,0,0:00
,187,Pavel Rosa,59,Timrå,F,10,5,1,6,2,1,3,0,0,0,0,0,0,0:00
,188,David Nyström,,SSK,F,46,4,2,6,12,0,0,0,0,0,0,0,0,0:00
,189,Anton Axelsson,6,Frölunda,F,39,3,3,6,8,0,0,0,0,0,0,0,0,0:00
,190,Johan Olsson,1023,Färjestad,F,46,3,3,6,8,1,1,0,0,0,0,0,0,0:00
,190,Jonas Frögren,24,Färjestad,D,46,3,3,6,84,0,2,0,0,0,0,0,0,0:00
,192,Timmy Pettersson,33,SSK,D,50,3,3,6,42,0,1,0,0,0,0,0,0,0:00
,193,Marko Jantunen,1090,Timrå,F,11,2,4,6,4,0,0,0,0,0,0,0,0,0:00
,194,Pär Styf,36,Timrå,D,27,2,4,6,78,1,0,0,0,0,0,0,0,0:00
,195,Robin Lindqvist,22,Luleå,F,32,2,4,6,34,0,0,0,0,0,0,0,0,0:00
,196,Marcus Kristoffersson,38,Djurgården,F,35,2,4,6,94,0,1,0,0,0,0,0,0,0:00
,197,Sanny Lindström,8,Timrå,D,50,2,4,6,83,0,0,0,0,0,0,0,0,0:00
,198,Mikael Johansson,85,Färjestad,F,46,1,5,6,16,0,1,0,0,0,0,0,0,0:00
,199,Sebastian Meijer,13,Leksand,F,49,1,5,6,41,0,0,0,0,0,0,0,0,0:00
,199,Peter Hammarström,,HV71,F,49,1,5,6,28,0,0,0,0,0,0,0,0,0:00
,201,Jaroslav Kalla,17,Leksand,F,8,0,6,6,0,0,0,0,0,0,0,0,0,0:00
,202,Martin Öhrstedt,11,Brynäs,D,49,4,1,5,22,0,1,0,0,0,0,0,0,0:00
,203,Christoph Brandner,26,SSK,F,25,3,2,5,10,0,1,0,0,0,0,0,0,0:00
,204,Tomas Wallgren,8,Luleå,F,38,3,2,5,31,1,0,0,0,0,0,0,0,0:00
,205,Oscar Hedman,41,MODO,D,44,3,2,5,30,1,2,0,0,0,0,0,0,0:00
,206,Magnus Isaksson,9,Luleå,F,50,3,2,5,18,1,0,0,0,0,0,0,0,0:00
,207,Patrik Carlsson,72,Frölunda,F,12,2,3,5,0,0,0,0,0,0,0,0,0,0:00
,208,Christopher Thörn,34,Djurgården,F,33,2,3,5,28,0,0,0,0,0,0,0,0,0:00
,209,Jonas Liwing,23,Djurgården,D,44,2,3,5,14,1,0,0,0,0,0,0,0,0:00
,210,Henrik Petré,79,SSK,D,49,2,3,5,30,0,0,0,0,0,0,0,0,0:00
,211,Pasi Määttänen,,HV71,F,26,1,4,5,8,1,0,0,0,0,0,0,0,0:00
,212,Tomas Skogs,23,Mora,D,37,1,4,5,34,0,0,0,0,0,0,0,0,0:00
,213,Anton Strålman,6,Timrå,D,45,1,4,5,28,0,0,0,0,0,0,0,0,0:00
,214,Erik Ryman,33,Djurgården,D,49,1,4,5,38,0,0,0,0,0,0,0,0,0:00
,214,Antti-Jussi Niemi,7,Frölunda,D,49,1,4,5,60,0,0,0,0,0,0,0,0,0:00
,214,Christoffer Norgren,29,Linköping,D,49,1,4,5,54,0,1,0,0,0,0,0,0,0:00
,217,Jonathan Granström,31,Mora,F,43,0,5,5,49,0,0,0,0,0,0,0,0,0:00
,218,Kimmo Lotvonen,29,Leksand,D,12,3,1,4,20,2,1,0,0,0,0,0,0,0:00
,219,Marcus Eriksson,,Mora,F,22,3,1,4,18,1,0,0,0,0,0,0,0,0:00
,220,Johan Harju,24,Luleå,F,39,3,1,4,8,0,0,0,0,0,0,0,0,0:00
,221,Antti Aarnio,10,Brynäs,F,36,2,2,4,82,0,1,0,0,0,0,0,0,0:00
,222,Magnus Sandberg,,Mora,F,38,2,2,4,12,0,0,0,0,0,0,0,0,0:00
,222,Blake Sloan,1011,Timrå,F,38,2,2,4,40,0,0,0,0,0,0,0,0,0:00
,224,Martin Sevc,55,Färjestad,D,8,1,3,4,14,1,1,0,0,0,0,0,0,0:00
,225,Daniel Hermansson,22,Brynäs,F,20,1,3,4,10,0,0,0,0,0,0,0,0,0:00
,226,Petter Ullman,16,Leksand,D,30,1,3,4,54,0,0,0,0,0,0,0,0,0:00
,227,Linus Videll,55,SSK,F,31,1,3,4,4,0,0,0,0,0,0,0,0,0:00
,227,Mika Niskanen,99,HV71,D,31,1,3,4,26,1,1,0,0,0,0,0,0,0:00
,229,Mikko Kuparinen,,Brynäs,D,40,1,3,4,48,0,0,0,0,0,0,0,0,0:00
,230,Alexander Ribbenstrand,7,Djurgården,D,45,1,3,4,73,0,0,0,0,0,0,0,0,0:00
,231,Joachim Gellerstedt,,Brynäs,F,32,0,4,4,8,0,0,0,0,0,0,0,0,0:00
,232,Patric Blomdahl,84,Linköping,F,45,3,0,3,93,0,0,0,0,0,0,0,0,0:00
,233,Anthony Tuzzolino,17,MODO,F,11,2,1,3,14,0,1,0,0,0,0,0,0,0:00
,234,Richard Demén Willaume,7,Frölunda,D,42,2,1,3,26,0,1,0,0,0,0,0,0,0:00
,235,Calle Bergström,,Mora,D,43,2,1,3,20,1,0,0,0,0,0,0,0,0:00
,236,Niklas Hjalmarsson,28,HV71,D,4,1,2,3,0,0,0,0,0,0,0,0,0,0:00
,237,Viktor Lindgren,10,Luleå,F,12,1,2,3,2,0,1,0,0,0,0,0,0,0:00
,238,Vesa Viitakoski,,Brynäs,F,13,1,2,3,16,0,1,0,0,0,0,0,0,0:00
,239,Kirill Starkov,14,Frölunda,F,34,1,2,3,4,1,0,0,0,0,0,0,0,0:00
,240,Jesper Björck,,Djurgården,D,39,1,2,3,30,0,0,0,0,0,0,0,0,0:00
,241,Pär Bäcker,24,Färjestad,F,40,1,2,3,16,0,0,0,0,0,0,0,0,0:00
,242,Karol Krizan,60,MODO,Gk,50,1,2,3,10,0,0,0,0,0,0,0,0,0:00
,243,Pavel Trnka,26,Leksand,D,7,0,3,3,8,0,0,0,0,0,0,0,0,0:00
,244,Mattias Ritola,21,Leksand,F,30,0,3,3,10,0,0,0,0,0,0,0,0,0:00
,245,Pasi Petriläinen,,SSK,D,32,0,3,3,59,0,0,0,0,0,0,0,0,0:00
,246,Johan Holmqvist,40,Brynäs,Gk,33,0,3,3,0,0,0,0,0,0,0,0,0,0:00
,247,Stanislav Neckar,4,SSK,D,36,0,3,3,73,0,0,0,0,0,0,0,0,0:00
,248,Mats Hansson,1021,Timrå,F,48,0,3,3,20,0,0,0,0,0,0,0,0,0:00
,249,Christofer Löfberg,44,Djurgården,F,43,2,0,2,24,0,1,0,0,0,0,0,0,0:00
,250,Andreas Jämtin,18,HV71,F,8,1,1,2,28,0,0,0,0,0,0,0,0,0:00
,251,Daniel Widing,41,Brynäs,F,11,1,1,2,2,0,0,0,0,0,0,0,0,0:00
,252,Patrik Hucko,61,Leksand,D,17,1,1,2,10,0,0,0,0,0,0,0,0,0:00
,253,Yan Golubovsky,10,Leksand,D,31,1,1,2,22,0,1,0,0,0,0,0,0,0:00
,254,Johan Halvardsson,27,HV71,D,37,1,1,2,34,0,0,0,0,0,0,0,0,0:00
,255,Ladislav Benysek,3,Leksand,D,38,1,1,2,42,1,1,0,0,0,0,0,0,0:00
,256,Per Savilahti-Nagander,,Luleå,D,41,1,1,2,40,0,0,0,0,0,0,0,0,0:00
,257,Peter Nolander,70,Mora,D,43,1,1,2,14,0,0,0,0,0,0,0,0,0:00
,258,Peter Fabus,45,Mora,F,18,0,2,2,6,0,0,0,0,0,0,0,0,0:00
,259,Erik Lindberg,,Luleå,D,27,0,2,2,14,0,0,0,0,0,0,0,0,0:00
,260,Martin Thelander,1088,Färjestad,F,29,0,2,2,53,0,0,0,0,0,0,0,0,0:00
,261,Fredrik Norrena,30,Linköping,Gk,43,0,2,2,35,0,0,0,0,0,0,0,0,0:00
,262,Daniel Ljungkvist,16,SSK,D,47,0,2,2,44,0,0,0,0,0,0,0,0,0:00
,263,Andreas Molinder,24,MODO,F,4,1,0,1,2,0,0,0,0,0,0,0,0,0:00
,264,Antti-Pekka Lamberg,21,Djurgården,D,26,1,0,1,40,1,0,0,0,0,0,0,0,0:00
,265,Niklas Öhman,43,MODO,D,6,0,1,1,2,0,0,0,0,0,0,0,0,0:00
,265,Shane Willis,19,Linköping,F,6,0,1,1,4,0,0,0,0,0,0,0,0,0:00
,265,Janne Laakkonen,1091,Timrå,F,6,0,1,1,0,0,0,0,0,0,0,0,0,0:00
,268,Daniel Grillfors,32,HV71,D,9,0,1,1,0,0,0,0,0,0,0,0,0,0:00
,269,Patrik Zackrisson,26,Frölunda,F,10,0,1,1,0,0,0,0,0,0,0,0,0,0:00
,270,Axel Nordholm,12,HV71,D,16,0,1,1,2,0,0,0,0,0,0,0,0,0:00
,271,Jordan Krestanovich,11,Mora,F,18,0,1,1,2,0,0,0,0,0,0,0,0,0:00
,272,Linus Omark,67,Luleå,F,19,0,1,1,10,0,0,0,0,0,0,0,0,0:00
,273,Adam Svoboda,1001,Timrå,F,20,0,1,1,2,0,0,0,0,0,0,0,0,0:00
,274,Niklas Bröms,15,Leksand,F,23,0,1,1,2,0,0,0,0,0,0,0,0,0:00
,274,Johan Nilsson,33,MODO,F,23,0,1,1,2,0,0,0,0,0,0,0,0,0:00
,276,Pierre Johnsson,2,Mora,D,35,0,1,1,20,0,0,0,0,0,0,0,0,0:00
,276,Vladimir Sicak,24,MODO,D,35,0,1,1,12,0,0,0,0,0,0,0,0,0:00
,278,Tommy Salo,31,Frölunda,Gk,44,0,1,1,16,0,0,0,0,0,0,0,0,0:00
,279,Rastislav Stana,31,SSK,Gk,47,0,1,1,2,0,0,0,0,0,0,0,0,0:00
,280,Stefan Liv,1,HV71,Gk,49,0,1,1,6,0,0,0,0,0,0,0,0,0:00
,281,Tomas Duba,35,Leksand,Gk,50,0,1,1,4,0,0,0,0,0,0,0,0,0:00
,281,Johan Backlund,26,Leksand,Gk,50,0,1,1,2,0,0,0,0,0,0,0,0,0:00
,281,Petri Vehanen,35,Mora,Gk,50,0,1,1,6,0,0,0,0,0,0,0,0,0:00
,281,Jonas Fransson,32,Linköping,Gk,50,0,1,1,0,0,0,0,0,0,0,0,0,0:00
,281,Teemu Lassila,35,Djurgården,Gk,50,0,1,1,16,0,0,0,0,0,0,0,0,0:00
,286,Jimmy Jensen,3,Djurgården,F,1,0,0,0,0,0,0,0,0,0,0,0,0,0:00
,286,Christoffer From-Björk,28,Djurgården,D,1,0,0,0,0,0,0,0,0,0,0,0,0,0:00
,286,Fredrik Gräsvik,29,Brynäs,Gk,1,0,0,0,0,0,0,0,0,0,0,0,0,0:00
,286,Chris Nybeck,26,HV71,F,1,0,0,0,0,0,0,0,0,0,0,0,0,0:00
,286,Robin Gartner,2,HV71,D,1,0,0,0,0,0,0,0,0,0,0,0,0,0:00
,286,Johan Andersson,24,SSK,F,1,0,0,0,0,0,0,0,0,0,0,0,0,0:00
,286,Andreas Engqvist,21,Djurgården,F,1,0,0,0,0,0,0,0,0,0,0,0,0,0:00
,286,Nils Bäckström,3,Djurgården,D,1,0,0,0,0,0,0,0,0,0,0,0,0,0:00
,286,Jim Karlsson,26,Luleå,Gk,1,0,0,0,0,0,0,0,0,0,0,0,0,0:00
,286,Niklas Amberg,35,HV71,Gk,1,0,0,0,0,0,0,0,0,0,0,0,0,0:00
,286,Fredrik Strid,,Brynäs,F,1,0,0,0,0,0,0,0,0,0,0,0,0,0:00
,286,Tim Johansson Bräck,13,Djurgården,F,1,0,0,0,0,0,0,0,0,0,0,0,0,0:00
,286,Fredrik Sonntag,6,SSK,D,1,0,0,0,0,0,0,0,0,0,0,0,0,0:00
,286,Tony Lagerström,25,SSK,F,1,0,0,0,0,0,0,0,0,0,0,0,0,0:00
,286,Marcus Weinstock,20,Färjestad,F,1,0,0,0,0,0,0,0,0,0,0,0,0,0:00
,301,Marcus Götz,2,Brynäs,D,2,0,0,0,0,0,0,0,0,0,0,0,0,0:00
,301,Albin Lorentzon,27,Linköping,D,2,0,0,0,0,0,0,0,0,0,0,0,0,0:00
,301,Pontus Hansson,42,Frölunda,Gk,2,0,0,0,0,0,0,0,0,0,0,0,0,0:00
,301,Andreas Axell,,Linköping,F,2,0,0,0,0,0,0,0,0,0,0,0,0,0:00
,301,Erik Lindhagen,29,Linköping,F,2,0,0,0,0,0,0,0,0,0,0,0,0,0:00
,301,Fabian Eriksson,,Timrå,Gk,2,0,0,0,0,0,0,0,0,0,0,0,0,0:00
,301,Jesper Olsson,5,Mora,D,2,0,0,0,0,0,0,0,0,0,0,0,0,0:00
,301,Eric Moe,9,Timrå,D,2,0,0,0,0,0,0,0,0,0,0,0,0,0:00
,301,Johan Dahlberg,1027,MODO,F,2,0,0,0,0,0,0,0,0,0,0,0,0,0:00
,301,Robin Figren,23,Frölunda,F,2,0,0,0,0,0,0,0,0,0,0,0,0,0:00
,311,Maths Johansson,6,HV71,F,3,0,0,0,0,0,0,0,0,0,0,0,0,0:00
,311,Johan Alcén,14,Brynäs,F,3,0,0,0,0,0,0,0,0,0,0,0,0,0:00
,311,Anders Lindbäck,39,Brynäs,Gk,3,0,0,0,0,0,0,0,0,0,0,0,0,0:00
,314,Sebastian Enterfeldt,59,Brynäs,F,4,0,0,0,0,0,0,0,0,0,0,0,0,0:00
,314,Jhonas Enroth,1,SSK,Gk,4,0,0,0,0,0,0,0,0,0,0,0,0,0:00
,314,Linus Näsström,81,Linköping,F,4,0,0,0,0,0,0,0,0,0,0,0,0,0:00
,314,Stefan Ridderwall,39,Djurgården,Gk,4,0,0,0,0,0,0,0,0,0,0,0,0,0:00
,314,Jonas Junland,44,Linköping,D,4,0,0,0,0,0,0,0,0,0,0,0,0,0:00
,319,Linus Morin,29,Brynäs,D,5,0,0,0,0,0,0,0,0,0,0,0,0,0:00
,319,Patrik Eriksson,,Brynäs,Gk,5,0,0,0,0,0,0,0,0,0,0,0,0,0:00
,319,Johan Karlsson,35,HV71,Gk,5,0,0,0,0,0,0,0,0,0,0,0,0,0:00
,319,Jukka Tiilikainen,,Leksand,F,5,0,0,0,2,0,0,0,0,0,0,0,0,0:00
,319,Mathias Porseland,8,Frölunda,D,5,0,0,0,0,0,0,0,0,0,0,0,0,0:00
,319,André Hult,23,Mora,F,5,0,0,0,2,0,0,0,0,0,0,0,0,0:00
,319,Jonas Lindström,,Timrå,F,5,0,0,0,0,0,0,0,0,0,0,0,0,0:00
,319,Morten Madsen,29,Frölunda,F,5,0,0,0,2,0,0,0,0,0,0,0,0,0:00
,327,Tom Wandell,14,SSK,F,6,0,0,0,0,0,0,0,0,0,0,0,0,0:00
,327,Petr Leska,91,SSK,F,6,0,0,0,0,0,0,0,0,0,0,0,0,0:00
,329,Petter Rönnquist,,Djurgården,Gk,7,0,0,0,0,0,0,0,0,0,0,0,0,0:00
,329,Jens Jakobs,26,Mora,F,7,0,0,0,2,0,0,0,0,0,0,0,0,0:00
,329,Kim Sunna,27,Brynäs,F,7,0,0,0,4,0,0,0,0,0,0,0,0,0:00
,329,Nikos Tselios,35,Färjestad,D,7,0,0,0,10,0,0,0,0,0,0,0,0,0:00
,329,Dan Mogemark,1,Linköping,Gk,7,0,0,0,0,0,0,0,0,0,0,0,0,0:00
,334,Pavel Patera,1030,Färjestad,F,8,0,0,0,4,0,0,0,0,0,0,0,0,0:00
,334,Niclas Andersén,9,Leksand,D,8,0,0,0,8,0,0,0,0,0,0,0,0,0:00
,334,Jacob Blomqvist,44,Brynäs,F,8,0,0,0,0,0,0,0,0,0,0,0,0,0:00
,334,Mattias Beck,83,HV71,F,8,0,0,0,0,0,0,0,0,0,0,0,0,0:00
,334,Patrik Nilson,,Djurgården,F,8,0,0,0,2,0,0,0,0,0,0,0,0,0:00
,334,Victor Ringberg,8,Linköping,D,8,0,0,0,0,0,0,0,0,0,0,0,0,0:00
,340,Johan Berggren,,SSK,D,9,0,0,0,2,0,0,0,0,0,0,0,0,0:00
,341,Joakim Lundström,84,Brynäs,Gk,10,0,0,0,0,0,0,0,0,0,0,0,0,0:00
,341,Seth Wikskal,26,HV71,F,10,0,0,0,2,0,0,0,0,0,0,0,0,0:00
,341,Jonas Johansson,,Luleå,D,10,0,0,0,0,0,0,0,0,0,0,0,0,0:00
,341,Joel Gistedt,31,Frölunda,Gk,10,0,0,0,0,0,0,0,0,0,0,0,0,0:00
,345,Mattias Modig,33,Luleå,Gk,13,0,0,0,0,0,0,0,0,0,0,0,0,0:00
,345,Simon Skoog,98,/,D,13,0,0,0,4,0,0,0,0,0,0,0,0,0:00
,345,Daniel Eklund,,Leksand,F,13,0,0,0,2,0,0,0,0,0,0,0,0,0:00
,348,Carl Gunnarsson,6,Linköping,D,14,0,0,0,0,0,0,0,0,0,0,0,0,0:00
,349,Jonas Ahnelöv,55,Frölunda,D,15,0,0,0,2,0,0,0,0,0,0,0,0,0:00
,350,Christopher Königsson,,MODO,Gk,16,0,0,0,0,0,0,0,0,0,0,0,0,0:00
,351,Marcus Nyberg,2,Luleå,D,19,0,0,0,2,0,0,0,0,0,0,0,0,0:00
,352,Stefan Erkgärds,4,Färjestad,D,20,0,0,0,2,0,0,0,0,0,0,0,0,0:00
,353,Jonathan Ericsson,,SSK,D,24,0,0,0,20,0,0,0,0,0,0,0,0,0:00
,354,Örjan Lindmark,,Leksand,D,26,0,0,0,45,0,0,0,0,0,0,0,0,0:00
,355,Tommy Enström,63,MODO,F,29,0,0,0,12,0,0,0,0,0,0,0,0,0:00
,356,Michal Zajkowski,30,MODO,Gk,34,0,0,0,0,0,0,0,0,0,0,0,0,0:00
,357,Johan Asplund,35,Timrå,Gk,35,0,0,0,0,0,0,0,0,0,0,0,0,0:00
,357,Niklas Andersson,24,Brynäs,D,35,0,0,0,26,0,0,0,0,0,0,0,0,0:00
,359,Mattias Andersson,30,Djurgården,Gk,39,0,0,0,0,0,0,0,0,0,0,0,0,0:00
,360,Sebastian Karlsson,12,Frölunda,F,40,0,0,0,20,0,0,0,0,0,0,0,0,0:00
,361,David Rautio,30,Luleå,Gk,41,0,0,0,0,0,0,0,0,0,0,0,0,0:00
,362,Mika Oksa,1039,Timrå,F,43,0,0,0,0,0,0,0,0,0,0,0,0,0:00
,363,Mikael Sandberg,,Frölunda,Gk,44,0,0,0,0,0,0,0,0,0,0,0,0,0:00
,364,Tero Leinonen,1,Luleå,Gk,45,0,0,0,16,0,0,0,0,0,0,0,0,0:00
,364,Erik Ersberg,40,HV71,Gk,45,0,0,0,2,0,0,0,0,0,0,0,0,0:00
,364,Jan Srdinko,28,Leksand,D,45,0,0,0,75,0,0,0,0,0,0,0,0,0:00
,367,Elias Granath,4,Leksand,D,46,0,0,0,55,0,0,0,0,0,0,0,0,0:00
,368,Markus Korhonen,1,Brynäs,Gk,48,0,0,0,0,0,0,0,0,0,0,0,0,0:00
,369,André Mattsson,,Djurgården,D,49,0,0,0,69,0,0,0,0,0,0,0,0,0:00
,369,Magnus Lindquist,,SSK,Gk,49,0,0,0,0,0,0,0,0,0,0,0,0,0:00
,371,Daniel Sperrle,1,Mora,Gk,50,0,0,0,2,0,0,0,0,0,0,0,0,0:00
,371,Christopher Heino-Lindberg,40,Färjestad,Gk,50,0,0,0,0,0,0,0,0,0,0,0,0,0:00
,371,Daniel Henriksson,40,Färjestad,Gk,50,0,0,0,6,0,0,0,0,0,0,0,0,0:00
,1,Henrik Zetterberg,,Timrå,F,50,19,31,50,24,2,5,0,0,0,0,0,0,0:00
,2,Kristian Huselius,20,Linköping,F,34,14,35,49,10,2,5,0,0,0,0,0,0,0:00
,3,Mattias Weinhandl,80,MODO,F,50,26,20,46,18,2,14,0,0,0,0,0,0,0:00
,4,Shawn Horcoff,,Mora,F,50,19,27,46,117,1,6,0,0,0,0,0,0,0:00
,5,Nils Ekman,3,Djurgården,F,44,18,27,45,106,3,7,0,0,0,0,0,0,0:00
,6,Brendan Morrison,,Linköping,F,45,16,28,44,50,2,4,0,0,0,0,0,0,0:00
,7,Niklas Andersson,24,Frölunda,F,44,14,27,41,16,3,2,0,0,0,0,0,0,0:00
,8,Michael Knuble,,Linköping,F,49,26,13,39,40,7,5,0,0,0,0,0,0,0:00
,9,Martin Plüss,28,Frölunda,F,46,23,16,39,42,6,11,0,0,0,0,0,0,0:00
,10,Marcus Nilson,3,Djurgården,F,48,17,22,39,110,6,7,0,0,0,0,0,0,0:00
,11,Peter Forsberg,21,MODO,F,33,13,26,39,88,4,1,0,0,0,0,0,0,0:00
,12,Johan Davidsson,76,HV71,F,50,12,26,38,2,3,5,0,0,0,0,0,0,0:00
,13,Mikael Lind,36,Brynäs,F,50,11,27,38,24,0,3,0,0,0,0,0,0,0:00
,14,Tomi Kallio,71,Frölunda,F,50,18,19,37,24,3,3,0,0,0,0,0,0,0:00
,15,Daniel Cleary,,Mora,F,47,11,26,37,138,2,2,0,0,0,0,0,0,0:00
,16,Niklas Nordgren,13,Timrå,F,46,19,17,36,71,7,9,0,0,0,0,0,0,0:00
,17,Per Ledin,97,Luleå,F,46,16,20,36,94,1,6,0,0,0,0,0,0,0:00
,18,Henrik Sedin,,MODO,F,44,14,22,36,50,3,4,0,0,0,0,0,0,0:00
,19,Fredrik Modin,,Timrå,F,43,12,24,36,58,2,6,0,0,0,0,0,0,0:00
,20,Jonas Rönnqvist,,Luleå,F,49,5,31,36,36,0,2,0,0,0,0,0,0,0:00
,21,Pelle Prestberg,10,Färjestad,F,49,21,14,35,48,8,6,0,0,0,0,0,0,0:00
,22,Jonathan Hedström,71,Timrå,F,46,14,21,35,92,3,3,0,0,0,0,0,0,0:00
,23,Tony Mårtensson,9,Linköping,F,50,13,21,34,12,5,1,0,0,0,0,0,0,0:00
,24,Rastislav Pavlikovsky,14,Mora,F,38,12,22,34,44,1,2,0,0,0,0,0,0,0:00
,25,Magnus Johansson,7,Linköping,D,47,9,25,34,26,3,4,0,0,0,0,0,0,0:00
,26,Daniel Sedin,,MODO,F,49,13,20,33,40,1,4,0,0,0,0,0,0,0:00
,27,Marian Hossa,,Mora,F,24,18,14,32,22,3,3,0,0,0,0,0,0,0:00
,28,Jonas Nordquist,39,Luleå,F,49,16,16,32,12,1,7,0,0,0,0,0,0,0:00
,29,Jonas Höglund,28,Färjestad,F,49,15,17,32,24,4,5,0,0,0,0,0,0,0:00
,30,Justin Williams,,Luleå,F,49,14,18,32,61,1,2,0,0,0,0,0,0,0:00
,31,Joakim Eriksson,10,SSK,F,48,11,21,32,26,1,3,0,0,0,0,0,0,0:00
,31,Peter Nordström,19,Färjestad,F,48,11,21,32,56,0,3,0,0,0,0,0,0,0:00
,33,Jörgen Jönsson,21,Färjestad,F,50,11,21,32,38,2,3,0,0,0,0,0,0,0:00
,34,Tomas Holmström,,Luleå,F,47,14,16,30,50,4,6,0,0,0,0,0,0,0:00
,35,Jaroslav Obsut,43,Luleå,D,49,11,19,30,50,2,6,0,0,0,0,0,0,0:00
,36,Per Svartvadet,39,MODO,F,49,8,21,29,56,0,1,0,0,0,0,0,0,0:00
,37,Peter Högardh,12,Frölunda,F,43,7,22,29,10,3,2,0,0,0,0,0,0,0:00
,38,Mikko Peltola,,Linköping,F,38,13,15,28,32,2,1,0,0,0,0,0,0,0:00
,39,Tom Koivisto,,Frölunda,D,50,9,19,28,66,1,2,0,0,0,0,0,0,0:00
,40,Fredrik Olausson,20,HV71,F,41,8,20,28,40,0,5,0,0,0,0,0,0,0:00
,41,Teemu Aalto,38,Timrå,F,50,5,23,28,56,1,4,0,0,0,0,0,0,0:00
,42,Jonas Johnson,30,Frölunda,F,48,18,9,27,34,3,5,0,0,0,0,0,0,0:00
,43,Jussi Tarvainen,40,Linköping,F,49,13,13,26,26,2,3,0,0,0,0,0,0,0:00
,44,Zdeno Chara,,Färjestad,D,33,10,15,25,132,3,5,0,0,0,0,0,0,0:00
,45,David Petrasek,22,Malmö,D,49,10,15,25,72,0,4,0,0,0,0,0,0,0:00
,46,Dick Tärnström,6,SSK,D,50,7,18,25,46,1,2,0,0,0,0,0,0,0:00
,47,Marcel Hossa,81,Mora,F,48,18,6,24,69,5,8,0,0,0,0,0,0,0:00
,48,Mariusz Czerkawski,,Djurgården,F,46,15,9,24,20,3,4,0,0,0,0,0,0,0:00
,49,Daniel Tjärnqvist,34,Djurgården,D,49,12,12,24,30,2,6,0,0,0,0,0,0,0:00
,50,Andreas Karlsson,28,HV71,F,39,11,13,24,12,2,2,0,0,0,0,0,0,0:00
,51,Per Gustafsson,7,HV71,D,46,9,15,24,44,1,3,0,0,0,0,0,0,0:00
,52,Stefan Hellkvist,,HV71,F,48,9,15,24,14,1,4,0,0,0,0,0,0,0:00
,53,Peter Andersson,,Malmö,D,44,8,16,24,74,1,1,0,0,0,0,0,0,0:00
,54,Kristian Gahn,1017,Timrå,F,46,8,16,24,22,0,1,0,0,0,0,0,0,0:00
,55,Tommi Miettinen,9,Brynäs,F,48,7,17,24,46,0,1,0,0,0,0,0,0,0:00
,56,Samuel Påhlsson,26,Frölunda,F,48,6,18,24,56,2,1,0,0,0,0,0,0,0:00
,57,Magnus Kahnberg,11,Frölunda,F,46,15,8,23,22,3,2,0,0,0,0,0,0,0:00
,58,Mika Hannula,33,Malmö,F,47,14,9,23,71,1,5,0,0,0,0,0,0,0:00
,59,Jonas Esbjörs,22,Frölunda,F,48,9,14,23,22,2,3,0,0,0,0,0,0,0:00
,60,Olli Jokinen,,SSK,F,23,13,9,22,52,0,4,0,0,0,0,0,0,0:00
,61,Vesa Viitakoski,,Brynäs,F,47,12,10,22,14,3,4,0,0,0,0,0,0,0:00
,62,Robert Döme,59,SSK,F,50,12,10,22,92,2,3,0,0,0,0,0,0,0:00
,63,Andreas Dackell,12,Brynäs,F,40,9,13,22,48,1,2,0,0,0,0,0,0,0:00
,64,Tuukka Mäntylä,4,Luleå,D,48,8,14,22,44,1,1,0,0,0,0,0,0,0:00
,65,Tommy Sjödin,7,Brynäs,D,50,7,15,22,52,1,4,0,0,0,0,0,0,0:00
,66,Henrik Malmström,9,Brynäs,F,50,12,9,21,20,0,1,0,0,0,0,0,0,0:00
,66,Markus Matthiasson,92,Malmö,F,50,12,9,21,58,0,4,0,0,0,0,0,0,0:00
,68,Jörgen Bemström,24,SSK,F,50,11,10,21,36,2,1,0,0,0,0,0,0,0:00
,69,Kim Staal,28,Malmö,F,34,10,11,21,12,2,3,0,0,0,0,0,0,0:00
,70,Valeri Krykov,1051,Timrå,F,50,7,14,21,37,0,2,0,0,0,0,0,0,0:00
,71,Yared Hagos,91,Timrå,F,49,6,15,21,38,2,0,0,0,0,0,0,0,0:00
,72,Anders Huusko,,HV71,F,48,11,9,20,28,1,4,0,0,0,0,0,0,0:00
,73,Mathias Johansson,75,Färjestad,F,47,9,11,20,40,2,0,0,0,0,0,0,0,0:00
,74,Kenneth Bergqvist,41,Mora,F,50,9,11,20,36,1,6,0,0,0,0,0,0,0:00
,75,Mikael Samuelsson,37,SSK,F,29,7,13,20,45,0,2,0,0,0,0,0,0,0:00
,76,Björn Danielsson,23,Brynäs,F,44,7,13,20,20,0,3,0,0,0,0,0,0,0:00
,77,Christian Berglund,17,Färjestad,F,48,7,13,20,97,1,0,0,0,0,0,0,0,0:00
,78,Aki-Petteri Berg,1066,Timrå,F,47,6,14,20,46,0,2,0,0,0,0,0,0,0:00
,79,Jan Huokko,,SSK,F,50,11,8,19,42,1,7,0,0,0,0,0,0,0:00
,80,Mikael Wahlberg,,Brynäs,F,28,9,10,19,24,0,4,0,0,0,0,0,0,0:00
,81,Björn Melin,9,Malmö,F,46,9,10,19,22,1,3,0,0,0,0,0,0,0:00
,82,Robert Carlsson,12,Timrå,F,50,9,10,19,18,3,3,0,0,0,0,0,0,0:00
,83,Johan Tellström,,Luleå,F,50,7,12,19,45,0,1,0,0,0,0,0,0,0:00
,83,Joel Lundqvist,20,Frölunda,F,50,7,12,19,38,0,2,0,0,0,0,0,0,0:00
,85,Dragan Umicevic,84,SSK,F,47,6,13,19,20,2,2,0,0,0,0,0,0,0:00
,86,Christian Bäckman,5,Frölunda,D,50,4,15,19,40,0,2,0,0,0,0,0,0,0:00
,87,Mikael Wahlberg,23,Malmö,F,43,2,17,19,46,0,1,0,0,0,0,0,0,0:00
,88,Daniel Rudslätt,14,Djurgården,F,50,10,8,18,50,0,4,0,0,0,0,0,0,0:00
,89,Dan Boyle,,Djurgården,D,32,9,9,18,47,1,3,0,0,0,0,0,0,0:00
,90,Ronnie Sundin,23,Frölunda,D,47,9,9,18,38,2,5,0,0,0,0,0,0,0:00
,91,Mikko Luoma,5,Malmö,D,50,9,9,18,72,3,3,0,0,0,0,0,0,0:00
,92,Andreas Jämtin,18,HV71,F,42,6,12,18,155,0,0,0,0,0,0,0,0,0:00
,93,Adam Masuhr,38,Mora,D,50,6,12,18,22,1,3,0,0,0,0,0,0,0:00
,94,Mikael Johansson,,Djurgården,F,41,3,15,18,6,0,0,0,0,0,0,0,0,0:00
,95,Patrick Thoresen,41,Djurgården,F,30,10,7,17,33,3,5,0,0,0,0,0,0,0:00
,96,Sheldon Souray,,Färjestad,D,39,9,8,17,117,0,4,0,0,0,0,0,0,0:00
,97,Thomas Koch,,Luleå,F,50,9,8,17,22,3,1,0,0,0,0,0,0,0:00
,97,Alexander Steen,20,MODO,F,50,9,8,17,26,4,1,0,0,0,0,0,0,0:00
,99,Markus Näslund,19,MODO,F,13,8,9,17,8,2,3,0,0,0,0,0,0,0:00
,100,Daniel Alfredsson,,Frölunda,F,15,8,9,17,10,1,1,0,0,0,0,0,0,0:00
,101,Per-Johan Axelsson,11,Frölunda,F,45,8,9,17,95,2,3,0,0,0,0,0,0,0:00
,102,Mathias Tjärnqvist,71,HV71,F,46,8,9,17,18,0,4,0,0,0,0,0,0,0:00
,103,Robert Carlsson,14,SSK,F,48,6,11,17,90,2,0,0,0,0,0,0,0,0:00
,104,Marko Kauppinen,6,Mora,D,50,6,11,17,32,0,2,0,0,0,0,0,0,0:00
,105,Calle Steen,,Färjestad,F,47,4,13,17,50,0,0,0,0,0,0,0,0,0:00
,106,Jari Tolsa,17,Frölunda,F,50,4,13,17,32,2,1,0,0,0,0,0,0,0:00
,107,Erik Norbäck,,SSK,F,50,1,16,17,22,1,0,0,0,0,0,0,0,0:00
,108,Linus Fagemo,,Luleå,F,50,8,8,16,32,2,1,0,0,0,0,0,0,0:00
,109,Andreas Salomonsson,15,MODO,F,30,7,9,16,46,1,3,0,0,0,0,0,0,0:00
,110,Henrik Tallinder,,Linköping,D,44,6,10,16,63,3,1,0,0,0,0,0,0,0:00
,111,Per Hallin,8,Timrå,F,49,5,11,16,60,1,0,0,0,0,0,0,0,0:00
,112,Jan-Axel Alavaara,55,Frölunda,D,49,4,12,16,48,1,4,0,0,0,0,0,0,0:00
,113,Petri Liimatainen,73,SSK,D,48,10,5,15,67,2,4,0,0,0,0,0,0,0:00
,114,Christian Söderström,82,Timrå,F,48,9,6,15,22,1,3,0,0,0,0,0,0,0:00
,115,Magnus Nilsson,24,Timrå,F,46,8,7,15,50,3,3,0,0,0,0,0,0,0:00
,116,Frans Nielsen,1015,Malmö,F,49,8,7,15,6,0,1,0,0,0,0,0,0,0:00
,117,Ove Molin,21,Brynäs,F,45,7,8,15,18,0,2,0,0,0,0,0,0,0:00
,118,Karl Fabricius,52,Luleå,F,48,7,8,15,8,1,0,0,0,0,0,0,0,0:00
,119,Per Eklund,,Linköping,F,49,6,9,15,18,1,0,0,0,0,0,0,0,0:00
,120,Jyrki Välivaara,39,Linköping,D,47,5,10,15,48,1,2,0,0,0,0,0,0,0:00
,121,Jesper Mattsson,26,Färjestad,F,48,5,10,15,47,2,3,0,0,0,0,0,0,0:00
,122,Mikael Håkanson,51,Linköping,F,46,8,6,14,24,1,0,0,0,0,0,0,0,0:00
,123,Johan Franzén,,Linköping,F,43,7,7,14,45,1,1,0,0,0,0,0,0,0:00
,124,Jesper Damgaard,7,MODO,D,44,7,7,14,28,0,3,0,0,0,0,0,0,0:00
,125,Sami Salo,,Frölunda,D,41,6,8,14,18,3,1,0,0,0,0,0,0,0:00
,126,Timmy Pettersson,33,SSK,D,49,6,8,14,36,2,2,0,0,0,0,0,0,0:00
,127,Per-Åge Skröder,10,HV71,F,50,6,8,14,77,1,1,0,0,0,0,0,0,0:00
,128,Fredrik Bremberg,73,Djurgården,F,37,5,9,14,18,0,0,0,0,0,0,0,0,0:00
,129,Loui Eriksson,,Frölunda,F,39,5,9,14,4,0,3,0,0,0,0,0,0,0:00
,130,Thomas Johansson,18,Linköping,D,39,4,10,14,22,0,1,0,0,0,0,0,0,0:00
,131,Tobias Enström,37,MODO,D,49,4,10,14,24,0,2,0,0,0,0,0,0,0:00
,132,Radek Hamr,1032,Färjestad,F,47,3,11,14,47,1,1,0,0,0,0,0,0,0:00
,133,Thomas Berglund,,Luleå,F,47,2,12,14,32,0,1,0,0,0,0,0,0,0:00
,134,Pär Styf,36,Timrå,D,45,8,5,13,94,2,3,0,0,0,0,0,0,0:00
,135,Brett Mclean,,Malmö,F,38,7,6,13,102,1,1,0,0,0,0,0,0,0:00
,136,Marcus Eriksson,,Mora,F,50,7,6,13,26,0,2,0,0,0,0,0,0,0:00
,137,Niclas Wallin,26,Luleå,D,39,6,7,13,89,2,4,0,0,0,0,0,0,0:00
,138,Hans Jonsson,5,MODO,D,49,6,7,13,46,1,3,0,0,0,0,0,0,0:00
,139,Kristofer Ottosson,9,Djurgården,F,34,4,9,13,8,0,1,0,0,0,0,0,0,0:00
,140,Antti-Jussi Niemi,7,Frölunda,D,45,4,9,13,78,0,1,0,0,0,0,0,0,0:00
,141,Calle Bergström,,Mora,D,47,4,9,13,8,0,2,0,0,0,0,0,0,0:00
,142,Peter Hammarström,,Malmö,F,50,2,11,13,30,0,0,0,0,0,0,0,0,0:00
,143,Kent Manderville,1028,Timrå,F,34,9,3,12,90,1,2,0,0,0,0,0,0,0:00
,144,Stefan Pettersson,77,HV71,F,49,8,4,12,60,3,1,0,0,0,0,0,0,0:00
,145,Jonas Soling,1011,Brynäs,F,42,5,7,12,82,2,2,0,0,0,0,0,0,0:00
,146,Håkan Bogg,33,Mora,F,48,5,7,12,32,2,0,0,0,0,0,0,0,0:00
,147,Magnus Gästrin,40,MODO,F,49,5,7,12,60,2,0,0,0,0,0,0,0,0:00
,148,Jimmie Ölvestad,19,Djurgården,F,46,4,8,12,89,0,0,0,0,0,0,0,0,0:00
,149,Jakob Johansson,26,Brynäs,F,50,3,9,12,26,1,0,0,0,0,0,0,0,0:00
,150,Pavel Skrbek,11,Mora,D,48,1,11,12,68,1,0,0,0,0,0,0,0,0:00
,151,Magnus Sandberg,,Mora,F,48,7,4,11,22,1,0,0,0,0,0,0,0,0:00
,152,Branko Radivojevic,,Luleå,F,10,6,5,11,8,1,0,0,0,0,0,0,0,0:00
,153,Mikael Renberg,19,Luleå,F,22,6,5,11,16,0,4,0,0,0,0,0,0,0:00
,154,Anders Nilsson,43,Mora,F,34,5,6,11,12,0,0,0,0,0,0,0,0,0:00
,155,Ulf Söderström,12,Linköping,F,41,5,6,11,12,0,1,0,0,0,0,0,0,0:00
,156,Sanny Lindström,8,Timrå,D,50,5,6,11,109,1,2,0,0,0,0,0,0,0:00
,156,Kalle Sahlstedt,,HV71,F,50,5,6,11,39,0,2,0,0,0,0,0,0,0:00
,156,Emil Lundberg,51,Luleå,F,50,5,6,11,26,0,0,0,0,0,0,0,0,0:00
,156,Lars Jonsson,20,Timrå,D,50,5,6,11,32,1,0,0,0,0,0,0,0,0:00
,160,Anders Burström,21,SSK,F,50,4,7,11,52,1,0,0,0,0,0,0,0,0:00
,161,Andreas Lilja,,Mora,D,44,3,8,11,67,1,0,0,0,0,0,0,0,0:00
,162,Tim Eriksson,26,Linköping,F,47,3,8,11,14,1,0,0,0,0,0,0,0,0:00
,163,Nichlas Falk,16,Djurgården,F,43,2,9,11,26,0,0,0,0,0,0,0,0,0:00
,164,Peter Nylander,11,Mora,F,49,2,9,11,12,0,0,0,0,0,0,0,0,0:00
,165,Marian Gaborik,,Färjestad,F,12,6,4,10,45,0,0,0,0,0,0,0,0,0:00
,166,Jan Hammar,,Malmö,F,49,5,5,10,18,0,0,0,0,0,0,0,0,0:00
,167,Mattias Timander,3,MODO,D,47,3,7,10,60,0,0,0,0,0,0,0,0,0:00
,168,Sebastian Sulku,,Brynäs,D,26,2,8,10,20,0,1,0,0,0,0,0,0,0:00
,169,Peter Nolander,70,Mora,D,48,2,8,10,22,0,1,0,0,0,0,0,0,0:00
,170,Anders Eriksson,8,HV71,D,32,1,9,10,54,0,1,0,0,0,0,0,0,0:00
,171,Teemu Riihijärvi,,SSK,F,50,5,4,9,96,2,0,0,0,0,0,0,0,0:00
,172,Gabriel Karlsson,49,SSK,F,44,3,6,9,14,0,0,0,0,0,0,0,0,0:00
,173,Andreas Pihl,2,Linköping,D,47,3,6,9,81,1,0,0,0,0,0,0,0,0:00
,174,Christian Eklund,20,Djurgården,F,49,3,6,9,74,0,0,0,0,0,0,0,0,0:00
,175,Fredrik Hynning,12,Luleå,F,43,0,9,9,4,0,0,0,0,0,0,0,0,0:00
,176,Roger Åkerström,28,Luleå,D,37,6,2,8,57,1,3,0,0,0,0,0,0,0:00
,177,Kimmo Timonen,,Brynäs,D,10,5,3,8,8,2,1,0,0,0,0,0,0,0:00
,178,Chris Phillips,,Brynäs,D,27,5,3,8,45,1,2,0,0,0,0,0,0,0:00
,179,Fredrik Emvall,33,Linköping,F,35,5,3,8,10,0,0,0,0,0,0,0,0,0:00
,180,Mats Trygg,46,Färjestad,D,49,5,3,8,38,1,4,0,0,0,0,0,0,0:00
,181,Ladislav Nagy,22,Mora,F,19,4,4,8,22,0,0,0,0,0,0,0,0,0:00
,182,Marcus Magnertoft,,Malmö,F,24,4,4,8,10,0,0,0,0,0,0,0,0,0:00
,183,Peter Ekelund,,HV71,F,48,4,4,8,22,0,1,0,0,0,0,0,0,0:00
,184,Per Hållberg,18,Färjestad,D,32,3,5,8,26,0,3,0,0,0,0,0,0,0:00
,185,Marcel Jenni,,Färjestad,F,25,2,6,8,6,0,1,0,0,0,0,0,0,0:00
,186,Kimmo Peltonen,,HV71,D,47,2,6,8,70,1,1,0,0,0,0,0,0,0:00
,187,Martin Lindman,4,/,D,47,1,7,8,84,0,1,0,0,0,0,0,0,0:00
,188,Arto Tukio,8,Frölunda,D,48,1,7,8,20,0,1,0,0,0,0,0,0,0:00
,189,Espen Knutsen,,Djurgården,F,15,0,8,8,12,0,0,0,0,0,0,0,0,0:00
,190,Manny Malhotra,,HV71,D,20,5,2,7,16,0,1,0,0,0,0,0,0,0:00
,191,Martin Jansson,77,Mora,F,49,5,2,7,16,0,1,0,0,0,0,0,0,0:00
,192,Christian Sjögren,14,Brynäs,F,25,3,4,7,95,0,0,0,0,0,0,0,0,0:00
,193,Pierre Hedin,21,MODO,D,31,3,4,7,28,0,1,0,0,0,0,0,0,0:00
,194,Peter Öberg,27,MODO,F,43,3,4,7,55,1,0,0,0,0,0,0,0,0:00
,195,Scott Thornton,,SSK,F,12,2,5,7,10,0,0,0,0,0,0,0,0,0:00
,196,Jan Sandström,7,Luleå,D,41,2,5,7,30,0,0,0,0,0,0,0,0,0:00
,197,Mike Comrie,,Färjestad,F,10,1,6,7,10,0,0,0,0,0,0,0,0,0:00
,198,Tomas Kollar,29,Djurgården,F,32,1,6,7,46,1,1,0,0,0,0,0,0,0:00
,199,Johan Fransson,10,Luleå,D,43,1,6,7,30,0,0,0,0,0,0,0,0,0:00
,200,Mika Strömberg,,Djurgården,D,44,1,6,7,16,0,1,0,0,0,0,0,0,0:00
,201,Daniel Casselståhl,52,Brynäs,D,48,1,6,7,34,1,0,0,0,0,0,0,0,0:00
,202,Josef Boumedienne,78,Brynäs,D,13,6,0,6,43,1,2,0,0,0,0,0,0,0:00
,203,Kyle Calder,,SSK,F,12,5,1,6,6,0,2,0,0,0,0,0,0,0:00
,204,Pasi Määttänen,,HV71,F,20,3,3,6,6,0,2,0,0,0,0,0,0,0:00
,205,Johan Svedberg,7,Timrå,D,37,3,3,6,32,0,2,0,0,0,0,0,0,0:00
,206,Emil Kåberg,27,Färjestad,F,47,3,3,6,213,1,0,0,0,0,0,0,0,0:00
,207,Pär Bäcker,24,Färjestad,F,49,3,3,6,18,0,0,0,0,0,0,0,0,0:00
,208,Adrian Aucoin,,MODO,D,14,2,4,6,32,0,1,0,0,0,0,0,0,0:00
,209,Johan Lindström,79,Linköping,F,16,2,4,6,0,0,0,0,0,0,0,0,0,0:00
,210,Robert Nilsson,,Djurgården,F,23,2,4,6,6,1,1,0,0,0,0,0,0,0:00
,211,Jonas Andersson,,/ SSK,F,41,2,4,6,10,0,0,0,0,0,0,0,0,0:00
,212,Johnny Oduya,,Djurgården,D,49,2,4,6,139,1,0,0,0,0,0,0,0,0:00
,213,Bryan Muir,,MODO,D,26,1,5,6,36,0,0,0,0,0,0,0,0,0:00
,214,Staffan Kronwall,24,/,D,38,1,5,6,47,0,0,0,0,0,0,0,0,0:00
,215,Mikko Kuparinen,,Brynäs,D,48,1,5,6,113,0,0,0,0,0,0,0,0,0:00
,216,Henrik Petré,79,Mora,D,50,1,5,6,32,0,1,0,0,0,0,0,0,0:00
,217,Rikard Franzén,,Djurgården,D,34,0,6,6,57,0,0,0,0,0,0,0,0,0:00
,218,Jonathan Cheechoo,,HV71,F,20,5,0,5,10,2,1,0,0,0,0,0,0,0:00
,219,Marc-Andre Bergeron,,Brynäs,D,10,3,2,5,72,1,0,0,0,0,0,0,0,0:00
,220,Daniel Fernholm,24,Djurgården,D,31,3,2,5,22,1,0,0,0,0,0,0,0,0:00
,221,Johan Halvardsson,27,HV71,D,36,2,3,5,46,0,0,0,0,0,0,0,0,0:00
,222,Joakim Lindström,10,MODO,F,37,2,3,5,24,0,0,0,0,0,0,0,0,0:00
,223,Johan Norgren,45,Malmö,D,49,2,3,5,42,1,0,0,0,0,0,0,0,0:00
,224,Chris Ferraro,,SSK,F,12,1,4,5,26,0,0,0,0,0,0,0,0,0:00
,225,Daniel Back,,Mora,F,27,1,4,5,6,0,0,0,0,0,0,0,0,0:00
,226,Peter Popovic,,SSK,D,36,1,4,5,34,0,0,0,0,0,0,0,0,0:00
,227,Ola Svanberg,4,HV71,D,43,1,4,5,18,0,1,0,0,0,0,0,0,0:00
,228,Daniel Glimmenvall,6,Brynäs,D,45,1,4,5,28,0,0,0,0,0,0,0,0,0:00
,229,Miska Kangasniemi,,Malmö,D,48,1,4,5,50,0,0,0,0,0,0,0,0,0:00
,230,Ronald Petrovicky,26,Brynäs,F,10,0,5,5,27,0,0,0,0,0,0,0,0,0:00
,231,Carl Söderberg,17,Malmö,F,38,0,5,5,8,0,0,0,0,0,0,0,0,0:00
,232,Fredrik Eriksson,8,Färjestad,D,40,4,0,4,22,2,0,0,0,0,0,0,0,0:00
,233,Mikko Luovi,,Brynäs,F,16,3,1,4,6,0,0,0,0,0,0,0,0,0:00
,234,Mikael Simons,78,Mora,F,43,3,1,4,4,0,0,0,0,0,0,0,0,0:00
,235,Oscar Steen,45,Färjestad,F,8,2,2,4,8,1,0,0,0,0,0,0,0,0:00
,235,Frantisek Kaberle,,MODO,D,8,2,2,4,0,0,2,0,0,0,0,0,0,0:00
,237,Marcus Kristoffersson,38,Djurgården,F,20,2,2,4,42,1,0,0,0,0,0,0,0,0:00
,237,Mattias Remstam,75,HV71,F,20,2,2,4,24,0,2,0,0,0,0,0,0,0:00
,239,Johannes Salmonsson,25,Djurgården,F,30,2,2,4,6,1,0,0,0,0,0,0,0,0:00
,240,Niclas Hävelid,28,SSK,D,46,2,2,4,60,0,1,0,0,0,0,0,0,0:00
,241,Richard Park,,Malmö,F,9,1,3,4,4,0,0,0,0,0,0,0,0,0:00
,242,Jens Karlsson,58,Frölunda,F,39,1,3,4,57,0,0,0,0,0,0,0,0,0:00
,243,Fredrik Warg,29,MODO,F,41,1,3,4,22,0,0,0,0,0,0,0,0,0:00
,244,Oscar Hedman,41,MODO,D,43,1,3,4,18,0,1,0,0,0,0,0,0,0:00
,245,Christopher Thörn,34,Djurgården,F,14,3,0,3,2,1,0,0,0,0,0,0,0,0:00
,246,Steve Staios,,Luleå,D,7,2,1,3,12,0,0,0,0,0,0,0,0,0:00
,247,Petr Sachl,,Brynäs,F,10,2,1,3,4,0,0,0,0,0,0,0,0,0:00
,248,Peter Ferraro,,SSK,F,12,2,1,3,6,0,1,0,0,0,0,0,0,0:00
,249,Dan Hinote,58,MODO,F,18,2,1,3,106,1,1,0,0,0,0,0,0,0:00
,249,Jason Deleurme,,Malmö,F,18,2,1,3,18,0,1,0,0,0,0,0,0,0:00
,251,Mike Johnson,,Färjestad,F,8,1,2,3,4,0,0,0,0,0,0,0,0,0:00
,252,Johan Andersson,17,Linköping,F,29,1,2,3,14,0,0,0,0,0,0,0,0,0:00
,253,Christoffer Norgren,29,Linköping,D,46,1,2,3,63,0,0,0,0,0,0,0,0,0:00
,253,Johan Bülow,,Linköping,F,46,1,2,3,24,0,0,0,0,0,0,0,0,0:00
,255,Janne Niinimaa,44,Malmö,D,10,0,3,3,34,0,0,0,0,0,0,0,0,0:00
,256,Morten Green,13,MODO,F,26,0,3,3,20,0,0,0,0,0,0,0,0,0:00
,257,Pasi Nurminen,,Malmö,Gk,31,0,3,3,10,0,0,0,0,0,0,0,0,0:00
,258,Fredrik Sundin,1244,Timrå,F,35,0,3,3,10,0,0,0,0,0,0,0,0,0:00
,259,Simon Skoog,98,HV71,D,36,0,3,3,10,0,0,0,0,0,0,0,0,0:00
,260,Janne Grönvall,,Färjestad,D,48,0,3,3,42,0,0,0,0,0,0,0,0,0:00
,261,Mark Mowers,,Malmö,F,9,2,0,2,0,1,0,0,0,0,0,0,0,0:00
,262,Niko Mikkola,,Mora,D,12,2,0,2,8,0,0,0,0,0,0,0,0,0:00
,263,Martin Thörnberg,10,HV71,F,28,2,0,2,18,0,0,0,0,0,0,0,0,0:00
,264,Jouni Loponen,,HV71,D,11,1,1,2,6,1,0,0,0,0,0,0,0,0:00
,265,Daniel Ljungkvist,16,HV71,D,14,1,1,2,12,1,0,0,0,0,0,0,0,0:00
,265,Magnus Hedlund,,MODO,D,14,1,1,2,8,1,0,0,0,0,0,0,0,0:00
,267,Kalle Koskinen,9,Timrå,D,21,1,1,2,6,0,0,0,0,0,0,0,0,0:00
,268,Mattias Wennerberg,26,MODO,F,34,1,1,2,18,0,0,0,0,0,0,0,0,0:00
,269,Jacob Karlsson,,Linköping,D,38,1,1,2,12,0,1,0,0,0,0,0,0,0:00
,270,Ronnie Pettersson,6,Djurgården,D,43,1,1,2,14,0,0,0,0,0,0,0,0,0:00
,271,Jan Öberg,9,MODO,F,46,1,1,2,20,0,0,0,0,0,0,0,0,0:00
,272,Nicklas Grossmann,8,SSK,D,31,0,2,2,14,0,0,0,0,0,0,0,0,0:00
,273,Peter Casparsson,,Linköping,F,45,0,2,2,16,0,0,0,0,0,0,0,0,0:00
,274,Robin Jonsson,39,Färjestad,D,47,0,2,2,12,0,0,0,0,0,0,0,0,0:00
,275,Mattias Öhlund,,Luleå,D,2,1,0,1,4,0,1,0,0,0,0,0,0,0:00
,275,Oscar Sundh,13,Djurgården,F,2,1,0,1,0,0,0,0,0,0,0,0,0,0:00
,277,Radovan Somik,,Malmö,F,8,1,0,1,6,1,0,0,0,0,0,0,0,0:00
,277,Hannes Hyvönen,23,Färjestad,F,8,1,0,1,10,0,0,0,0,0,0,0,0,0:00
,279,Bryan Mccabe,,HV71,D,10,1,0,1,30,0,1,0,0,0,0,0,0,0:00
,280,Niclas Bergfors,10,SSK,F,25,1,0,1,2,1,0,0,0,0,0,0,0,0:00
,281,Jonas Frögren,24,Färjestad,D,34,1,0,1,26,1,0,0,0,0,0,0,0,0:00
,282,Marcus Paulsson,53,Malmö,F,42,1,0,1,10,0,0,0,0,0,0,0,0,0:00
,283,Mats Hansson,1021,Timrå,F,49,1,0,1,18,0,0,0,0,0,0,0,0,0:00
,284,Todd White,,SSK,D,1,0,1,1,4,0,0,0,0,0,0,0,0,0:00
,285,Shawn Mceachern,,Malmö,F,6,0,1,1,14,0,0,0,0,0,0,0,0,0:00
,285,Paul Stanton,,Malmö,D,6,0,1,1,27,0,0,0,0,0,0,0,0,0:00
,287,Timo Hirvonen,,Malmö,F,7,0,1,1,4,0,0,0,0,0,0,0,0,0:00
,288,Patrik Hersley,6,Malmö,D,8,0,1,1,0,0,0,0,0,0,0,0,0,0:00
,288,Angel Nikolov,,Mora,D,8,0,1,1,8,0,0,0,0,0,0,0,0,0:00
,290,Per Savilahti-Nagander,,Luleå,D,25,0,1,1,14,0,0,0,0,0,0,0,0,0:00
,291,Andreas Valdix,14,Malmö,F,26,0,1,1,2,0,0,0,0,0,0,0,0,0:00
,292,Nicklas Danielsson,74,Brynäs,F,30,0,1,1,2,0,0,0,0,0,0,0,0,0:00
,293,Martin Gerber,28,Färjestad,Gk,32,0,1,1,12,0,0,0,0,0,0,0,0,0:00
,294,Niklas Andersson,24,Brynäs,D,36,0,1,1,12,0,0,0,0,0,0,0,0,0:00
,295,Kristian Antila,,Luleå,Gk,42,0,1,1,2,0,0,0,0,0,0,0,0,0:00
,296,Henrik Lundqvist,,Frölunda,Gk,48,0,1,1,2,0,0,0,0,0,0,0,0,0:00
,297,Fredrik Norrena,30,Linköping,Gk,49,0,1,1,24,0,0,0,0,0,0,0,0,0:00
,297,Johan Holmqvist,40,Brynäs,Gk,49,0,1,1,2,0,0,0,0,0,0,0,0,0:00
,299,Tero Leinonen,1,Mora,Gk,50,0,1,1,14,0,0,0,0,0,0,0,0,0:00
,300,Jesper Björck,,Brynäs,D,1,0,0,0,0,0,0,0,0,0,0,0,0,0:00
,300,Andreas Granö- Isaksson,,Djurgården,Gk,1,0,0,0,0,0,0,0,0,0,0,0,0,0:00
,300,Pierre Johnsson,2,Mora,D,1,0,0,0,0,0,0,0,0,0,0,0,0,0:00
,300,Viktor Lindgren,10,Luleå,F,1,0,0,0,0,0,0,0,0,0,0,0,0,0:00
,300,Erik Lundin,,Brynäs,D,1,0,0,0,0,0,0,0,0,0,0,0,0,0:00
,300,Robert Lukas,,Malmö,D,1,0,0,0,0,0,0,0,0,0,0,0,0,0:00
,300,Marcus Hansson,,Malmö,Gk,1,0,0,0,0,0,0,0,0,0,0,0,0,0:00
,300,Kalle Olsson,85,Frölunda,F,1,0,0,0,2,0,0,0,0,0,0,0,0,0:00
,300,Björn Hallner,,Frölunda,D,1,0,0,0,0,0,0,0,0,0,0,0,0,0:00
,300,Rickard Lidström,,Färjestad,D,1,0,0,0,0,0,0,0,0,0,0,0,0,0:00
,300,Daniel Åhsberg,22,Frölunda,F,1,0,0,0,0,0,0,0,0,0,0,0,0,0:00
,300,Nicklas Jadeland,55,Malmö,F,1,0,0,0,0,0,0,0,0,0,0,0,0,0:00
,300,Richard Östlund,,Djurgården,Gk,1,0,0,0,0,0,0,0,0,0,0,0,0,0:00
,300,Johannes Westring,,Djurgården,D,1,0,0,0,2,0,0,0,0,0,0,0,0,0:00
,300,Marcus Olsson,,Malmö,F,1,0,0,0,0,0,0,0,0,0,0,0,0,0:00
,300,Micael Andersson,,Färjestad,Gk,1,0,0,0,0,0,0,0,0,0,0,0,0,0:00
,300,Christofer Löfberg,44,Djurgården,F,1,0,0,0,0,0,0,0,0,0,0,0,0,0:00
,317,Tomas Skogs,23,Mora,D,2,0,0,0,0,0,0,0,0,0,0,0,0,0:00
,317,Johan Wackfeldt,,Brynäs,F,2,0,0,0,0,0,0,0,0,0,0,0,0,0:00
,317,Andreas Forsberg Sundin,,Linköping,F,2,0,0,0,0,0,0,0,0,0,0,0,0,0:00
,317,Linus Morin,29,Brynäs,D,2,0,0,0,0,0,0,0,0,0,0,0,0,0:00
,317,Lars Jansson,,MODO,D,2,0,0,0,0,0,0,0,0,0,0,0,0,0:00
,317,Mattias Hellström,4,MODO,F,2,0,0,0,0,0,0,0,0,0,0,0,0,0:00
,317,Stefan Ridderwall,39,Djurgården,Gk,2,0,0,0,0,0,0,0,0,0,0,0,0,0:00
,317,Albin Lorentzon,27,Linköping,D,2,0,0,0,0,0,0,0,0,0,0,0,0,0:00
,317,Jonathan Granström,31,Mora,F,2,0,0,0,2,0,0,0,0,0,0,0,0,0:00
,317,Likit Andersson,,Frölunda,D,2,0,0,0,0,0,0,0,0,0,0,0,0,0:00
,317,Erik Tägtström,,Timrå,D,2,0,0,0,0,0,0,0,0,0,0,0,0,0:00
,328,Joakim Lundström,84,Brynäs,Gk,3,0,0,0,0,0,0,0,0,0,0,0,0,0:00
,328,Jonas Lindström,,Timrå,F,3,0,0,0,2,0,0,0,0,0,0,0,0,0:00
,328,Christopher Königsson,,MODO,Gk,3,0,0,0,0,0,0,0,0,0,0,0,0,0:00
,328,Robert Öhman,,MODO,Gk,3,0,0,0,0,0,0,0,0,0,0,0,0,0:00
,328,Jonas Almtorp,16,Brynäs,F,3,0,0,0,0,0,0,0,0,0,0,0,0,0:00
,333,Pontus Sjögren,87,SSK,Gk,4,0,0,0,0,0,0,0,0,0,0,0,0,0:00
,333,Patric Blomdahl,84,Linköping,F,4,0,0,0,4,0,0,0,0,0,0,0,0,0:00
,333,Tyler Arnason,,Brynäs,F,4,0,0,0,0,0,0,0,0,0,0,0,0,0:00
,333,Fabian Eriksson,,Timrå,Gk,4,0,0,0,0,0,0,0,0,0,0,0,0,0:00
,333,Patrik Eriksson,,Brynäs,Gk,4,0,0,0,0,0,0,0,0,0,0,0,0,0:00
,333,Johan Harju,24,Luleå,F,4,0,0,0,0,0,0,0,0,0,0,0,0,0:00
,333,Johan Jonsson,20,Timrå,D,4,0,0,0,0,0,0,0,0,0,0,0,0,0:00
,340,Anze Kopitar,,SSK,F,5,0,0,0,0,0,0,0,0,0,0,0,0,0:00
,340,Linus Videll,55,SSK,F,5,0,0,0,0,0,0,0,0,0,0,0,0,0:00
,340,Tomas Wallgren,8,Luleå,F,5,0,0,0,0,0,0,0,0,0,0,0,0,0:00
,340,Fredrik Strid,,Brynäs,F,5,0,0,0,0,0,0,0,0,0,0,0,0,0:00
,344,Alexander Larsson,20,HV71,F,6,0,0,0,0,0,0,0,0,0,0,0,0,0:00
,344,Marty Turco,,Djurgården,Gk,6,0,0,0,4,0,0,0,0,0,0,0,0,0:00
,346,Erik Lindberg,,Luleå,D,7,0,0,0,0,0,0,0,0,0,0,0,0,0:00
,346,Patrik Bäärnhielm,,Luleå,D,7,0,0,0,0,0,0,0,0,0,0,0,0,0:00
,346,Rickard Nilsson,,Linköping,Gk,7,0,0,0,0,0,0,0,0,0,0,0,0,0:00
,346,Martin Spångberg,,Frölunda,Gk,7,0,0,0,0,0,0,0,0,0,0,0,0,0:00
,346,Stefan Erkgärds,4,Färjestad,D,7,0,0,0,0,0,0,0,0,0,0,0,0,0:00
,351,Mika Niskanen,99,HV71,D,8,0,0,0,8,0,0,0,0,0,0,0,0,0:00
,351,Jonas Westerling,93,Mora,F,8,0,0,0,0,0,0,0,0,0,0,0,0,0:00
,353,Mattias Karlsson,20,Brynäs,D,9,0,0,0,2,0,0,0,0,0,0,0,0,0:00
,353,Richard Demén Willaume,7,Frölunda,D,9,0,0,0,0,0,0,0,0,0,0,0,0,0:00
,355,David Rautio,30,Luleå,Gk,10,0,0,0,0,0,0,0,0,0,0,0,0,0:00
,356,Brian Boucher,,HV71,D,11,0,0,0,0,0,0,0,0,0,0,0,0,0:00
,357,Kimmo Kapanen,35,Timrå,Gk,12,0,0,0,0,0,0,0,0,0,0,0,0,0:00
,357,Peter Hirsch,15,Malmö,Gk,12,0,0,0,0,0,0,0,0,0,0,0,0,0:00
,359,Niklas Hjalmarsson,28,HV71,D,14,0,0,0,0,0,0,0,0,0,0,0,0,0:00
,360,Boo Ahl,,HV71,Gk,15,0,0,0,0,0,0,0,0,0,0,0,0,0:00
,360,Jonathan Ericsson,,SSK,D,15,0,0,0,4,0,0,0,0,0,0,0,0,0:00
,362,Cristopher Nihlstorp,41,Malmö,Gk,16,0,0,0,0,0,0,0,0,0,0,0,0,0:00
,363,Jose Theodore,,Djurgården,Gk,17,0,0,0,2,0,0,0,0,0,0,0,0,0:00
,364,Fredrik Eriksson,,Färjestad,Gk,18,0,0,0,0,0,0,0,0,0,0,0,0,0:00
,364,David Fredriksson,54,HV71,F,18,0,0,0,0,0,0,0,0,0,0,0,0,0:00
,366,Nicklas Bäckström,19,Brynäs,F,19,0,0,0,2,0,0,0,0,0,0,0,0,0:00
,367,Emmanuel Fernandez,,Luleå,Gk,20,0,0,0,0,0,0,0,0,0,0,0,0,0:00
,368,Markus Korhonen,1,Brynäs,Gk,22,0,0,0,0,0,0,0,0,0,0,0,0,0:00
,369,Antti Jokela,,/,Gk,23,0,0,0,0,0,0,0,0,0,0,0,0,0:00
,370,Gusten Törnqvist,95,Luleå,Gk,28,0,0,0,0,0,0,0,0,0,0,0,0,0:00
,371,Jonas Johansson,,Luleå,D,29,0,0,0,16,0,0,0,0,0,0,0,0,0:00
,371,Tobias Viklund,16,MODO,D,29,0,0,0,8,0,0,0,0,0,0,0,0,0:00
,371,Magnus Åkerlund,1,HV71,Gk,29,0,0,0,0,0,0,0,0,0,0,0,0,0:00
,374,Johan Björk,55,Malmö,D,31,0,0,0,6,0,0,0,0,0,0,0,0,0:00
,375,Rolf Wanhainen,,Djurgården,Gk,35,0,0,0,0,0,0,0,0,0,0,0,0,0:00
,375,Jimmy Danielsson,,Timrå,Gk,35,0,0,0,0,0,0,0,0,0,0,0,0,0:00
,377,Björn Bjurling,31,Djurgården,Gk,38,0,0,0,2,0,0,0,0,0,0,0,0,0:00
,378,Andreas Hadelöv,1,Malmö,Gk,40,0,0,0,0,0,0,0,0,0,0,0,0,0:00
,379,Bert Robertsson,,SSK,D,42,0,0,0,24,0,0,0,0,0,0,0,0,0:00
,380,Daniel Sperrle,1,Linköping,Gk,44,0,0,0,0,0,0,0,0,0,0,0,0,0:00
,380,Tommy Salo,31,MODO,Gk,44,0,0,0,14,0,0,0,0,0,0,0,0,0:00
,382,Stefan Liv,1,HV71,Gk,45,0,0,0,2,0,0,0,0,0,0,0,0,0:00
,382,Mikael Sandberg,,Frölunda,Gk,45,0,0,0,0,0,0,0,0,0,0,0,0,0:00
,384,Miikka Kiprusoff,,Timrå,Gk,48,0,0,0,2,0,0,0,0,0,0,0,0,0:00
,384,Magnus Lindquist,,SSK,Gk,48,0,0,0,0,0,0,0,0,0,0,0,0,0:00
,384,Rastislav Stana,31,SSK,Gk,48,0,0,0,0,0,0,0,0,0,0,0,0,0:00
,387,Daniel Henriksson,40,Färjestad,Gk,49,0,0,0,2,0,0,0,0,0,0,0,0,0:00
,388,Bengt Höglund,,Mora,Gk,50,0,0,0,0,0,0,0,0,0,0,0,0,0:00
,388,Michal Zajkowski,30,MODO,Gk,50,0,0,0,0,0,0,0,0,0,0,0,0,0:00
,1,Magnus Kahnberg,11,Frölunda,F,50,33,16,49,20,6,6,0,0,0,0,0,0,0:00
,2,Pelle Prestberg,10,Färjestad,F,50,22,23,45,50,4,9,0,0,0,0,0,0,0:00
,3,Joakim Eriksson,10,SSK,F,50,15,29,44,24,2,2,0,0,0,0,0,0,0:00
,4,Mikko Peltola,,Linköping,F,47,14,29,43,34,3,2,0,0,0,0,0,0,0:00
,5,Kalle Sahlstedt,,HV71,F,50,20,22,42,18,2,2,0,0,0,0,0,0,0:00
,6,Mikael Lind,36,Brynäs,F,45,14,28,42,16,1,4,0,0,0,0,0,0,0:00
,7,Tomi Kallio,71,Frölunda,F,50,24,17,41,54,6,9,0,0,0,0,0,0,0:00
,8,Andreas Salomonsson,15,MODO,F,47,13,26,39,48,3,6,0,0,0,0,0,0,0:00
,9,Johan Davidsson,76,HV71,F,49,14,24,38,8,5,2,0,0,0,0,0,0,0:00
,10,Jörgen Jönsson,21,Färjestad,F,49,16,21,37,24,1,6,0,0,0,0,0,0,0:00
,11,Niklas Andersson,24,Frölunda,F,46,17,19,36,80,3,1,0,0,0,0,0,0,0:00
,12,Jonas Rönnqvist,,Luleå,F,50,11,25,36,28,1,4,0,0,0,0,0,0,0:00
,13,Jussi Tarvainen,40,Linköping,F,48,20,15,35,26,5,4,0,0,0,0,0,0,0:00
,14,Juha Riihijärvi,19,Malmö,F,50,13,22,35,32,1,2,0,0,0,0,0,0,0:00
,15,Stefan Pettersson,77,Djurgården,F,50,18,16,34,28,7,3,0,0,0,0,0,0,0:00
,16,Niklas Persson,23,Leksand,F,50,14,20,34,42,1,0,0,0,0,0,0,0,0:00
,17,Tommi Miettinen,9,Brynäs,F,50,13,21,34,56,2,6,0,0,0,0,0,0,0:00
,18,Jonathan Hedström,71,Djurgården,F,48,12,22,34,94,1,4,0,0,0,0,0,0,0:00
,19,Jesper Mattsson,26,Malmö,F,48,19,14,33,24,3,4,0,0,0,0,0,0,0:00
,20,Peter Nordström,19,Färjestad,F,42,11,22,33,30,4,2,0,0,0,0,0,0,0:00
,21,Per Eklund,,Linköping,F,50,15,17,32,24,1,4,0,0,0,0,0,0,0:00
,22,Valeri Krykov,1051,Timrå,F,50,8,24,32,47,0,2,0,0,0,0,0,0,0:00
,23,Markus Matthiasson,92,Timrå,F,50,20,11,31,22,4,9,0,0,0,0,0,0,0:00
,24,Richard Lintner,22,Djurgården,D,41,18,13,31,73,3,5,0,0,0,0,0,0,0:00
,25,Jens Nielsen,,Leksand,F,42,9,22,31,75,2,2,0,0,0,0,0,0,0:00
,26,Patrik Zetterberg,,SSK,F,50,18,12,30,32,3,4,0,0,0,0,0,0,0:00
,27,Johan Franzén,,Linköping,F,49,12,18,30,26,2,2,0,0,0,0,0,0,0:00
,28,Mikael Wahlberg,23,Malmö,F,50,11,18,29,75,3,2,0,0,0,0,0,0,0:00
,29,Robert Döme,59,SSK,F,28,10,19,29,8,2,4,0,0,0,0,0,0,0:00
,30,Fredrik Bremberg,73,Djurgården,F,32,10,19,29,10,3,2,0,0,0,0,0,0,0:00
,31,Peter Larsson,,SSK,F,43,8,21,29,40,1,2,0,0,0,0,0,0,0:00
,32,Hannes Hyvönen,23,Färjestad,F,47,15,13,28,98,2,6,0,0,0,0,0,0,0:00
,33,Jonas Johnson,30,Frölunda,F,49,14,14,28,68,2,4,0,0,0,0,0,0,0:00
,34,Brian Felsner,,Linköping,F,38,13,15,28,63,1,4,0,0,0,0,0,0,0:00
,35,Niklas Nordgren,13,Timrå,F,46,13,15,28,44,2,5,0,0,0,0,0,0,0:00
,36,Per-Åge Skröder,10,HV71,F,50,11,17,28,138,2,6,0,0,0,0,0,0,0:00
,37,Jari Tolsa,17,Frölunda,F,50,8,20,28,36,2,2,0,0,0,0,0,0,0:00
,38,Mikael Johansson,,Djurgården,F,47,10,17,27,10,2,1,0,0,0,0,0,0,0:00
,39,Per Gustafsson,7,HV71,D,32,4,23,27,32,1,0,0,0,0,0,0,0,0:00
,40,Robert Carlsson,12,Timrå,F,50,17,9,26,16,2,10,0,0,0,0,0,0,0:00
,41,Johan Rosén,,Leksand,F,50,14,12,26,52,1,7,0,0,0,0,0,0,0:00
,42,Marcel Jenni,,Färjestad,F,50,13,13,26,50,1,1,0,0,0,0,0,0,0:00
,43,Radek Hamr,1032,Färjestad,F,44,11,15,26,22,5,7,0,0,0,0,0,0,0:00
,44,Niklas Anger,17,Brynäs,F,50,11,15,26,26,4,1,0,0,0,0,0,0,0:00
,45,Tim Eriksson,26,Linköping,F,50,10,16,26,39,3,1,0,0,0,0,0,0,0:00
,46,Mattias Remstam,75,HV71,F,46,9,17,26,75,1,2,0,0,0,0,0,0,0:00
,47,Magnus Wernblom,9,MODO,F,47,14,11,25,88,1,1,0,0,0,0,0,0,0:00
,48,Daniel Rudslätt,14,Djurgården,F,48,14,11,25,30,3,2,0,0,0,0,0,0,0:00
,49,Anders Huusko,,HV71,F,49,12,13,25,24,4,3,0,0,0,0,0,0,0:00
,50,Jörgen Bemström,24,SSK,F,49,10,15,25,18,1,0,0,0,0,0,0,0,0:00
,51,Björn Danielsson,23,Brynäs,F,50,15,9,24,46,1,3,0,0,0,0,0,0,0:00
,52,Jonas Nordquist,39,Luleå,F,47,13,11,24,18,3,1,0,0,0,0,0,0,0:00
,53,Juha Lind,,SSK,F,49,13,11,24,28,5,2,0,0,0,0,0,0,0:00
,54,Jani Hassinen,,HV71,F,41,11,13,24,43,4,4,0,0,0,0,0,0,0:00
,55,Alexander Steen,20,Frölunda,F,48,10,14,24,50,3,3,0,0,0,0,0,0,0:00
,56,Tommy Sjödin,7,Brynäs,D,49,9,15,24,50,1,3,0,0,0,0,0,0,0:00
,56,Jan Huokko,,SSK,F,49,9,15,24,22,0,3,0,0,0,0,0,0,0:00
,58,David Petrasek,22,Malmö,D,49,8,16,24,123,3,2,0,0,0,0,0,0,0:00
,59,Kim Staal,28,Malmö,F,45,15,8,23,14,4,1,0,0,0,0,0,0,0:00
,60,Henrik Nordfeldt,,Leksand,F,50,12,11,23,52,2,6,0,0,0,0,0,0,0:00
,61,Ulf Söderström,12,Färjestad,F,49,9,14,23,24,3,1,0,0,0,0,0,0,0:00
,61,Joel Lundqvist,20,Frölunda,F,49,9,14,23,48,1,2,0,0,0,0,0,0,0:00
,63,Peter Andersson,,Malmö,D,46,2,21,23,55,0,0,0,0,0,0,0,0,0:00
,64,Fredrik Emvall,33,Linköping,F,48,11,11,22,55,2,2,0,0,0,0,0,0,0:00
,65,Kalle Koskinen,9,Timrå,D,48,8,14,22,56,1,4,0,0,0,0,0,0,0:00
,66,Rastislav Pavlikovsky,14,Leksand,F,34,7,15,22,57,1,0,0,0,0,0,0,0,0:00
,67,Ove Molin,21,Brynäs,F,38,7,15,22,14,2,4,0,0,0,0,0,0,0:00
,68,Johan Tellström,,Luleå,F,46,10,11,21,22,1,1,0,0,0,0,0,0,0:00
,69,Marcus Magnertoft,,Malmö,F,48,10,11,21,16,2,4,0,0,0,0,0,0,0:00
,70,Peter Ekelund,,HV71,F,49,10,11,21,42,1,2,0,0,0,0,0,0,0:00
,71,Fredrik Olausson,20,HV71,F,45,8,13,21,44,0,4,0,0,0,0,0,0,0:00
,72,Kamil Brabenec,,Luleå,F,46,6,15,21,30,2,1,0,0,0,0,0,0,0:00
,73,Per Svartvadet,39,MODO,F,35,13,7,20,10,1,3,0,0,0,0,0,0,0:00
,74,Pasi Määttänen,,HV71,F,41,13,7,20,30,3,2,0,0,0,0,0,0,0:00
,75,Linus Fagemo,,Luleå,F,46,13,7,20,34,2,2,0,0,0,0,0,0,0:00
,76,Yared Hagos,91,Timrå,F,48,9,11,20,75,1,0,0,0,0,0,0,0,0:00
,77,Mathias Johansson,75,Färjestad,F,50,6,14,20,24,0,1,0,0,0,0,0,0,0:00
,78,Mats Trygg,46,Färjestad,D,49,13,6,19,30,3,4,0,0,0,0,0,0,0:00
,79,Johan Witehall,,Leksand,F,49,11,8,19,61,2,3,0,0,0,0,0,0,0:00
,80,Magnus Nilsson,24,Luleå,F,49,10,9,19,60,4,4,0,0,0,0,0,0,0:00
,81,Kristofer Ottosson,9,Djurgården,F,50,7,12,19,16,1,1,0,0,0,0,0,0,0:00
,82,Nichlas Falk,16,Djurgården,F,42,6,13,19,20,1,1,0,0,0,0,0,0,0:00
,83,Pekka Tirkkonen,,Linköping,F,43,3,16,19,12,1,1,0,0,0,0,0,0,0:00
,84,Peter Högardh,12,MODO,F,36,8,10,18,6,1,0,0,0,0,0,0,0,0:00
,85,Björn Melin,9,HV71,F,47,7,11,18,28,2,1,0,0,0,0,0,0,0:00
,85,Magnus Hedlund,,MODO,D,47,7,11,18,69,3,3,0,0,0,0,0,0,0:00
,87,Mikael Håkanson,51,Linköping,F,35,6,12,18,24,1,2,0,0,0,0,0,0,0:00
,88,Anders Söderberg,26,MODO,F,47,6,12,18,8,2,1,0,0,0,0,0,0,0:00
,89,Andreas Jämtin,18,HV71,F,39,5,13,18,105,1,1,0,0,0,0,0,0,0:00
,90,Antti-Jussi Niemi,7,Frölunda,D,47,4,14,18,74,0,2,0,0,0,0,0,0,0:00
,91,Peter Nylander,11,Brynäs,F,49,9,8,17,18,2,1,0,0,0,0,0,0,0:00
,92,Christian Eklund,20,Djurgården,F,42,8,9,17,56,2,1,0,0,0,0,0,0,0:00
,93,Per Hållberg,18,Färjestad,D,48,8,9,17,30,2,0,0,0,0,0,0,0,0:00
,94,Robert Carlsson,14,SSK,F,50,8,9,17,28,1,2,0,0,0,0,0,0,0:00
,95,Gabriel Karlsson,49,SSK,F,50,7,10,17,65,0,0,0,0,0,0,0,0,0:00
,96,Oscar Ackeström,25,Frölunda,D,43,6,11,17,109,1,0,0,0,0,0,0,0,0:00
,97,Greger Artursson,,Färjestad,D,50,6,11,17,34,0,3,0,0,0,0,0,0,0:00
,97,Per Hallin,8,Timrå,F,50,6,11,17,65,1,2,0,0,0,0,0,0,0:00
,99,Lubomir Sekeras,77,SSK,D,33,4,13,17,30,1,3,0,0,0,0,0,0,0:00
,100,Thomas Berglund,,Luleå,F,40,4,13,17,164,1,2,0,0,0,0,0,0,0:00
,101,Henrik Malmström,9,Brynäs,F,49,9,7,16,22,1,1,0,0,0,0,0,0,0:00
,102,Frans Nielsen,1015,Malmö,F,50,9,7,16,28,2,2,0,0,0,0,0,0,0:00
,103,Karl Fabricius,52,Luleå,F,34,8,8,16,22,1,2,0,0,0,0,0,0,0:00
,104,Richard Pavlikovsky,,Leksand,D,50,8,8,16,20,0,3,0,0,0,0,0,0,0:00
,105,Kenneth Bergqvist,41,Djurgården,F,49,7,9,16,24,2,1,0,0,0,0,0,0,0:00
,106,Niklas Eriksson,,Leksand,F,50,7,9,16,38,1,0,0,0,0,0,0,0,0:00
,107,Tuukka Mäntylä,4,Luleå,D,43,6,10,16,67,1,4,0,0,0,0,0,0,0:00
,108,Morten Green,13,MODO,F,44,6,10,16,36,2,2,0,0,0,0,0,0,0:00
,109,Petri Liimatainen,73,Malmö,D,50,5,11,16,51,1,1,0,0,0,0,0,0,0:00
,110,Jens Karlsson,58,Frölunda,F,50,3,13,16,62,0,1,0,0,0,0,0,0,0:00
,111,Jyrki Välivaara,39,Linköping,D,48,2,14,16,36,1,1,0,0,0,0,0,0,0:00
,112,Jonas Esbjörs,22,Frölunda,F,48,10,5,15,48,3,3,0,0,0,0,0,0,0:00
,113,Mika Niskanen,99,HV71,D,50,7,8,15,57,2,2,0,0,0,0,0,0,0:00
,113,Christer Olsson,,Leksand,D,50,7,8,15,54,2,3,0,0,0,0,0,0,0:00
,115,Fredrik Warg,29,MODO,F,41,6,9,15,26,1,2,0,0,0,0,0,0,0:00
,116,Peter Hammarström,,Färjestad,F,47,6,9,15,51,0,0,0,0,0,0,0,0,0:00
,117,Per Ledin,97,Luleå,F,50,6,9,15,112,2,1,0,0,0,0,0,0,0:00
,117,Jesper Damgaard,7,MODO,D,50,6,9,15,51,1,3,0,0,0,0,0,0,0:00
,119,Jouni Loponen,,HV71,D,49,5,10,15,40,1,4,0,0,0,0,0,0,0:00
,120,Hans Huczkowski,26,Luleå,F,44,4,11,15,8,0,2,0,0,0,0,0,0,0:00
,121,Tomas Kollar,29,Djurgården,F,50,6,8,14,22,0,2,0,0,0,0,0,0,0:00
,122,Johan Bülow,,Linköping,F,50,5,9,14,38,0,0,0,0,0,0,0,0,0:00
,123,Thomas Johansson,18,Linköping,D,50,3,11,14,46,3,2,0,0,0,0,0,0,0:00
,124,Loui Eriksson,,Frölunda,F,46,8,5,13,4,1,1,0,0,0,0,0,0,0:00
,125,Christian Söderström,82,Timrå,F,48,7,6,13,62,4,1,0,0,0,0,0,0,0:00
,126,Pär Bäcker,24,Färjestad,F,49,7,6,13,24,2,0,0,0,0,0,0,0,0:00
,127,Jakob Johansson,26,Brynäs,F,50,7,6,13,34,2,1,0,0,0,0,0,0,0:00
,128,Jonas Soling,1011,Brynäs,F,49,5,8,13,53,1,1,0,0,0,0,0,0,0:00
,129,Martin Lindman,4,Färjestad,D,41,3,10,13,64,0,0,0,0,0,0,0,0,0:00
,130,Fredrik Svensson,4,Leksand,D,48,3,10,13,111,1,1,0,0,0,0,0,0,0:00
,131,Kristian Gahn,1017,SSK /,F,50,3,10,13,36,0,1,0,0,0,0,0,0,0:00
,132,Ronnie Sundin,23,Frölunda,D,48,2,11,13,16,0,1,0,0,0,0,0,0,0:00
,133,Stefan Hellkvist,,HV71,F,24,8,4,12,6,2,2,0,0,0,0,0,0,0:00
,134,Daniel Glimmenvall,6,Brynäs,D,49,6,6,12,32,0,1,0,0,0,0,0,0,0:00
,135,Per Lundell,,Leksand,D,50,6,6,12,12,1,1,0,0,0,0,0,0,0:00
,136,Tobias Holm,,Leksand,F,45,4,8,12,108,2,0,0,0,0,0,0,0,0:00
,137,Jan Nemecek,,Timrå,D,50,4,8,12,18,0,2,0,0,0,0,0,0,0:00
,138,Lars Jonsson,20,Leksand,D,50,3,9,12,30,0,1,0,0,0,0,0,0,0:00
,139,Calle Steen,,Färjestad,F,43,2,10,12,42,0,1,0,0,0,0,0,0,0:00
,140,Jan-Axel Alavaara,55,Frölunda,D,50,2,10,12,98,1,0,0,0,0,0,0,0,0:00
,141,Martin Thörnberg,10,HV71,F,47,7,4,11,71,1,0,0,0,0,0,0,0,0:00
,142,Teemu Riihijärvi,,SSK,F,34,5,6,11,48,0,1,0,0,0,0,0,0,0:00
,143,Daniel Fernholm,24,Djurgården,D,37,4,7,11,28,0,2,0,0,0,0,0,0,0:00
,144,Kent Manderville,1028,Timrå,F,23,3,8,11,18,1,0,0,0,0,0,0,0,0:00
,145,Martin Johansson,,MODO,D,49,3,8,11,14,0,1,0,0,0,0,0,0,0:00
,146,Dieter Kalt,74,Färjestad,F,45,2,9,11,26,0,1,0,0,0,0,0,0,0:00
,147,Jan Sandström,7,Luleå,D,49,1,10,11,20,0,1,0,0,0,0,0,0,0:00
,148,Janne Grönvall,,Färjestad,D,50,1,10,11,98,0,0,0,0,0,0,0,0,0:00
,148,Kimmo Eronen,,Frölunda,D,50,1,10,11,20,1,1,0,0,0,0,0,0,0:00
,150,Joonas Jääskeläinen,,Leksand,F,24,6,4,10,2,0,0,0,0,0,0,0,0,0:00
,151,Martin Knold,,Linköping,D,34,6,4,10,20,0,1,0,0,0,0,0,0,0:00
,152,Pär Styf,36,Timrå,D,43,6,4,10,79,2,3,0,0,0,0,0,0,0:00
,153,Christian Sjögren,14,Timrå,F,50,6,4,10,73,2,2,0,0,0,0,0,0,0:00
,154,Jonas Frögren,24,Färjestad,D,47,5,5,10,38,2,3,0,0,0,0,0,0,0:00
,155,Timmy Pettersson,33,/ SSK,D,46,4,6,10,24,1,1,0,0,0,0,0,0,0:00
,156,Björn Nord,,Djurgården,D,20,3,7,10,24,1,0,0,0,0,0,0,0,0:00
,157,Christoffer Norgren,29,Linköping,D,49,3,7,10,81,2,0,0,0,0,0,0,0,0:00
,158,Mikael Pettersson,19,Leksand,F,47,2,8,10,34,1,0,0,0,0,0,0,0,0:00
,159,Peter Ström,1047,Frölunda,F,50,2,8,10,43,0,1,0,0,0,0,0,0,0:00
,160,Peter Popovic,,SSK,D,49,1,9,10,61,0,1,0,0,0,0,0,0,0:00
,161,Johan Lindström,79,Linköping,F,50,8,1,9,6,1,1,0,0,0,0,0,0,0:00
,162,Antti Törmänen,,SSK,F,25,6,3,9,26,0,3,0,0,0,0,0,0,0:00
,163,Tommy Pettersson,,MODO,F,50,6,3,9,12,2,1,0,0,0,0,0,0,0:00
,164,Richard Kapus,,Luleå,F,14,4,5,9,2,0,0,0,0,0,0,0,0,0:00
,165,Hans Jonsson,5,MODO,D,28,4,5,9,38,2,1,0,0,0,0,0,0,0:00
,166,Erik Kakko,,Frölunda,D,50,4,5,9,28,0,3,0,0,0,0,0,0,0:00
,167,Johan Norgren,45,Malmö,D,50,3,6,9,52,0,2,0,0,0,0,0,0,0:00
,168,Roger Åkerström,28,Luleå,D,38,6,2,8,20,3,4,0,0,0,0,0,0,0:00
,169,Simon Skoog,98,HV71,D,49,6,2,8,47,0,0,0,0,0,0,0,0,0:00
,170,Jan Öberg,9,MODO,F,50,5,3,8,20,2,1,0,0,0,0,0,0,0:00
,171,Marcus Kristoffersson,38,Djurgården,F,31,4,4,8,125,0,1,0,0,0,0,0,0,0:00
,172,Pavel Skrbek,11,Luleå,D,34,4,4,8,84,1,0,0,0,0,0,0,0,0:00
,173,Johnny Oduya,,Djurgården,D,42,4,4,8,173,1,1,0,0,0,0,0,0,0:00
,174,Fredrik Eriksson,8,Färjestad,D,35,3,5,8,29,1,0,0,0,0,0,0,0,0:00
,175,Jacob Karlsson,,Linköping,D,48,2,6,8,28,1,0,0,0,0,0,0,0,0:00
,176,Mika Lehtinen,,MODO,D,50,2,6,8,76,1,1,0,0,0,0,0,0,0:00
,177,Peter Casparsson,,Linköping,F,30,4,3,7,24,1,0,0,0,0,0,0,0,0:00
,178,Mattias Wennerberg,26,MODO,F,50,4,3,7,34,1,1,0,0,0,0,0,0,0:00
,179,Robert Nordmark,,Djurgården,D,14,3,4,7,10,0,2,0,0,0,0,0,0,0:00
,180,Peter Messa,,SSK,D,38,3,4,7,16,2,0,0,0,0,0,0,0,0:00
,181,Veli-Pekka Laitinen,33,Brynäs,F,48,2,5,7,22,1,0,0,0,0,0,0,0,0:00
,182,Lee Jinman,,Timrå,F,30,1,6,7,14,0,0,0,0,0,0,0,0,0:00
,183,Jesper Jäger,,Timrå,D,48,0,7,7,60,0,0,0,0,0,0,0,0,0:00
,184,Mika Strömberg,,Djurgården,D,24,6,0,6,24,2,5,0,0,0,0,0,0,0:00
,185,Nicklas Danielsson,74,Brynäs,F,47,6,0,6,22,0,2,0,0,0,0,0,0,0:00
,186,Erik Norbäck,,SSK,F,15,4,2,6,4,1,1,0,0,0,0,0,0,0:00
,187,Andreas Pihl,2,Linköping,D,50,4,2,6,64,0,1,0,0,0,0,0,0,0:00
,188,Emil Lundberg,51,Luleå,F,38,3,3,6,12,0,1,0,0,0,0,0,0,0:00
,189,Johan Fransson,10,Luleå,D,44,3,3,6,28,0,0,0,0,0,0,0,0,0:00
,190,Daniel Rydmark,,Malmö,F,47,3,3,6,102,0,2,0,0,0,0,0,0,0:00
,191,Roger Kyrö,,Brynäs,F,27,2,4,6,2,0,0,0,0,0,0,0,0,0:00
,192,Robert Nilsson,,Leksand,F,34,2,4,6,6,0,0,0,0,0,0,0,0,0:00
,193,Stefan Bemström,22,SSK,D,39,2,4,6,16,0,0,0,0,0,0,0,0,0:00
,194,Peter Öberg,27,MODO,F,46,2,4,6,53,0,1,0,0,0,0,0,0,0:00
,195,Stefan Nilsson,,Luleå,F,22,1,5,6,18,0,0,0,0,0,0,0,0,0:00
,196,Staffan Kronwall,24,Djurgården,D,44,1,5,6,54,0,0,0,0,0,0,0,0,0:00
,196,Jonas Johansson,,Luleå,D,44,1,5,6,28,0,0,0,0,0,0,0,0,0:00
,198,Jonas Elofsson,,Leksand,D,45,1,5,6,40,0,0,0,0,0,0,0,0,0:00
,199,Niklas Sundblad,,Malmö,F,50,1,5,6,110,1,0,0,0,0,0,0,0,0:00
,200,Mikko Kuparinen,,Brynäs,D,48,0,6,6,113,0,0,0,0,0,0,0,0,0:00
,201,Göran Hermansson,,Leksand,F,49,4,1,5,41,0,0,0,0,0,0,0,0,0:00
,202,Tommy Westlund,,Leksand,F,14,3,2,5,6,0,1,0,0,0,0,0,0,0:00
,203,Espen Knutsen,,Djurgården,F,6,2,3,5,4,0,0,0,0,0,0,0,0,0:00
,204,Clas Eriksson,,Färjestad,F,28,2,3,5,12,0,0,0,0,0,0,0,0,0:00
,205,Joakim Lundberg,,Malmö,D,35,2,3,5,36,0,0,0,0,0,0,0,0,0:00
,206,Tommi Rajamäki,,Timrå,D,43,2,3,5,26,0,1,0,0,0,0,0,0,0:00
,207,Andreas Valdix,14,Malmö,F,47,2,3,5,8,0,0,0,0,0,0,0,0,0:00
,208,Jesper Björck,,Brynäs,D,48,2,3,5,74,2,1,0,0,0,0,0,0,0:00
,209,Magnus Gästrin,40,MODO,F,49,2,3,5,16,0,0,0,0,0,0,0,0,0:00
,210,Tobias Enström,37,MODO,D,33,1,4,5,6,0,0,0,0,0,0,0,0,0:00
,211,Jari Kauppila,33,Leksand,F,7,3,1,4,6,0,2,0,0,0,0,0,0,0:00
,212,Daniel Casselståhl,52,Brynäs,D,26,3,1,4,10,0,3,0,0,0,0,0,0,0:00
,213,Jonas Hägerbäck,,Luleå,F,31,3,1,4,28,1,1,0,0,0,0,0,0,0:00
,214,Sebastian Meijer,13,HV71,F,21,2,2,4,2,0,1,0,0,0,0,0,0,0:00
,215,Fredrik Sundin,1244,Timrå,F,46,2,2,4,20,1,0,0,0,0,0,0,0,0:00
,216,Bert Robertsson,,SSK,D,48,2,2,4,109,0,0,0,0,0,0,0,0,0:00
,217,Jan Hammar,,Malmö,F,49,2,2,4,16,0,0,0,0,0,0,0,0,0:00
,218,Toni Koivunen,,Timrå,F,15,1,3,4,4,1,1,0,0,0,0,0,0,0:00
,219,Kari Haakana,32,MODO,D,31,1,3,4,50,0,1,0,0,0,0,0,0,0:00
,220,Ronnie Pettersson,6,Djurgården,D,44,1,3,4,30,0,1,0,0,0,0,0,0,0:00
,221,Sanny Lindström,8,Timrå,D,48,1,3,4,91,0,0,0,0,0,0,0,0,0:00
,221,Fredrik Johansson,12,Frölunda,F,48,1,3,4,6,0,0,0,0,0,0,0,0,0:00
,223,Magnus Österby,,Malmö,D,50,1,3,4,94,0,0,0,0,0,0,0,0,0:00
,224,Johan Halvardsson,27,HV71,D,11,0,4,4,39,0,0,0,0,0,0,0,0,0:00
,225,Dusan Milo,,MODO,D,26,2,1,3,16,0,0,0,0,0,0,0,0,0:00
,226,Bobbie Hagelin,,SSK,F,33,2,1,3,4,0,0,0,0,0,0,0,0,0:00
,227,Oscar Hedman,41,MODO,D,24,1,2,3,6,0,0,0,0,0,0,0,0,0:00
,228,Ola Thorwalls,,HV71,D,33,1,2,3,24,1,0,0,0,0,0,0,0,0:00
,229,Daniel Ljungkvist,16,/ SSK,D,47,1,2,3,36,0,1,0,0,0,0,0,0,0:00
,230,Mats Hansson,1021,Timrå,F,49,1,2,3,30,1,1,0,0,0,0,0,0,0:00
,231,Johannes Salmonsson,25,Djurgården,F,25,0,3,3,4,0,0,0,0,0,0,0,0,0:00
,232,Hans Lodin,,Leksand,D,16,2,0,2,16,0,0,0,0,0,0,0,0,0:00
,233,Toivo Suursoo,,Malmö,F,22,2,0,2,35,0,0,0,0,0,0,0,0,0:00
,234,Jimmie Svensson,,Malmö,F,31,2,0,2,6,0,0,0,0,0,0,0,0,0:00
,235,Patrik Bäärnhielm,,Luleå,D,5,1,1,2,2,0,0,0,0,0,0,0,0,0:00
,236,Carl Söderberg,17,Malmö,F,24,1,1,2,8,1,0,0,0,0,0,0,0,0:00
,237,Adam Masuhr,38,Brynäs,D,26,1,1,2,4,0,0,0,0,0,0,0,0,0:00
,238,Joakim Lindström,10,MODO,F,15,0,2,2,0,0,0,0,0,0,0,0,0,0:00
,239,Linus Videll,55,SSK,F,23,0,2,2,0,0,0,0,0,0,0,0,0,0:00
,240,Jonas Andersson Junkka,,Luleå,D,32,0,2,2,26,0,0,0,0,0,0,0,0,0:00
,241,Andreas Hadelöv,1,Malmö,Gk,50,0,2,2,6,0,0,0,0,0,0,0,0,0:00
,241,Anders Back,,SSK,D,50,0,2,2,30,0,0,0,0,0,0,0,0,0:00
,243,Linus Stensson,,Djurgården,F,1,1,0,1,0,0,0,0,0,0,0,0,0,0:00
,244,Alexander Semjonov,,Leksand,F,2,1,0,1,0,0,0,0,0,0,0,0,0,0:00
,245,Kalle Olsson,85,Frölunda,F,4,1,0,1,0,1,0,0,0,0,0,0,0,0:00
,246,Lars Jansson,,MODO,D,17,1,0,1,10,0,0,0,0,0,0,0,0,0:00
,247,Johan Björk,55,Malmö,D,27,1,0,1,6,1,0,0,0,0,0,0,0,0:00
,248,Pierre Berggren,,Luleå,F,34,1,0,1,2,1,0,0,0,0,0,0,0,0:00
,249,Jonathan Ericsson,,SSK,D,42,1,0,1,12,0,0,0,0,0,0,0,0,0:00
,250,Jonas Leetma,,Frölunda,D,47,1,0,1,8,0,0,0,0,0,0,0,0,0:00
,251,Robert Nordberg,,Djurgården,F,6,0,1,1,4,0,0,0,0,0,0,0,0,0:00
,252,Lasse Degn,,Malmö,F,7,0,1,1,4,0,0,0,0,0,0,0,0,0:00
,253,Petter Nilsson,,Luleå,D,8,0,1,1,4,0,0,0,0,0,0,0,0,0:00
,253,Rikk-Petteri Lehtonen,,Leksand,D,8,0,1,1,6,0,0,0,0,0,0,0,0,0:00
,255,Maurice Rozenthal,,Leksand,F,10,0,1,1,2,0,0,0,0,0,0,0,0,0:00
,255,Henrik Petré,79,Brynäs,D,10,0,1,1,6,0,0,0,0,0,0,0,0,0:00
,257,Urban Omark,,SSK,F,13,0,1,1,6,0,0,0,0,0,0,0,0,0:00
,258,Emil Kåberg,27,Färjestad,F,15,0,1,1,6,0,0,0,0,0,0,0,0,0:00
,259,Ragnar Karlsson,27,Linköping,F,25,0,1,1,10,0,0,0,0,0,0,0,0,0:00
,260,Robert Borgqvist,,Malmö,Gk,27,0,1,1,2,0,0,0,0,0,0,0,0,0:00
,261,Stefan Liv,1,HV71,Gk,42,0,1,1,6,0,0,0,0,0,0,0,0,0:00
,262,Johan Berggren,,SSK,D,43,0,1,1,20,0,0,0,0,0,0,0,0,0:00
,262,Mike Bales,,Leksand,Gk,43,0,1,1,2,0,0,0,0,0,0,0,0,0:00
,264,Markus Korhonen,1,Brynäs,Gk,50,0,1,1,2,0,0,0,0,0,0,0,0,0:00
,264,Juuso Riksman,30,MODO,Gk,50,0,1,1,4,0,0,0,0,0,0,0,0,0:00
,266,Nicklas Grossmann,8,SSK,D,1,0,0,0,0,0,0,0,0,0,0,0,0,0:00
,266,Kristian Henriksson,,Djurgården,Gk,1,0,0,0,0,0,0,0,0,0,0,0,0,0:00
,266,Alexander Håkansson,,Timrå,F,1,0,0,0,0,0,0,0,0,0,0,0,0,0:00
,266,Johan Karlsson,,Luleå,F,1,0,0,0,0,0,0,0,0,0,0,0,0,0:00
,266,Daniel Åhsberg,22,Frölunda,F,1,0,0,0,0,0,0,0,0,0,0,0,0,0:00
,266,Alexander Blomqvist,,SSK,Gk,1,0,0,0,0,0,0,0,0,0,0,0,0,0:00
,266,Linus Persson,25,Frölunda,F,1,0,0,0,0,0,0,0,0,0,0,0,0,0:00
,266,Marcus Mellbin,,Färjestad,Gk,1,0,0,0,0,0,0,0,0,0,0,0,0,0:00
,266,Niklas Sjölund,,Djurgården,Gk,1,0,0,0,0,0,0,0,0,0,0,0,0,0:00
,266,Martin Spångberg,,Frölunda,Gk,1,0,0,0,0,0,0,0,0,0,0,0,0,0:00
,266,Espen Olsen Lie,,Timrå,F,1,0,0,0,0,0,0,0,0,0,0,0,0,0:00
,266,Christoffer Brännström,,Luleå,D,1,0,0,0,0,0,0,0,0,0,0,0,0,0:00
,266,Mattias Modig,33,Luleå,Gk,1,0,0,0,0,0,0,0,0,0,0,0,0,0:00
,279,Andreas Granö- Isaksson,,Djurgården,Gk,2,0,0,0,0,0,0,0,0,0,0,0,0,0:00
,279,Fredrik Jonsson,,HV71,F,2,0,0,0,0,0,0,0,0,0,0,0,0,0:00
,279,Niko Halttunen,,SSK,F,2,0,0,0,0,0,0,0,0,0,0,0,0,0:00
,279,Joel Davis,,Linköping,Gk,2,0,0,0,0,0,0,0,0,0,0,0,0,0:00
,279,Niklas Andersson,24,Brynäs,D,2,0,0,0,0,0,0,0,0,0,0,0,0,0:00
,279,Patrik Eriksson,,Brynäs,Gk,2,0,0,0,0,0,0,0,0,0,0,0,0,0:00
,279,Stefan Svanbom,,Brynäs,D,2,0,0,0,0,0,0,0,0,0,0,0,0,0:00
,279,Per Thunberg,,Linköping,F,2,0,0,0,0,0,0,0,0,0,0,0,0,0:00
,279,David Rautio,30,Luleå,Gk,2,0,0,0,0,0,0,0,0,0,0,0,0,0:00
,279,André Selander,,Malmö,F,2,0,0,0,0,0,0,0,0,0,0,0,0,0:00
,279,Stanislav Valach,,SSK,F,2,0,0,0,0,0,0,0,0,0,0,0,0,0:00
,279,Adrian Ahrling,,Timrå,F,2,0,0,0,0,0,0,0,0,0,0,0,0,0:00
,279,Peter Sundqvist,,Timrå,D,2,0,0,0,0,0,0,0,0,0,0,0,0,0:00
,279,Jens Lodén,,Brynäs,Gk,2,0,0,0,0,0,0,0,0,0,0,0,0,0:00
,279,Mattias Hellström,4,MODO,F,2,0,0,0,0,0,0,0,0,0,0,0,0,0:00
,279,Rickard Johansson,,Timrå,F,2,0,0,0,0,0,0,0,0,0,0,0,0,0:00
,295,Peter Klitsie,,Linköping,D,3,0,0,0,0,0,0,0,0,0,0,0,0,0:00
,295,Oscar Sundh,13,Djurgården,F,3,0,0,0,0,0,0,0,0,0,0,0,0,0:00
,295,Mikael Öberg,,Djurgården,F,3,0,0,0,2,0,0,0,0,0,0,0,0,0:00
,295,Patrick Thoresen,41,Djurgården,F,3,0,0,0,2,0,0,0,0,0,0,0,0,0:00
,295,Joachim Gellerstedt,,Djurgården,F,3,0,0,0,0,0,0,0,0,0,0,0,0,0:00
,295,Mishail Joukov,,HV71,F,3,0,0,0,0,0,0,0,0,0,0,0,0,0:00
,295,Alexander Larsson,20,HV71,F,3,0,0,0,0,0,0,0,0,0,0,0,0,0:00
,295,Jens Bergenström,32,Leksand,F,3,0,0,0,2,0,0,0,0,0,0,0,0,0:00
,295,Vesa Junkkonen,,Luleå,D,3,0,0,0,0,0,0,0,0,0,0,0,0,0:00
,295,Niklas Wästlund,,MODO,D,3,0,0,0,2,0,0,0,0,0,0,0,0,0:00
,305,Pontus Sjögren,87,SSK,Gk,4,0,0,0,0,0,0,0,0,0,0,0,0,0:00
,305,Alexander Täng,,Frölunda,D,4,0,0,0,0,0,0,0,0,0,0,0,0,0:00
,305,Viktor Lindgren,10,Luleå,F,4,0,0,0,0,0,0,0,0,0,0,0,0,0:00
,305,Jarmo Myllys,,HV71,Gk,4,0,0,0,0,0,0,0,0,0,0,0,0,0:00
,305,Micael Andersson,,Färjestad,Gk,4,0,0,0,0,0,0,0,0,0,0,0,0,0:00
,310,Jonas Jakobsen,,Frölunda,D,5,0,0,0,0,0,0,0,0,0,0,0,0,0:00
,310,Kristoffer Bäckström,,Brynäs,D,5,0,0,0,0,0,0,0,0,0,0,0,0,0:00
,310,Simon Östlund,,Brynäs,F,5,0,0,0,0,0,0,0,0,0,0,0,0,0:00
,313,Janos Vas,19,Malmö,F,6,0,0,0,0,0,0,0,0,0,0,0,0,0:00
,313,Ryan Savoia,24,Djurgården,F,6,0,0,0,6,0,0,0,0,0,0,0,0,0:00
,313,Christopher Thörn,34,Djurgården,F,6,0,0,0,4,0,0,0,0,0,0,0,0,0:00
,313,Mikael Romö,,Timrå,F,6,0,0,0,2,0,0,0,0,0,0,0,0,0:00
,317,Richard Östlund,,Djurgården,Gk,7,0,0,0,0,0,0,0,0,0,0,0,0,0:00
,317,Magnus Åkerlund,1,HV71,Gk,7,0,0,0,0,0,0,0,0,0,0,0,0,0:00
,317,Mikael Sandberg,,Frölunda,Gk,7,0,0,0,0,0,0,0,0,0,0,0,0,0:00
,317,Jim Engström,,Brynäs,F,7,0,0,0,0,0,0,0,0,0,0,0,0,0:00
,317,Marcus Lundell,,Leksand,Gk,7,0,0,0,0,0,0,0,0,0,0,0,0,0:00
,322,Dragan Umicevic,84,SSK,F,8,0,0,0,0,0,0,0,0,0,0,0,0,0:00
,322,Håkan Åhlund,,Malmö,D,8,0,0,0,2,0,0,0,0,0,0,0,0,0:00
,324,David Fredriksson,54,HV71,F,9,0,0,0,2,0,0,0,0,0,0,0,0,0:00
,325,Carl-Johan Ericson,,Brynäs,F,10,0,0,0,0,0,0,0,0,0,0,0,0,0:00
,326,Alexander Hult,,/,F,11,0,0,0,2,0,0,0,0,0,0,0,0,0:00
,326,Mikael Von Der Geest,,Linköping,F,11,0,0,0,6,0,0,0,0,0,0,0,0,0:00
,328,Per Savilahti-Nagander,,Luleå,D,12,0,0,0,2,0,0,0,0,0,0,0,0,0:00
,328,Torbjörn Lindberg,,Luleå,D,12,0,0,0,0,0,0,0,0,0,0,0,0,0:00
,330,David Halvardsson,,Timrå,D,14,0,0,0,0,0,0,0,0,0,0,0,0,0:00
,331,Albin Lorentzon,27,Linköping,D,15,0,0,0,2,0,0,0,0,0,0,0,0,0:00
,332,Mattias Öhrling,,Timrå,Gk,16,0,0,0,0,0,0,0,0,0,0,0,0,0:00
,333,Mattias Fagerström,,Timrå,Gk,18,0,0,0,0,0,0,0,0,0,0,0,0,0:00
,334,Jonas Almtorp,16,MODO,F,20,0,0,0,4,0,0,0,0,0,0,0,0,0:00
,334,Corey Hirsch,,Timrå,Gk,20,0,0,0,0,0,0,0,0,0,0,0,0,0:00
,334,Christoffer Lindholm,,Leksand,F,20,0,0,0,0,0,0,0,0,0,0,0,0,0:00
,337,Johan Jonsson,20,Timrå,D,21,0,0,0,0,0,0,0,0,0,0,0,0,0:00
,338,Cristopher Nihlstorp,41,Malmö,Gk,23,0,0,0,0,0,0,0,0,0,0,0,0,0:00
,339,Ola Svanberg,4,HV71,D,24,0,0,0,2,0,0,0,0,0,0,0,0,0:00
,340,Robin Jonsson,39,Färjestad,D,28,0,0,0,10,0,0,0,0,0,0,0,0,0:00
,340,Andreas Forsberg Sundin,,Linköping,F,28,0,0,0,0,0,0,0,0,0,0,0,0,0:00
,342,Jens Olsson,28,Malmö,D,33,0,0,0,0,0,0,0,0,0,0,0,0,0:00
,343,Elias Granath,4,Leksand,D,38,0,0,0,4,0,0,0,0,0,0,0,0,0:00
,343,Nicklas Eckerblom,,Djurgården,F,38,0,0,0,8,0,0,0,0,0,0,0,0,0:00
,345,Mattias Karlsson,20,Brynäs,D,39,0,0,0,6,0,0,0,0,0,0,0,0,0:00
,346,Petter Rönnquist,,Djurgården,Gk,43,0,0,0,0,0,0,0,0,0,0,0,0,0:00
,346,Johan Jönfeldt,,Frölunda,Gk,43,0,0,0,0,0,0,0,0,0,0,0,0,0:00
,346,Patrik Rönnqvist,,Brynäs,F,43,0,0,0,22,0,0,0,0,0,0,0,0,0:00
,349,Magnus Lindquist,,SSK,Gk,45,0,0,0,2,0,0,0,0,0,0,0,0,0:00
,349,Kimmo Kapanen,35,Timrå,Gk,45,0,0,0,37,0,0,0,0,0,0,0,0,0:00
,349,Sinuhe Wallinheimo,,Färjestad,Gk,45,0,0,0,8,0,0,0,0,0,0,0,0,0:00
,352,Björn Bjurling,31,Djurgården,Gk,46,0,0,0,0,0,0,0,0,0,0,0,0,0:00
,352,Joakim Lundström,84,Brynäs,Gk,46,0,0,0,0,0,0,0,0,0,0,0,0,0:00
,354,Gusten Törnqvist,95,Luleå,Gk,48,0,0,0,0,0,0,0,0,0,0,0,0,0:00
,354,Daniel Sperrle,1,Linköping,Gk,48,0,0,0,0,0,0,0,0,0,0,0,0,0:00
,356,Henrik Lundqvist,,Frölunda,Gk,49,0,0,0,4,0,0,0,0,0,0,0,0,0:00
,356,Boo Ahl,,/,Gk,49,0,0,0,0,0,0,0,0,0,0,0,0,0:00
,356,Daniel Henriksson,40,Luleå,Gk,49,0,0,0,0,0,0,0,0,0,0,0,0,0:00
,359,Kimmo Vesa,,MODO,Gk,50,0,0,0,0,0,0,0,0,0,0,0,0,0:00
,359,Fredrik Eriksson,,Färjestad,Gk,50,0,0,0,0,0,0,0,0,0,0,0,0,0:00
,359,Fredrik Norrena,30,Linköping,Gk,50,0,0,0,16,0,0,0,0,0,0,0,0,0:00
,359,Rolf Wanhainen,,SSK,Gk,50,0,0,0,0,0,0,0,0,0,0,0,0,0:00
,359,Johan Backlund,26,Leksand,Gk,50,0,0,0,2,0,0,0,0,0,0,0,0,0:00
,1,Mikael Karlberg,,Leksand,F,49,16,30,46,38,5,8,0,0,0,0,0,0,0:00
,2,Magnus Wernblom,9,MODO,F,45,26,19,45,48,7,17,0,0,0,0,0,0,0:00
,3,Niklas Nordgren,13,Timrå,F,47,20,23,43,40,4,6,0,0,0,0,0,0,0:00
,4,Niklas Andersson,24,Frölunda,F,49,24,18,42,59,2,7,0,0,0,0,0,0,0:00
,5,Johan Davidsson,76,HV71,F,50,16,26,42,4,2,4,0,0,0,0,0,0,0:00
,6,Juha Riihijärvi,19,Malmö,F,50,14,28,42,10,3,6,0,0,0,0,0,0,0:00
,7,Daniel Rydmark,,Malmö,F,50,21,20,41,66,5,7,0,0,0,0,0,0,0:00
,8,Pasi Määttänen,,HV71,F,49,14,27,41,46,4,5,0,0,0,0,0,0,0:00
,9,Jörgen Jönsson,21,Färjestad,F,49,16,23,39,58,3,5,0,0,0,0,0,0,0:00
,10,Kristofer Ottosson,9,Djurgården,F,46,19,19,38,30,4,4,0,0,0,0,0,0,0:00
,11,Fredrik Bremberg,73,Djurgården,F,45,18,20,38,24,2,4,0,0,0,0,0,0,0:00
,12,Jens Nielsen,,Leksand,F,46,15,23,38,30,2,5,0,0,0,0,0,0,0:00
,13,Valeri Krykov,1051,Timrå,F,50,11,27,38,36,2,2,0,0,0,0,0,0,0:00
,14,Kalle Sahlstedt,,HV71,F,41,20,17,37,14,4,6,0,0,0,0,0,0,0:00
,15,Joel Lundqvist,20,Frölunda,F,50,17,20,37,113,3,2,0,0,0,0,0,0,0:00
,16,Henrik Nordfeldt,,Leksand,F,50,14,22,36,56,3,5,0,0,0,0,0,0,0:00
,17,Jonas Johnson,30,Frölunda,F,49,12,23,35,24,2,2,0,0,0,0,0,0,0:00
,18,Magnus Kahnberg,11,Frölunda,F,50,14,20,34,22,3,6,0,0,0,0,0,0,0:00
,19,Marko Jantunen,1090,Färjestad,F,50,10,24,34,42,1,5,0,0,0,0,0,0,0:00
,20,Per Eklund,,Linköping,F,50,7,27,34,56,1,1,0,0,0,0,0,0,0:00
,21,Antti Törmänen,,SSK,F,49,12,21,33,46,1,7,0,0,0,0,0,0,0:00
,22,Jonas Rönnqvist,,Luleå,F,46,10,23,33,28,0,3,0,0,0,0,0,0,0:00
,23,Niklas Anger,17,Brynäs,F,48,20,12,32,28,2,8,0,0,0,0,0,0,0:00
,24,Marcus Thuresson,,Malmö,F,48,18,14,32,59,1,3,0,0,0,0,0,0,0:00
,25,Dieter Kalt,74,Färjestad,F,49,18,14,32,59,1,2,0,0,0,0,0,0,0:00
,26,Thomas Rhodin,25,Färjestad,D,50,14,18,32,62,4,4,0,0,0,0,0,0,0:00
,27,Marcel Jenni,,Färjestad,F,38,14,17,31,46,3,3,0,0,0,0,0,0,0:00
,28,Petter Nilsson,,Luleå,D,47,13,18,31,24,4,4,0,0,0,0,0,0,0:00
,29,Jani Hassinen,,HV71,F,44,8,23,31,34,2,3,0,0,0,0,0,0,0:00
,30,Hans Huczkowski,26,Luleå,F,41,19,11,30,6,2,7,0,0,0,0,0,0,0:00
,31,Markus Matthiasson,92,Timrå,F,50,18,12,30,28,3,5,0,0,0,0,0,0,0:00
,32,Mika Hannula,33,Malmö,F,49,15,15,30,72,0,3,0,0,0,0,0,0,0:00
,33,Peter Nordström,19,Färjestad,F,44,13,17,30,59,1,5,0,0,0,0,0,0,0:00
,34,Mikael Johansson,,Djurgården,F,49,2,28,30,24,0,2,0,0,0,0,0,0,0:00
,35,Robert Carlsson,12,Timrå,F,46,15,14,29,24,4,5,0,0,0,0,0,0,0:00
,36,Ulf Söderström,12,Färjestad,F,45,10,19,29,45,0,1,0,0,0,0,0,0,0:00
,37,Anders Söderberg,26,MODO,F,49,10,19,29,4,1,0,0,0,0,0,0,0,0:00
,38,Peter Larsson,,SSK,F,50,10,19,29,26,1,3,0,0,0,0,0,0,0:00
,39,Peter Högardh,12,MODO,F,48,7,22,29,50,2,3,0,0,0,0,0,0,0:00
,40,Linus Fagemo,,Luleå,F,50,16,12,28,26,3,9,0,0,0,0,0,0,0:00
,41,Björn Nord,,Djurgården,D,49,11,17,28,108,4,6,0,0,0,0,0,0,0:00
,42,Stefan Öhman,,MODO,F,49,8,20,28,36,2,2,0,0,0,0,0,0,0:00
,43,Stefan Nilsson,,Luleå,F,49,4,24,28,44,1,2,0,0,0,0,0,0,0:00
,44,Pär Bäcker,24,Färjestad,F,49,11,16,27,46,1,2,0,0,0,0,0,0,0:00
,45,Mikael Lind,36,Timrå,F,35,9,18,27,34,1,1,0,0,0,0,0,0,0:00
,46,Juha Lind,,SSK,F,47,17,9,26,24,0,5,0,0,0,0,0,0,0:00
,47,Magnus Johansson,7,Frölunda,D,50,11,15,26,14,3,5,0,0,0,0,0,0,0:00
,48,Tommi Miettinen,9,Brynäs,F,50,9,17,26,76,1,2,0,0,0,0,0,0,0:00
,49,Radek Hamr,1032,Färjestad,F,49,7,19,26,22,0,1,0,0,0,0,0,0,0:00
,50,Mattias Wennerberg,26,MODO,F,50,17,8,25,30,4,4,0,0,0,0,0,0,0:00
,51,Tommy Pettersson,,MODO,F,50,15,10,25,24,3,2,0,0,0,0,0,0,0:00
,52,Jesper Mattsson,26,Malmö,F,42,13,12,25,32,3,1,0,0,0,0,0,0,0:00
,53,Petri Liimatainen,73,Malmö,D,50,6,19,25,73,1,2,0,0,0,0,0,0,0:00
,54,Toni Koivunen,,Timrå,F,47,4,21,25,8,1,2,0,0,0,0,0,0,0:00
,55,Niklas Persson,23,Leksand,F,49,4,21,25,51,0,3,0,0,0,0,0,0,0:00
,56,Anders Huusko,,HV71,F,44,13,11,24,20,3,1,0,0,0,0,0,0,0:00
,57,Patrik Carnbäck,,Frölunda,F,49,12,12,24,96,6,1,0,0,0,0,0,0,0:00
,58,Mathias Tjärnqvist,71,Djurgården,F,38,11,13,24,30,4,5,0,0,0,0,0,0,0:00
,59,Anders Burström,21,Luleå,F,50,9,15,24,34,2,4,0,0,0,0,0,0,0:00
,60,Ove Molin,21,Brynäs,F,48,8,16,24,44,1,2,0,0,0,0,0,0,0:00
,61,Thomas Berglund,,Luleå,F,37,4,20,24,115,1,1,0,0,0,0,0,0,0:00
,62,Jari Tolsa,17,Frölunda,F,43,9,14,23,24,3,2,0,0,0,0,0,0,0:00
,63,Jan Larsson,,Brynäs,F,49,6,17,23,63,1,3,0,0,0,0,0,0,0:00
,64,Peter Hammarström,,Färjestad,F,50,5,18,23,30,1,1,0,0,0,0,0,0,0:00
,65,Per Hallin,8,Timrå,F,49,13,9,22,55,1,7,0,0,0,0,0,0,0:00
,66,Per-Åge Skröder,10,HV71,F,44,12,10,22,50,4,6,0,0,0,0,0,0,0:00
,67,Kyösti Karjalainen,,Brynäs,F,43,10,12,22,26,3,3,0,0,0,0,0,0,0:00
,68,Tommy Sjödin,7,Brynäs,D,50,9,13,22,30,1,5,0,0,0,0,0,0,0:00
,69,Pierre Hedin,21,MODO,D,46,8,14,22,32,1,3,0,0,0,0,0,0,0:00
,69,Jörgen Bemström,24,SSK,F,46,8,14,22,57,2,0,0,0,0,0,0,0,0:00
,71,Niklas Eriksson,,Leksand,F,50,8,14,22,22,1,2,0,0,0,0,0,0,0:00
,71,Joakim Eriksson,10,Djurgården,F,50,8,14,22,22,3,1,0,0,0,0,0,0,0:00
,73,Greger Artursson,,Färjestad,D,50,7,15,22,22,3,0,0,0,0,0,0,0,0:00
,74,Jouni Loponen,,HV71,D,49,6,16,22,34,0,2,0,0,0,0,0,0,0:00
,75,Roger Kyrö,,Brynäs,F,43,11,10,21,8,3,5,0,0,0,0,0,0,0:00
,76,Daniel Rudslätt,14,Djurgården,F,48,10,11,21,58,1,1,0,0,0,0,0,0,0:00
,77,Robert Nilsson,,Leksand,F,41,8,13,21,10,2,0,0,0,0,0,0,0,0:00
,78,Peter Ekelund,,HV71,F,50,8,13,21,51,0,4,0,0,0,0,0,0,0:00
,79,Christer Olsson,,Leksand,D,48,10,10,20,44,1,6,0,0,0,0,0,0,0:00
,80,Martin Lindman,4,Timrå,D,50,6,14,20,91,1,5,0,0,0,0,0,0,0:00
,80,Stefan Bemström,22,SSK,D,50,6,14,20,10,3,3,0,0,0,0,0,0,0:00
,82,Richard Pavlikovsky,,HV71,D,50,5,15,20,16,0,1,0,0,0,0,0,0,0:00
,83,Oscar Ackeström,25,Frölunda,D,47,10,9,19,76,2,5,0,0,0,0,0,0,0:00
,84,Erik Norbäck,,SSK,F,48,9,10,19,41,2,2,0,0,0,0,0,0,0:00
,85,Magnus Gästrin,40,Linköping,F,49,7,12,19,46,1,3,0,0,0,0,0,0,0:00
,86,Jonas Esbjörs,22,Frölunda,F,49,5,14,19,30,0,0,0,0,0,0,0,0,0:00
,87,Pelle Prestberg,10,Färjestad,F,45,12,6,18,26,2,4,0,0,0,0,0,0,0:00
,88,Toivo Suursoo,,Malmö,F,34,10,8,18,36,1,2,0,0,0,0,0,0,0:00
,89,Johan Norgren,45,Malmö,D,50,10,8,18,66,1,3,0,0,0,0,0,0,0:00
,90,Niklas Kronwall,,Djurgården,D,50,5,13,18,46,1,2,0,0,0,0,0,0,0:00
,90,Mats Trygg,46,Färjestad,D,50,5,13,18,54,1,0,0,0,0,0,0,0,0:00
,92,Kalle Koskinen,9,Timrå,D,50,2,16,18,52,0,0,0,0,0,0,0,0,0:00
,93,Patrik Wallenberg,,Timrå,F,48,11,6,17,16,2,0,0,0,0,0,0,0,0:00
,94,Patrik Zetterberg,,SSK,F,49,11,6,17,69,3,2,0,0,0,0,0,0,0:00
,95,Tomas Strandberg,,Djurgården,F,48,10,7,17,24,0,3,0,0,0,0,0,0,0:00
,96,Pär Styf,36,Timrå,D,47,8,9,17,112,2,3,0,0,0,0,0,0,0:00
,97,Juha Joenväärä,,Djurgården,F,48,8,9,17,16,1,1,0,0,0,0,0,0,0:00
,98,Stefan Pettersson,77,Linköping,F,36,7,10,17,6,2,2,0,0,0,0,0,0,0:00
,99,Markus Åkerblom,,Timrå,F,45,7,10,17,26,1,1,0,0,0,0,0,0,0:00
,100,Miroslav Hlinka,,MODO,F,41,5,12,17,67,2,0,0,0,0,0,0,0,0:00
,101,Roger Åkerström,28,Luleå,D,44,5,12,17,96,0,4,0,0,0,0,0,0,0:00
,102,Christian Eklund,20,Djurgården,F,45,11,5,16,65,4,2,0,0,0,0,0,0,0:00
,103,Nichlas Falk,16,Djurgården,F,48,7,9,16,32,3,2,0,0,0,0,0,0,0:00
,103,Björn Melin,9,HV71,F,48,7,9,16,44,1,2,0,0,0,0,0,0,0:00
,105,Barry Richter,,Linköping,D,44,6,10,16,74,2,2,0,0,0,0,0,0,0:00
,106,Peter Andersson,,Malmö,D,45,2,14,16,67,1,1,0,0,0,0,0,0,0:00
,107,Peter Ström,1047,Frölunda,F,50,8,7,15,16,3,1,0,0,0,0,0,0,0:00
,107,Per Ledin,97,Luleå,F,50,8,7,15,72,2,1,0,0,0,0,0,0,0:00
,109,Mikael Pettersson,19,Leksand,F,36,7,8,15,51,0,1,0,0,0,0,0,0,0:00
,110,Kristian Gahn,1017,SSK,F,50,7,8,15,20,1,3,0,0,0,0,0,0,0:00
,111,Daniel Glimmenvall,6,Brynäs,D,50,6,9,15,32,2,0,0,0,0,0,0,0,0:00
,112,Christian Söderström,82,Timrå,F,44,5,10,15,6,2,1,0,0,0,0,0,0,0:00
,113,Alexander Steen,20,Frölunda,F,45,5,10,15,18,0,0,0,0,0,0,0,0,0:00
,114,Magnus Hedlund,,MODO,D,45,4,11,15,24,1,2,0,0,0,0,0,0,0:00
,115,Per Hållberg,18,Färjestad,D,47,4,11,15,63,0,0,0,0,0,0,0,0,0:00
,116,Ronnie Sundin,23,Frölunda,D,49,4,11,15,40,1,2,0,0,0,0,0,0,0:00
,117,Per Lundell,,Färjestad,D,48,3,12,15,26,1,0,0,0,0,0,0,0,0:00
,118,Kamil Brabenec,,Luleå,F,50,3,12,15,26,1,1,0,0,0,0,0,0,0:00
,119,Brian Felsner,,Linköping,F,31,10,4,14,40,2,2,0,0,0,0,0,0,0:00
,120,Magnus Nilsson,24,Luleå,F,47,9,5,14,72,3,4,0,0,0,0,0,0,0:00
,121,Hans Lodin,,Leksand,D,49,9,5,14,91,4,4,0,0,0,0,0,0,0:00
,122,Jukka Tiilikainen,,SSK,F,47,8,6,14,72,2,2,0,0,0,0,0,0,0:00
,123,Peter Nylander,11,Brynäs,F,50,8,6,14,26,2,1,0,0,0,0,0,0,0:00
,124,Tommi Rajamäki,,Timrå,D,47,7,7,14,48,1,3,0,0,0,0,0,0,0:00
,125,Tomi Kallio,71,Frölunda,F,10,6,8,14,10,1,2,0,0,0,0,0,0,0:00
,126,Fredrik Emvall,33,Linköping,F,49,8,5,13,28,1,1,0,0,0,0,0,0,0:00
,127,Thomas Johansson,18,Linköping,D,45,7,6,13,14,0,2,0,0,0,0,0,0,0:00
,128,Clas Eriksson,,Färjestad,F,47,7,6,13,24,2,0,0,0,0,0,0,0,0:00
,129,David Petrasek,22,Malmö,D,50,7,6,13,72,2,2,0,0,0,0,0,0,0:00
,130,Henrik Andersson,,Linköping,F,46,6,7,13,24,1,0,0,0,0,0,0,0,0:00
,131,Andreas Holmqvist,7,Linköping,D,43,4,9,13,28,0,1,0,0,0,0,0,0,0:00
,132,Veli-Pekka Laitinen,33,Brynäs,F,49,4,9,13,26,1,2,0,0,0,0,0,0,0:00
,133,Kimmo Eronen,,Frölunda,D,50,4,9,13,6,1,3,0,0,0,0,0,0,0:00
,134,Jonas Hägerbäck,,Luleå,F,50,3,10,13,24,1,1,0,0,0,0,0,0,0:00
,135,Matthias Trattnig,,Djurgården,D,48,7,5,12,67,2,3,0,0,0,0,0,0,0:00
,136,Mikael Andersson,,Frölunda,F,43,6,6,12,43,2,0,0,0,0,0,0,0,0:00
,137,Mikael Wahlberg,23,Malmö,F,46,6,6,12,14,0,0,0,0,0,0,0,0,0:00
,138,Patrik Tano,,Luleå,F,50,6,6,12,10,2,0,0,0,0,0,0,0,0:00
,139,Christian Sjögren,14,Timrå,F,39,5,7,12,107,1,1,0,0,0,0,0,0,0:00
,140,Jesper Damgaard,7,MODO,D,46,4,8,12,26,0,2,0,0,0,0,0,0,0:00
,141,Mikael Håkanson,51,Linköping,F,39,3,9,12,28,0,2,0,0,0,0,0,0,0:00
,142,Peter Popovic,,SSK,D,50,3,9,12,52,1,2,0,0,0,0,0,0,0:00
,143,Hannes Hyvönen,23,Färjestad,F,10,11,0,11,12,2,6,0,0,0,0,0,0,0:00
,144,Martin Johansson,,MODO,D,49,7,4,11,24,1,3,0,0,0,0,0,0,0:00
,145,Jens Karlsson,58,Frölunda,F,45,5,6,11,101,1,0,0,0,0,0,0,0,0:00
,146,Kenneth Bergqvist,41,Brynäs,F,49,5,6,11,14,0,0,0,0,0,0,0,0,0:00
,147,Dusan Milo,,MODO,D,47,4,7,11,22,0,1,0,0,0,0,0,0,0:00
,148,Mattias Remstam,75,HV71,F,33,3,8,11,26,1,1,0,0,0,0,0,0,0:00
,149,Göran Hermansson,,Leksand,F,46,6,4,10,40,0,1,0,0,0,0,0,0,0:00
,150,Peter Ahola,,SSK,D,47,6,4,10,48,1,3,0,0,0,0,0,0,0:00
,151,Fredrik Svensson,4,Luleå,D,48,6,4,10,57,1,1,0,0,0,0,0,0,0:00
,152,Timmy Pettersson,33,HV71,D,50,6,4,10,57,0,3,0,0,0,0,0,0,0:00
,153,Mike Stapleton,,Leksand,F,19,5,5,10,10,0,2,0,0,0,0,0,0,0:00
,154,Johan Tellström,,Luleå,F,21,4,6,10,10,0,0,0,0,0,0,0,0,0:00
,155,Per Löfström,,Leksand,D,42,4,6,10,46,2,0,0,0,0,0,0,0,0:00
,156,Staffan Kronwall,24,Djurgården,D,48,4,6,10,65,0,1,0,0,0,0,0,0,0:00
,157,Jan-Axel Alavaara,55,Frölunda,D,49,4,6,10,71,1,2,0,0,0,0,0,0,0:00
,157,Daniel Jardemyr,,Leksand,D,49,4,6,10,52,2,0,0,0,0,0,0,0,0:00
,159,Marcus Magnertoft,,Malmö,F,31,3,7,10,4,1,0,0,0,0,0,0,0,0:00
,160,Mika Niskanen,99,HV71,D,45,3,7,10,50,1,1,0,0,0,0,0,0,0:00
,161,Greg Brown,,Leksand,D,30,2,8,10,32,0,0,0,0,0,0,0,0,0:00
,162,Mika Lehtinen,,MODO,D,44,2,8,10,73,2,0,0,0,0,0,0,0,0:00
,163,Leif Rohlin,,SSK,D,49,2,8,10,44,1,2,0,0,0,0,0,0,0:00
,163,Tim Eriksson,26,Linköping,F,49,2,8,10,8,0,0,0,0,0,0,0,0,0:00
,165,Jonas Elofsson,,Leksand,D,46,6,3,9,26,0,3,0,0,0,0,0,0,0:00
,166,Johan Rosén,,Leksand,F,35,5,4,9,53,1,1,0,0,0,0,0,0,0:00
,167,Tobias Holm,,Leksand,F,41,5,4,9,137,1,0,0,0,0,0,0,0,0:00
,168,Kim Staal,28,MODO,F,14,4,5,9,4,0,2,0,0,0,0,0,0,0:00
,169,Björn Danielsson,23,Brynäs,F,40,3,6,9,18,0,0,0,0,0,0,0,0,0:00
,170,Morten Green,13,MODO,F,45,3,6,9,12,0,1,0,0,0,0,0,0,0:00
,171,Frans Nielsen,1015,Malmö,F,47,3,6,9,10,0,1,0,0,0,0,0,0,0:00
,172,Erik Kakko,,Frölunda,D,43,2,7,9,47,0,0,0,0,0,0,0,0,0:00
,173,Jan Hammar,,Malmö,F,45,2,7,9,30,0,0,0,0,0,0,0,0,0:00
,174,Daniel Casselståhl,52,Timrå,D,48,5,3,8,24,0,0,0,0,0,0,0,0,0:00
,175,Fredrik Warg,29,MODO,F,46,4,4,8,55,0,0,0,0,0,0,0,0,0:00
,176,Jan Öberg,9,MODO,F,49,4,4,8,12,1,0,0,0,0,0,0,0,0:00
,177,Henrik Eriksson,,Timrå,F,50,4,4,8,22,1,0,0,0,0,0,0,0,0:00
,178,Mattias Luukkonen,,Frölunda,F,39,3,5,8,14,1,0,0,0,0,0,0,0,0:00
,179,Jan Sandström,7,Luleå,D,48,3,5,8,36,0,0,0,0,0,0,0,0,0:00
,180,Johan Hult,,HV71,F,50,3,5,8,24,0,0,0,0,0,0,0,0,0:00
,181,Per Gustafsson,7,HV71,D,15,2,6,8,6,0,0,0,0,0,0,0,0,0:00
,182,Johan Eneqvist,,Leksand,F,42,2,6,8,77,0,0,0,0,0,0,0,0,0:00
,183,Roger Öhman,,Malmö,D,31,1,7,8,14,1,1,0,0,0,0,0,0,0:00
,184,Jonas Frögren,24,Färjestad,D,50,1,7,8,48,0,0,0,0,0,0,0,0,0:00
,185,Michael Johansson,,Luleå,F,17,6,1,7,10,1,0,0,0,0,0,0,0,0:00
,186,Andrei Vasilyev,,Linköping,F,19,5,2,7,6,0,2,0,0,0,0,0,0,0:00
,187,Tomas Forslund,,Leksand,F,47,5,2,7,85,0,1,0,0,0,0,0,0,0:00
,188,Stefan Gustavson,,Linköping,F,21,4,3,7,6,1,1,0,0,0,0,0,0,0:00
,189,Gabriel Karlsson,49,SSK,F,39,4,3,7,12,3,0,0,0,0,0,0,0,0:00
,189,André Faust,,Färjestad,F,39,4,3,7,28,1,2,0,0,0,0,0,0,0:00
,191,Thomas Sjögren,,Malmö,F,13,3,4,7,2,0,2,0,0,0,0,0,0,0:00
,192,Peter Casparsson,,/,F,46,2,5,7,36,0,0,0,0,0,0,0,0,0:00
,193,Jesper Björck,,SSK,D,50,2,5,7,62,1,0,0,0,0,0,0,0,0:00
,194,Peter Öberg,27,MODO,F,23,1,6,7,22,0,0,0,0,0,0,0,0,0:00
,195,Lubomir Korhon,,HV71,F,21,5,1,6,10,1,0,0,0,0,0,0,0,0:00
,196,Marius Trygg,,Färjestad,F,45,5,1,6,4,1,1,0,0,0,0,0,0,0:00
,197,Joakim Lindström,10,MODO,F,29,4,2,6,14,1,0,0,0,0,0,0,0,0:00
,198,Daniel Ljungkvist,16,HV71,D,50,4,2,6,30,0,0,0,0,0,0,0,0,0:00
,199,Mikael Von Der Geest,,Linköping,F,22,3,3,6,14,1,1,0,0,0,0,0,0,0:00
,200,Ola Thorwalls,,HV71,D,43,3,3,6,44,0,0,0,0,0,0,0,0,0:00
,201,Johan Franzén,,Linköping,F,37,2,4,6,14,0,0,0,0,0,0,0,0,0:00
,202,Robert Carlsson,14,SSK,F,41,2,4,6,30,0,1,0,0,0,0,0,0,0:00
,203,Niklas Gällstedt,,Leksand,D,44,2,4,6,38,0,1,0,0,0,0,0,0,0:00
,204,Tobias Enström,37,MODO,D,42,1,5,6,16,0,1,0,0,0,0,0,0,0:00
,205,Jussi Pekkala,,Brynäs,D,47,1,5,6,43,0,0,0,0,0,0,0,0,0:00
,205,Henrik Petré,79,Brynäs,D,47,1,5,6,32,0,0,0,0,0,0,0,0,0:00
,207,Anders Back,,SSK,D,50,1,5,6,53,0,0,0,0,0,0,0,0,0:00
,208,Pär Djoos,,Brynäs,D,14,0,6,6,8,0,0,0,0,0,0,0,0,0:00
,209,Jan Mertzig,,Linköping,D,28,0,6,6,34,0,0,0,0,0,0,0,0,0:00
,210,David Halvardsson,,Timrå,D,49,3,2,5,6,3,0,0,0,0,0,0,0,0:00
,211,Dragan Umicevic,84,SSK,F,22,2,3,5,4,0,1,0,0,0,0,0,0,0:00
,212,Jonas Andersson Junkka,,Luleå,D,50,1,4,5,55,0,0,0,0,0,0,0,0,0:00
,213,Adam Masuhr,38,Brynäs,D,45,0,5,5,28,0,0,0,0,0,0,0,0,0:00
,214,Ronnie Pettersson,6,Djurgården,D,46,0,5,5,30,0,0,0,0,0,0,0,0,0:00
,215,Niklas Brännström,,HV71,F,22,3,1,4,14,0,0,0,0,0,0,0,0,0:00
,216,Per-Anton Lundström,8,Djurgården,D,49,3,1,4,81,0,1,0,0,0,0,0,0,0:00
,216,Henrik Malmström,9,/,F,49,3,1,4,8,1,0,0,0,0,0,0,0,0:00
,218,Fredrik Johansson,,Linköping,F,16,2,2,4,6,0,0,0,0,0,0,0,0,0:00
,219,Mikael Magnusson,,Djurgården,D,29,2,2,4,65,0,1,0,0,0,0,0,0,0:00
,220,Pavel Skrbek,11,Luleå,D,39,2,2,4,61,1,0,0,0,0,0,0,0,0:00
,221,Mathias Ahxner,,Linköping,D,47,2,2,4,20,0,1,0,0,0,0,0,0,0:00
,221,Daniel Widing,41,Leksand,F,47,2,2,4,8,0,0,0,0,0,0,0,0,0:00
,221,Daniel Rafner,,Djurgården,F,47,2,2,4,20,0,0,0,0,0,0,0,0,0:00
,224,Sebastian Meijer,13,HV71,F,47,1,3,4,4,0,0,0,0,0,0,0,0,0:00
,225,Nicklas Danielsson,74,Brynäs,F,26,0,4,4,10,0,0,0,0,0,0,0,0,0:00
,226,Joakim Lundberg,,Malmö,D,44,0,4,4,26,0,0,0,0,0,0,0,0,0:00
,227,Sinuhe Wallinheimo,,Färjestad,Gk,48,0,4,4,14,0,0,0,0,0,0,0,0,0:00
,228,Tony Virta,,SSK,F,5,2,1,3,31,0,2,0,0,0,0,0,0,0:00
,229,Johan Lindström,79,Linköping,F,20,2,1,3,0,0,0,0,0,0,0,0,0,0:00
,230,Martin Knold,,Linköping,D,37,2,1,3,26,0,1,0,0,0,0,0,0,0:00
,231,Andreas Pihl,2,Linköping,D,48,2,1,3,56,0,2,0,0,0,0,0,0,0:00
,232,Liam Garvey,,Luleå,F,21,1,2,3,10,0,0,0,0,0,0,0,0,0:00
,233,Robert Jindrich,,Timrå,D,37,1,2,3,22,0,1,0,0,0,0,0,0,0:00
,234,Johan Forsander,,Djurgården,F,41,1,2,3,49,0,0,0,0,0,0,0,0,0:00
,235,Ragnar Karlsson,27,Linköping,F,43,1,2,3,18,0,0,0,0,0,0,0,0,0:00
,236,Emil Lundberg,51,Luleå,F,47,1,2,3,8,0,0,0,0,0,0,0,0,0:00
,237,Martin Wilde,,MODO,D,48,1,2,3,34,0,0,0,0,0,0,0,0,0:00
,238,Ola Möllerstedt,,SSK,D,17,0,3,3,6,0,0,0,0,0,0,0,0,0:00
,239,Kimmo Kapanen,35,Timrå,Gk,47,0,3,3,4,0,0,0,0,0,0,0,0,0:00
,240,Kasper Kenig,,Leksand,F,11,2,0,2,6,0,2,0,0,0,0,0,0,0:00
,241,Fredrik Sundin,1244,Färjestad,F,33,2,0,2,12,1,0,0,0,0,0,0,0,0:00
,242,Andreas Valdix,14,Malmö,F,39,2,0,2,10,1,0,0,0,0,0,0,0,0:00
,242,Kristoffer Jobs,,Brynäs,F,39,2,0,2,6,0,0,0,0,0,0,0,0,0:00
,244,Johan Bülow,,Linköping,F,47,2,0,2,73,1,0,0,0,0,0,0,0,0:00
,245,Jani Virtanen,,Färjestad,D,12,1,1,2,16,1,0,0,0,0,0,0,0,0:00
,246,Jonas Almtorp,16,MODO,F,28,1,1,2,22,0,0,0,0,0,0,0,0,0:00
,247,Patrik Bäärnhielm,,Luleå,D,30,1,1,2,18,0,0,0,0,0,0,0,0,0:00
,248,Jonas Leetma,,Frölunda,D,33,1,1,2,4,0,0,0,0,0,0,0,0,0:00
,249,Sanny Lindström,8,Timrå,D,39,1,1,2,81,0,0,0,0,0,0,0,0,0:00
,250,Peter Hasselblad,,Malmö,D,41,1,1,2,20,0,0,0,0,0,0,0,0,0:00
,251,Mattias Carlsson,15,SSK,F,48,1,1,2,12,1,0,0,0,0,0,0,0,0:00
,252,Calle Steen,,Färjestad,F,11,0,2,2,2,0,0,0,0,0,0,0,0,0:00
,253,Jörgen Sundqvist,22,Leksand,D,22,0,2,2,37,0,0,0,0,0,0,0,0,0:00
,254,David Svee,,SSK,F,33,0,2,2,18,0,0,0,0,0,0,0,0,0:00
,255,Pär Arlbrandt,40,HV71,F,38,0,2,2,4,0,0,0,0,0,0,0,0,0:00
,256,Sean Gauthier,,Leksand,Gk,43,0,2,2,4,0,0,0,0,0,0,0,0,0:00
,257,Daniel Henriksson,40,Luleå,Gk,50,0,2,2,2,0,0,0,0,0,0,0,0,0:00
,258,Sergei Fokin,,Malmö,D,4,1,0,1,0,1,0,0,0,0,0,0,0,0:00
,259,Mikko Luovi,,Brynäs,F,7,1,0,1,0,0,1,0,0,0,0,0,0,0:00
,260,Andreas Kreü,,Linköping,F,13,1,0,1,32,0,1,0,0,0,0,0,0,0:00
,261,Janos Vas,19,Malmö,F,14,1,0,1,2,0,0,0,0,0,0,0,0,0:00
,262,Bjarne Hurtig,,Linköping,D,19,1,0,1,4,0,0,0,0,0,0,0,0,0:00
,263,Henrik Rehnberg,,Brynäs,D,41,1,0,1,44,0,1,0,0,0,0,0,0,0:00
,264,Roger Jönsson,,Linköping,F,4,0,1,1,4,0,0,0,0,0,0,0,0,0:00
,265,Andreas Forsberg Sundin,,Linköping,F,8,0,1,1,0,0,0,0,0,0,0,0,0,0:00
,266,Nicklas Eckerblom,,Djurgården,F,10,0,1,1,0,0,0,0,0,0,0,0,0,0:00
,267,Craig Woodcroft,,Linköping,F,11,0,1,1,28,0,0,0,0,0,0,0,0,0:00
,268,Johan Finnström,,Luleå,D,14,0,1,1,6,0,0,0,0,0,0,0,0,0:00
,268,Mats Hansson,1021,Timrå,F,14,0,1,1,2,0,0,0,0,0,0,0,0,0:00
,270,Jörgen Rickmo,,Djurgården,F,23,0,1,1,2,0,0,0,0,0,0,0,0,0:00
,271,Johan Halvardsson,27,HV71,D,39,0,1,1,14,0,0,0,0,0,0,0,0,0:00
,272,Juuso Riksman,30,MODO,Gk,49,0,1,1,6,0,0,0,0,0,0,0,0,0:00
,273,Christoffer Brännström,,Luleå,D,1,0,0,0,0,0,0,0,0,0,0,0,0,0:00
,273,Kristian Larsson,,Luleå,Gk,1,0,0,0,0,0,0,0,0,0,0,0,0,0:00
,273,Peter Lindelöf,,Djurgården,F,1,0,0,0,0,0,0,0,0,0,0,0,0,0:00
,273,Per Savilahti-Nagander,,Luleå,D,1,0,0,0,0,0,0,0,0,0,0,0,0,0:00
,273,Viktor Söderberg,,SSK,F,1,0,0,0,0,0,0,0,0,0,0,0,0,0:00
,273,Alexander Hult,,HV71,F,1,0,0,0,2,0,0,0,0,0,0,0,0,0:00
,273,Michal Zajkowski,30,MODO,Gk,1,0,0,0,0,0,0,0,0,0,0,0,0,0:00
,273,Lennon Eriksson,,Frölunda,D,1,0,0,0,0,0,0,0,0,0,0,0,0,0:00
,273,David Fredriksson,54,HV71,F,1,0,0,0,0,0,0,0,0,0,0,0,0,0:00
,273,Rikard Rydén,,SSK,F,1,0,0,0,0,0,0,0,0,0,0,0,0,0:00
,283,Ryan Foster,,Leksand,F,2,0,0,0,0,0,0,0,0,0,0,0,0,0:00
,283,Mattias Fagerström,,Timrå,Gk,2,0,0,0,0,0,0,0,0,0,0,0,0,0:00
,283,Urban Omark,,SSK,F,2,0,0,0,0,0,0,0,0,0,0,0,0,0:00
,283,Fredrik Eriksson,,Färjestad,Gk,2,0,0,0,0,0,0,0,0,0,0,0,0,0:00
,283,Björn Lavander,,Luleå,F,2,0,0,0,2,0,0,0,0,0,0,0,0,0:00
,283,Cristopher Nihlstorp,41,Malmö,Gk,2,0,0,0,0,0,0,0,0,0,0,0,0,0:00
,289,Erkki Saramaa,,Linköping,D,3,0,0,0,2,0,0,0,0,0,0,0,0,0:00
,289,Johan Jönfeldt,,Frölunda,Gk,3,0,0,0,0,0,0,0,0,0,0,0,0,0:00
,289,Mattias Karlsson,20,Brynäs,D,3,0,0,0,0,0,0,0,0,0,0,0,0,0:00
,289,Robert Medin,,Linköping,F,3,0,0,0,2,0,0,0,0,0,0,0,0,0:00
,289,Pär Rova,,Luleå,D,3,0,0,0,2,0,0,0,0,0,0,0,0,0:00
,289,Johan Fransson,10,Luleå,D,3,0,0,0,0,0,0,0,0,0,0,0,0,0:00
,289,Mikael Lindman,,HV71,D,3,0,0,0,0,0,0,0,0,0,0,0,0,0:00
,289,Andreas Lundin,,Timrå,F,3,0,0,0,0,0,0,0,0,0,0,0,0,0:00
,297,Jonas Johansson,,Luleå,D,4,0,0,0,2,0,0,0,0,0,0,0,0,0:00
,297,Daniel Josefsson,12,HV71,D,4,0,0,0,0,0,0,0,0,0,0,0,0,0:00
,297,Christian Backlinder,,SSK,D,4,0,0,0,0,0,0,0,0,0,0,0,0,0:00
,297,Daniel Hermansson,22,Leksand,F,4,0,0,0,0,0,0,0,0,0,0,0,0,0:00
,301,Henrik Gradin,,MODO,F,5,0,0,0,0,0,0,0,0,0,0,0,0,0:00
,301,Stefan Svanbom,,Brynäs,D,5,0,0,0,0,0,0,0,0,0,0,0,0,0:00
,301,Ola Svanberg,4,HV71,D,5,0,0,0,0,0,0,0,0,0,0,0,0,0:00
,304,Richard Östlund,,Djurgården,Gk,6,0,0,0,0,0,0,0,0,0,0,0,0,0:00
,304,Stefan Jonsson,,SSK,D,6,0,0,0,0,0,0,0,0,0,0,0,0,0:00
,304,Erik Nilsson,,Luleå,Gk,6,0,0,0,0,0,0,0,0,0,0,0,0,0:00
,307,Per Mårs,,Brynäs,F,7,0,0,0,2,0,0,0,0,0,0,0,0,0:00
,308,Henrik Bergfors,,SSK,D,8,0,0,0,0,0,0,0,0,0,0,0,0,0:00
,308,Alexander Blomqvist,,SSK,Gk,8,0,0,0,0,0,0,0,0,0,0,0,0,0:00
,308,Sebastian Lauritzen,16,Timrå,F,8,0,0,0,0,0,0,0,0,0,0,0,0,0:00
,308,Mattias Öhrling,,Timrå,Gk,8,0,0,0,0,0,0,0,0,0,0,0,0,0:00
,312,Olof Mattson,,Brynäs,D,9,0,0,0,2,0,0,0,0,0,0,0,0,0:00
,312,Fredrik Johansson,12,Frölunda,F,9,0,0,0,2,0,0,0,0,0,0,0,0,0:00
,312,Nordin El Harfaoui,,Djurgården,F,9,0,0,0,6,0,0,0,0,0,0,0,0,0:00
,315,Patrik Rönnqvist,,Brynäs,F,10,0,0,0,4,0,0,0,0,0,0,0,0,0:00
,315,Johan Lindström,,Djurgården,F,10,0,0,0,10,0,0,0,0,0,0,0,0,0:00
,315,Mats Christéen,,SSK,D,10,0,0,0,0,0,0,0,0,0,0,0,0,0:00
,318,Joakim Lundström,84,Brynäs,Gk,11,0,0,0,0,0,0,0,0,0,0,0,0,0:00
,318,Bobbie Hagelin,,SSK,F,11,0,0,0,0,0,0,0,0,0,0,0,0,0:00
,320,Jens Öhman,,MODO,F,12,0,0,0,4,0,0,0,0,0,0,0,0,0:00
,320,Simon Östlund,,Brynäs,F,12,0,0,0,0,0,0,0,0,0,0,0,0,0:00
,320,Martin Thörnberg,10,HV71,F,12,0,0,0,2,0,0,0,0,0,0,0,0,0:00
,323,Petter Rönnquist,,Leksand,Gk,13,0,0,0,0,0,0,0,0,0,0,0,0,0:00
,324,Pierre Berggren,,Luleå,F,14,0,0,0,0,0,0,0,0,0,0,0,0,0:00
,325,Daniel Wågström,,Brynäs,D,15,0,0,0,0,0,0,0,0,0,0,0,0,0:00
,326,Peter Gerhardsson,,SSK,F,17,0,0,0,6,0,0,0,0,0,0,0,0,0:00
,326,Mikael Svensk,,Frölunda,D,17,0,0,0,0,0,0,0,0,0,0,0,0,0:00
,328,Jim Engström,,Brynäs,F,18,0,0,0,6,0,0,0,0,0,0,0,0,0:00
,329,Joel Davis,,Linköping,Gk,20,0,0,0,0,0,0,0,0,0,0,0,0,0:00
,330,Lars Jonsson,20,Leksand,D,21,0,0,0,12,0,0,0,0,0,0,0,0,0:00
,330,Johan Björk,55,Malmö,D,21,0,0,0,6,0,0,0,0,0,0,0,0,0:00
,332,Daniel Sperrle,1,Linköping,Gk,30,0,0,0,0,0,0,0,0,0,0,0,0,0:00
,333,Johan Asplund,35,Brynäs,Gk,41,0,0,0,2,0,0,0,0,0,0,0,0,0:00
,334,Gusten Törnqvist,95,Luleå,Gk,43,0,0,0,0,0,0,0,0,0,0,0,0,0:00
,334,Fredrik Andersson,,Timrå,Gk,43,0,0,0,22,0,0,0,0,0,0,0,0,0:00
,336,Jonas Floberg,,Brynäs,F,44,0,0,0,6,0,0,0,0,0,0,0,0,0:00
,336,Jonas Fransson,32,Leksand,Gk,44,0,0,0,2,0,0,0,0,0,0,0,0,0:00
,338,Magnus Lindquist,,SSK,Gk,45,0,0,0,0,0,0,0,0,0,0,0,0,0:00
,339,Joaquin Gage,,Djurgården,Gk,46,0,0,0,54,0,0,0,0,0,0,0,0,0:00
,340,Fredrik Norrena,30,Frölunda,Gk,47,0,0,0,31,0,0,0,0,0,0,0,0,0:00
,340,Rolf Wanhainen,,SSK,Gk,47,0,0,0,12,0,0,0,0,0,0,0,0,0:00
,342,Jamie Ram,,Brynäs,Gk,48,0,0,0,0,0,0,0,0,0,0,0,0,0:00
,342,Björn Bjurling,31,Djurgården,Gk,48,0,0,0,2,0,0,0,0,0,0,0,0,0:00
,342,Robert Borgqvist,,Malmö,Gk,48,0,0,0,0,0,0,0,0,0,0,0,0,0:00
,345,Andreas Hadelöv,1,Malmö,Gk,50,0,0,0,8,0,0,0,0,0,0,0,0,0:00
,345,Mikael Gerdén,,Färjestad,Gk,50,0,0,0,2,0,0,0,0,0,0,0,0,0:00
,345,Peter Hirsch,15,MODO,Gk,50,0,0,0,0,0,0,0,0,0,0,0,0,0:00
,345,Henrik Lundqvist,,Frölunda,Gk,50,0,0,0,4,0,0,0,0,0,0,0,0,0:00
,345,Boo Ahl,,HV71,Gk,50,0,0,0,0,0,0,0,0,0,0,0,0,0:00
,345,Mikael Sandberg,,Linköping,Gk,50,0,0,0,6,0,0,0,0,0,0,0,0,0:00
,345,Stefan Liv,1,HV71,Gk,50,0,0,0,0,0,0,0,0,0,0,0,0,0:00
,1,Ulf Söderström,12,Färjestad,F,49,16,34,50,65,3,2,0,0,0,0,0,0,0:00
,2,Peter Högardh,12,MODO,F,47,22,25,47,27,5,2,0,0,0,0,0,0,0:00
,3,Niklas Andersson,24,Frölunda,F,41,14,32,46,64,2,2,0,0,0,0,0,0,0:00
,4,Jonas Johnson,30,Frölunda,F,50,14,31,45,24,1,6,0,0,0,0,0,0,0:00
,5,Stefan Nilsson,,Luleå,F,50,8,36,44,32,2,0,0,0,0,0,0,0,0:00
,6,Peter Larsson,,SSK,F,50,19,24,43,14,4,8,0,0,0,0,0,0,0:00
,7,Rickard Wallin,51,Färjestad,F,50,12,31,43,56,1,3,0,0,0,0,0,0,0:00
,8,Mikael Wahlberg,,MODO,F,44,9,34,43,34,0,0,0,0,0,0,0,0,0:00
,9,Jan Larsson,,Brynäs,F,46,15,27,42,38,4,2,0,0,0,0,0,0,0:00
,10,Johan Davidsson,76,HV71,F,50,13,27,40,24,1,1,0,0,0,0,0,0,0:00
,11,Jörgen Jönsson,21,Färjestad,F,50,22,17,39,20,3,5,0,0,0,0,0,0,0:00
,12,Dieter Kalt,74,Färjestad,F,49,21,17,38,43,7,6,0,0,0,0,0,0,0:00
,13,Patrik Carnbäck,,Frölunda,F,49,15,23,38,61,2,3,0,0,0,0,0,0,0:00
,14,Juha Riihijärvi,19,Malmö,F,50,20,17,37,14,2,5,0,0,0,0,0,0,0:00
,15,Kim Staal,28,MODO,F,49,14,23,37,16,3,3,0,0,0,0,0,0,0:00
,16,Mikael Håkanson,51,Djurgården,F,49,13,24,37,86,3,6,0,0,0,0,0,0,0:00
,17,Anders Burström,21,Luleå,F,50,13,23,36,28,3,4,0,0,0,0,0,0,0:00
,18,Magnus Johansson,7,Frölunda,D,48,14,21,35,36,1,4,0,0,0,0,0,0,0:00
,19,Mikael Johansson,,Djurgården,F,45,9,26,35,10,2,1,0,0,0,0,0,0,0:00
,20,Mattias Weinhandl,80,MODO,F,50,18,16,34,10,1,5,0,0,0,0,0,0,0:00
,21,Per Eklund,,Linköping,F,50,16,18,34,16,4,3,0,0,0,0,0,0,0:00
,22,Per-Åge Skröder,10,HV71,F,49,20,13,33,59,7,7,0,0,0,0,0,0,0:00
,23,Ove Molin,21,Brynäs,F,39,16,17,33,61,2,2,0,0,0,0,0,0,0:00
,24,Kalle Sahlstedt,,HV71,F,50,13,20,33,16,3,3,0,0,0,0,0,0,0:00
,25,Daniel Rudslätt,14,Brynäs,F,45,15,17,32,16,3,4,0,0,0,0,0,0,0:00
,26,Niklas Anger,17,AIK,F,50,12,20,32,16,2,4,0,0,0,0,0,0,0:00
,27,Tommy Sjödin,7,Brynäs,D,49,11,21,32,38,3,3,0,0,0,0,0,0,0:00
,28,Thomas Rhodin,25,Färjestad,D,50,11,21,32,61,4,5,0,0,0,0,0,0,0:00
,29,Henrik Zetterberg,,Timrå,F,48,10,22,32,20,2,4,0,0,0,0,0,0,0:00
,30,Nils Ekman,3,Djurgården,F,38,16,15,31,57,5,3,0,0,0,0,0,0,0:00
,31,Michael Johansson,,AIK,F,49,13,18,31,34,3,2,0,0,0,0,0,0,0:00
,32,Stefan Gustavson,,Linköping,F,49,9,22,31,34,1,2,0,0,0,0,0,0,0:00
,33,Markus Matthiasson,92,Timrå,F,50,18,12,30,59,2,5,0,0,0,0,0,0,0:00
,34,Magnus Wernblom,9,MODO,F,42,14,16,30,75,5,4,0,0,0,0,0,0,0:00
,35,Rastislav Pavlikovsky,14,HV71,F,46,14,16,30,102,3,1,0,0,0,0,0,0,0:00
,36,Mikael Andersson,,Frölunda,F,47,14,15,29,65,1,3,0,0,0,0,0,0,0:00
,37,Tom Bissett,,Brynäs,F,50,14,15,29,24,0,6,0,0,0,0,0,0,0:00
,38,Hans Huczkowski,26,Luleå,F,49,13,16,29,8,5,0,0,0,0,0,0,0,0:00
,39,Thomas Berglund,,Luleå,F,50,10,19,29,72,1,0,0,0,0,0,0,0,0:00
,40,Anders Huusko,,HV71,F,46,13,15,28,26,2,4,0,0,0,0,0,0,0:00
,41,Peter Hammarström,,Färjestad,F,48,13,15,28,22,3,2,0,0,0,0,0,0,0:00
,42,Marcus Thuresson,,Malmö,F,47,10,18,28,28,2,3,0,0,0,0,0,0,0:00
,43,Thomas Sjögren,,AIK,F,47,9,19,28,36,0,1,0,0,0,0,0,0,0:00
,44,Petter Nilsson,,Luleå,D,50,16,11,27,40,2,5,0,0,0,0,0,0,0:00
,45,Nichlas Falk,16,Djurgården,F,44,10,17,27,10,2,2,0,0,0,0,0,0,0:00
,46,Juha Lind,,SSK,F,41,16,10,26,10,2,6,0,0,0,0,0,0,0:00
,47,Joel Lundqvist,20,Frölunda,F,46,12,14,26,28,1,0,0,0,0,0,0,0,0:00
,48,Daniel Rydmark,,Malmö,F,48,11,15,26,52,3,3,0,0,0,0,0,0,0:00
,48,Anders Gozzi,,AIK,F,48,11,15,26,24,1,1,0,0,0,0,0,0,0:00
,50,Tony Mårtensson,9,Brynäs,F,50,9,17,26,14,2,1,0,0,0,0,0,0,0:00
,51,Fredrik Johansson,,Linköping,F,50,15,10,25,28,4,3,0,0,0,0,0,0,0:00
,52,Shayne Toporowski,,Luleå,F,30,14,11,25,71,4,4,0,0,0,0,0,0,0:00
,53,Magnus Kahnberg,11,Frölunda,F,50,14,11,25,24,1,2,0,0,0,0,0,0,0:00
,53,Pelle Prestberg,10,Frölunda,F,50,14,11,25,28,2,5,0,0,0,0,0,0,0:00
,55,Stefan Öhman,,MODO,F,48,11,14,25,16,2,1,0,0,0,0,0,0,0:00
,56,Thomas Johansson,18,AIK,D,49,9,16,25,36,2,5,0,0,0,0,0,0,0:00
,57,Brandon Convery,,Linköping,F,31,13,11,24,10,0,3,0,0,0,0,0,0,0:00
,58,Peter Ekelund,,HV71,F,48,9,15,24,20,1,1,0,0,0,0,0,0,0:00
,59,Jari Tolsa,17,Frölunda,F,48,8,16,24,18,2,2,0,0,0,0,0,0,0:00
,60,Filip Turek,,AIK,F,36,13,10,23,22,4,2,0,0,0,0,0,0,0:00
,61,Jan Pardavy,,Djurgården,F,47,12,11,23,70,1,1,0,0,0,0,0,0,0:00
,62,Peter Ström,1047,Frölunda,F,50,12,11,23,12,4,0,0,0,0,0,0,0,0:00
,63,Lars Jansson,,MODO,D,43,7,16,23,12,1,6,0,0,0,0,0,0,0:00
,64,Peter Nordström,19,Färjestad,F,45,5,18,23,56,0,1,0,0,0,0,0,0,0:00
,65,Stefan Pettersson,77,Linköping,F,48,14,8,22,16,3,3,0,0,0,0,0,0,0:00
,66,Jesper Mattsson,26,Malmö,F,49,12,10,22,26,3,6,0,0,0,0,0,0,0:00
,67,Marcel Jenni,,Färjestad,F,49,9,13,22,22,1,0,0,0,0,0,0,0,0:00
,68,Erik Kakko,,Färjestad,D,45,7,15,22,22,2,1,0,0,0,0,0,0,0:00
,69,Fredrik Bremberg,73,Malmö,F,48,5,17,22,2,1,2,0,0,0,0,0,0,0:00
,70,Kristofer Ottosson,9,Djurgården,F,41,13,8,21,12,2,5,0,0,0,0,0,0,0:00
,71,Richard Lintner,22,MODO,D,28,12,9,21,85,2,3,0,0,0,0,0,0,0:00
,72,Erik Norbäck,,SSK,F,43,11,10,21,22,0,3,0,0,0,0,0,0,0:00
,73,Kyösti Karjalainen,,Djurgården,F,48,9,12,21,18,2,2,0,0,0,0,0,0,0:00
,74,Mikael Pettersson,19,MODO,F,50,8,13,21,28,0,0,0,0,0,0,0,0,0:00
,75,Joakim Eriksson,10,Djurgården,F,50,6,15,21,24,1,3,0,0,0,0,0,0,0:00
,76,Christer Olsson,,Brynäs,D,50,5,16,21,65,0,2,0,0,0,0,0,0,0:00
,77,Robert Burakovsky,,Malmö,F,37,4,17,21,2,0,0,0,0,0,0,0,0,0:00
,78,Peter Popovic,,SSK,D,50,3,18,21,52,1,1,0,0,0,0,0,0,0:00
,79,David Longstaff,,Djurgården,F,45,9,11,20,55,2,1,0,0,0,0,0,0,0:00
,80,Björn Nord,,Djurgården,D,50,8,12,20,46,0,4,0,0,0,0,0,0,0:00
,81,Mats Trygg,46,Färjestad,D,40,9,10,19,22,1,1,0,0,0,0,0,0,0:00
,82,Jan Öberg,9,MODO,F,50,9,10,19,22,2,3,0,0,0,0,0,0,0:00
,82,Mikael Wahlberg,23,Malmö,F,50,9,10,19,20,0,1,0,0,0,0,0,0,0:00
,84,Jörgen Bemström,24,/ SSK,F,43,7,12,19,22,1,0,0,0,0,0,0,0,0:00
,85,Mikael Lind,36,Timrå,F,44,4,15,19,22,0,3,0,0,0,0,0,0,0:00
,86,Toivo Suursoo,,Luleå,F,48,15,3,18,57,3,0,0,0,0,0,0,0,0:00
,87,Jonas Soling,1011,Brynäs,F,35,14,4,18,22,5,1,0,0,0,0,0,0,0:00
,88,Linus Fagemo,,Timrå,F,49,13,5,18,14,3,3,0,0,0,0,0,0,0:00
,89,Jonathan Hedström,71,Luleå,F,47,11,7,18,38,1,2,0,0,0,0,0,0,0:00
,90,Xavier Majic,,Malmö,F,50,9,9,18,64,2,3,0,0,0,0,0,0,0:00
,91,Jouni Loponen,,HV71,D,40,7,11,18,14,1,1,0,0,0,0,0,0,0:00
,92,Björn Danielsson,23,Brynäs,F,49,6,12,18,16,0,0,0,0,0,0,0,0,0:00
,93,Peter Ahola,,SSK,D,49,4,14,18,91,0,4,0,0,0,0,0,0,0:00
,94,Marko Jantunen,1090,Färjestad,F,50,12,5,17,32,5,3,0,0,0,0,0,0,0:00
,95,Jari Kauppila,33,Luleå,F,50,11,6,17,34,1,1,0,0,0,0,0,0,0:00
,95,Greger Artursson,,Färjestad,D,50,11,6,17,22,2,8,0,0,0,0,0,0,0:00
,97,Mika Hannula,33,Malmö,F,41,10,7,17,14,0,3,0,0,0,0,0,0,0:00
,98,Daniel Wågström,,Brynäs,D,46,10,7,17,8,0,2,0,0,0,0,0,0,0:00
,99,Ronnie Sundin,23,Frölunda,D,49,9,8,17,38,2,3,0,0,0,0,0,0,0:00
,100,Mattias Remstam,75,HV71,F,37,8,9,17,16,1,0,0,0,0,0,0,0,0:00
,101,Oleg Belov,,HV71,F,34,7,10,17,12,2,1,0,0,0,0,0,0,0:00
,102,Johan Hult,,HV71,F,50,7,10,17,14,3,0,0,0,0,0,0,0,0:00
,103,Barry Richter,,Linköping,D,44,5,12,17,82,2,2,0,0,0,0,0,0,0:00
,104,Mike Helber,,Linköping,F,46,5,12,17,36,0,2,0,0,0,0,0,0,0:00
,105,Toni Sihvonen,,AIK,F,48,4,13,17,53,0,1,0,0,0,0,0,0,0:00
,106,Jukka Tiilikainen,,SSK,F,50,10,6,16,45,2,1,0,0,0,0,0,0,0:00
,107,Tommy Pettersson,,MODO,F,38,9,7,16,10,2,0,0,0,0,0,0,0,0:00
,108,Richard Pavlikovsky,,HV71,D,40,8,8,16,28,0,1,0,0,0,0,0,0,0:00
,109,Christian Söderström,82,Timrå,F,48,8,8,16,16,1,2,0,0,0,0,0,0,0:00
,110,Pierre Hedin,21,MODO,D,39,7,9,16,20,3,3,0,0,0,0,0,0,0:00
,111,Robert Carlsson,12,Timrå,F,49,7,9,16,12,0,0,0,0,0,0,0,0,0:00
,112,Björn Melin,9,HV71,F,50,7,9,16,40,0,4,0,0,0,0,0,0,0:00
,113,Marian Kacir,,Frölunda,F,33,6,10,16,22,1,1,0,0,0,0,0,0,0:00
,114,Jan-Axel Alavaara,55,Frölunda,D,50,5,11,16,28,0,2,0,0,0,0,0,0,0:00
,115,Kenneth Bergqvist,41,Brynäs,F,49,9,6,15,47,1,2,0,0,0,0,0,0,0:00
,116,Philippe Audet,,AIK,F,29,8,7,15,69,0,1,0,0,0,0,0,0,0:00
,117,Tomas Sandström,,Malmö,F,37,8,7,15,40,4,1,0,0,0,0,0,0,0:00
,118,Gabriel Karlsson,49,SSK,F,47,8,7,15,18,1,0,0,0,0,0,0,0,0:00
,119,Niklas Brännström,,HV71,F,48,7,8,15,26,2,1,0,0,0,0,0,0,0:00
,120,Anders Söderberg,26,MODO,F,30,6,9,15,6,0,2,0,0,0,0,0,0,0:00
,121,Miroslav Hlinka,,MODO,F,45,6,9,15,69,1,1,0,0,0,0,0,0,0:00
,122,Per Gustafsson,7,HV71,D,46,6,9,15,20,0,1,0,0,0,0,0,0,0:00
,122,Jens Karlsson,58,Frölunda,F,46,6,9,15,44,1,1,0,0,0,0,0,0,0:00
,124,Peter Casparsson,,Linköping,F,49,6,9,15,38,0,3,0,0,0,0,0,0,0:00
,125,Per Lundell,,Färjestad,D,31,5,10,15,14,2,3,0,0,0,0,0,0,0:00
,126,Mikael Von Der Geest,,Linköping,F,49,5,10,15,14,0,3,0,0,0,0,0,0,0:00
,127,Mathias Johansson,75,Färjestad,F,50,4,11,15,22,1,0,0,0,0,0,0,0,0:00
,128,Niklas Nordgren,13,Timrå,F,49,8,6,14,16,0,2,0,0,0,0,0,0,0:00
,129,Sami Mettovaara,,Luleå,F,46,7,7,14,57,0,1,0,0,0,0,0,0,0:00
,130,Timmy Pettersson,33,Frölunda,D,49,7,7,14,32,1,2,0,0,0,0,0,0,0:00
,131,Henrik Malmström,9,Malmö,F,48,6,8,14,10,1,0,0,0,0,0,0,0,0:00
,132,Pasi Sormunen,,Frölunda,D,35,5,9,14,63,1,1,0,0,0,0,0,0,0:00
,133,Nicklas Rahm,,Frölunda,D,50,4,10,14,26,2,1,0,0,0,0,0,0,0:00
,134,Mikael Magnusson,,Djurgården,D,49,3,11,14,50,1,0,0,0,0,0,0,0,0:00
,135,Stefan Bemström,22,SSK,D,50,3,11,14,8,1,1,0,0,0,0,0,0,0:00
,136,Peter Ottosson,,HV71,F,37,5,8,13,20,1,0,0,0,0,0,0,0,0:00
,137,Ragnar Karlsson,27,Linköping,F,39,9,3,12,46,3,1,0,0,0,0,0,0,0:00
,138,Edvin Frylén,36,Djurgården,D,48,8,4,12,44,0,1,0,0,0,0,0,0,0:00
,139,Peter Andersson,,Malmö,D,37,7,5,12,30,2,2,0,0,0,0,0,0,0:00
,140,Peter Gerhardsson,,SSK,F,42,6,6,12,16,1,2,0,0,0,0,0,0,0:00
,141,Niklas Kronwall,,Djurgården,D,48,5,7,12,34,2,2,0,0,0,0,0,0,0:00
,142,Pär Bäcker,24,Färjestad,F,47,4,8,12,16,0,0,0,0,0,0,0,0,0:00
,143,Jesper Björck,,SSK,D,50,4,8,12,61,0,1,0,0,0,0,0,0,0:00
,144,Jussi Pekkala,,Brynäs,D,40,3,9,12,26,0,1,0,0,0,0,0,0,0:00
,145,Mikko Luovi,,Brynäs,F,39,2,10,12,8,0,0,0,0,0,0,0,0,0:00
,146,Timo Peltomaa,,Timrå,F,45,1,11,12,34,0,0,0,0,0,0,0,0,0:00
,147,Christian Bäckman,5,Frölunda,D,44,7,4,11,38,1,2,0,0,0,0,0,0,0:00
,148,Andreas Kreü,,Linköping,F,40,6,5,11,32,0,1,0,0,0,0,0,0,0:00
,149,Roger Öhman,,Malmö,D,43,6,5,11,18,1,1,0,0,0,0,0,0,0:00
,150,Per Hallin,8,Timrå,F,45,6,5,11,63,2,1,0,0,0,0,0,0,0:00
,150,Clas Eriksson,,Färjestad,F,45,6,5,11,45,3,0,0,0,0,0,0,0,0:00
,152,Sergei Fokin,,Färjestad,D,48,6,5,11,24,1,0,0,0,0,0,0,0,0:00
,153,Peter Berndtsson,,Linköping,F,41,5,6,11,14,0,1,0,0,0,0,0,0,0:00
,154,Johan Forsander,,Djurgården,F,48,5,6,11,16,1,0,0,0,0,0,0,0,0:00
,155,Marcus Magnertoft,,Malmö,F,42,4,7,11,12,0,0,0,0,0,0,0,0,0:00
,156,Joakim Lundberg,,Malmö,D,49,3,8,11,44,1,2,0,0,0,0,0,0,0:00
,157,David Petrasek,22,Malmö,D,47,2,9,11,48,0,0,0,0,0,0,0,0,0:00
,158,Jyrki Louhi,,AIK,F,49,1,10,11,30,0,0,0,0,0,0,0,0,0:00
,159,Bjarne Hurtig,,Linköping,D,37,6,4,10,14,0,3,0,0,0,0,0,0,0:00
,160,Arnaud Briand,,Luleå,F,43,6,4,10,38,2,1,0,0,0,0,0,0,0:00
,161,Jan Huokko,,AIK,F,25,5,5,10,47,0,2,0,0,0,0,0,0,0:00
,162,Fredrik Svensson,4,Luleå,D,49,5,5,10,53,1,1,0,0,0,0,0,0,0:00
,163,Andreas Pihl,2,MODO,D,50,5,5,10,113,2,1,0,0,0,0,0,0,0:00
,164,Yared Hagos,91,AIK,F,45,4,6,10,36,0,0,0,0,0,0,0,0,0:00
,165,Robert Carlsson,14,SSK,F,50,4,6,10,30,1,0,0,0,0,0,0,0,0:00
,165,Mattias Svedberg,,AIK,D,50,4,6,10,36,0,0,0,0,0,0,0,0,0:00
,167,Johan Norgren,45,Malmö,D,49,3,7,10,48,0,0,0,0,0,0,0,0,0:00
,168,Roger Kyrö,,Brynäs,F,21,2,8,10,6,1,0,0,0,0,0,0,0,0:00
,169,Peter Kumpulainen,,AIK,F,49,2,8,10,6,0,0,0,0,0,0,0,0,0:00
,170,Roger Åkerström,28,Luleå,D,41,1,9,10,63,0,0,0,0,0,0,0,0,0:00
,171,Martin Knold,,Linköping,D,44,1,9,10,32,0,1,0,0,0,0,0,0,0:00
,172,Per Hållberg,18,MODO,D,45,1,9,10,32,0,1,0,0,0,0,0,0,0:00
,173,Tomas Strandberg,,Djurgården,F,47,5,4,9,16,1,0,0,0,0,0,0,0,0:00
,174,Jonas Esbjörs,22,HV71,F,18,4,5,9,6,1,0,0,0,0,0,0,0,0:00
,175,Matthias Trattnig,,Djurgården,D,44,4,5,9,26,0,0,0,0,0,0,0,0,0:00
,176,Jonas Frögren,24,Färjestad,D,50,3,6,9,18,2,0,0,0,0,0,0,0,0:00
,177,Pär Djoos,,Brynäs,D,18,2,7,9,28,0,1,0,0,0,0,0,0,0:00
,178,Daniel Casselståhl,52,Timrå,D,48,2,7,9,32,0,1,0,0,0,0,0,0,0:00
,179,Per-Anton Lundström,8,AIK,D,49,6,2,8,104,2,0,0,0,0,0,0,0,0:00
,180,Ronnie Pettersson,6,Djurgården,D,38,5,3,8,30,0,3,0,0,0,0,0,0,0:00
,181,Ola Thorwalls,,HV71,D,45,5,3,8,22,0,3,0,0,0,0,0,0,0:00
,182,Tomi Källarsson,,Timrå,D,43,4,4,8,76,0,3,0,0,0,0,0,0,0:00
,183,Kim Cannerheim,,SSK,F,45,3,5,8,6,0,1,0,0,0,0,0,0,0:00
,184,Mathias Ahxner,,Linköping,D,49,3,5,8,40,0,2,0,0,0,0,0,0,0:00
,185,Magnus Hedlund,,MODO,D,32,2,6,8,22,0,1,0,0,0,0,0,0,0:00
,186,Johan Franzén,,Linköping,F,36,2,6,8,64,0,0,0,0,0,0,0,0,0:00
,187,Leif Rohlin,,Djurgården,D,41,2,6,8,34,1,2,0,0,0,0,0,0,0:00
,188,Johan Finnström,,Luleå,D,46,1,7,8,46,0,0,0,0,0,0,0,0,0:00
,189,Mike Harder,,Brynäs,F,11,4,3,7,4,1,2,0,0,0,0,0,0,0:00
,190,Joakim Lindström,10,MODO,F,42,4,3,7,20,1,1,0,0,0,0,0,0,0:00
,191,Lars-Göran Wiklander,,SSK,F,45,4,3,7,12,1,1,0,0,0,0,0,0,0:00
,192,Robert Jindrich,,Timrå,D,43,3,4,7,46,1,0,0,0,0,0,0,0,0:00
,193,Erkki Saramaa,,Linköping,D,45,2,5,7,22,0,0,0,0,0,0,0,0,0:00
,193,Andreas Lindh,,SSK,D,45,2,5,7,22,0,1,0,0,0,0,0,0,0:00
,195,David Svee,,SSK,F,47,2,5,7,24,1,0,0,0,0,0,0,0,0:00
,196,Patrik Tano,,Luleå,F,49,2,5,7,2,0,0,0,0,0,0,0,0,0:00
,197,Peter Hasselblad,,Malmö,D,50,2,5,7,32,1,1,0,0,0,0,0,0,0:00
,198,David Bornhammar,,AIK,D,48,1,6,7,34,0,0,0,0,0,0,0,0,0:00
,199,Daniel Glimmenvall,6,Brynäs,D,37,0,7,7,36,0,0,0,0,0,0,0,0,0:00
,200,Pär Styf,36,Timrå,D,43,5,1,6,83,3,4,0,0,0,0,0,0,0:00
,201,Marius Trygg,,Färjestad,F,48,4,2,6,8,0,0,0,0,0,0,0,0,0:00
,201,David Engblom,33,AIK,F,48,4,2,6,14,1,0,0,0,0,0,0,0,0:00
,203,Mattias Carlsson,15,SSK,F,46,3,3,6,10,1,0,0,0,0,0,0,0,0:00
,204,Andrei Ignatovics,,Djurgården,F,47,3,3,6,10,2,1,0,0,0,0,0,0,0:00
,205,Jan Sandström,7,Luleå,D,41,2,4,6,12,0,1,0,0,0,0,0,0,0:00
,206,Ola Möllerstedt,,SSK,D,43,2,4,6,16,0,0,0,0,0,0,0,0,0:00
,207,Adam Masuhr,38,Brynäs,D,39,1,5,6,14,0,0,0,0,0,0,0,0,0:00
,208,Mikael Lindman,,HV71,D,42,1,5,6,12,0,1,0,0,0,0,0,0,0:00
,209,Daniel Ljungkvist,16,HV71,D,50,1,5,6,30,0,0,0,0,0,0,0,0,0:00
,209,Tommi Rajamäki,,Timrå,D,50,1,5,6,57,0,0,0,0,0,0,0,0,0:00
,211,Grigorijs Pantelejevs,,SSK,F,11,4,1,5,6,0,1,0,0,0,0,0,0,0:00
,212,Jörgen Rickmo,,Djurgården,F,45,4,1,5,16,0,0,0,0,0,0,0,0,0:00
,213,Jan Hammar,,Malmö,F,50,4,1,5,12,2,0,0,0,0,0,0,0,0:00
,214,Joakim Nordstrand,,Linköping,D,14,3,2,5,14,1,2,0,0,0,0,0,0,0:00
,215,Ed Ward,,Timrå,F,34,3,2,5,64,1,2,0,0,0,0,0,0,0:00
,216,David Printz,55,AIK,D,37,3,2,5,59,0,2,0,0,0,0,0,0,0:00
,217,Andreas Pettersson,,AIK,F,50,3,2,5,8,2,0,0,0,0,0,0,0,0:00
,218,Gregory Johnston,,MODO,D,13,2,3,5,22,0,1,0,0,0,0,0,0,0:00
,219,Andreas Jämtin,18,AIK,F,42,2,3,5,55,0,0,0,0,0,0,0,0,0:00
,220,Henrik Eriksson,,Timrå,F,45,2,3,5,28,0,0,0,0,0,0,0,0,0:00
,221,Fredrik Emvall,33,Linköping,F,50,2,3,5,46,0,0,0,0,0,0,0,0,0:00
,222,Lars Dahlström,,SSK,F,30,1,4,5,4,0,0,0,0,0,0,0,0,0:00
,223,Henrik Andersson,,Linköping,F,38,1,4,5,6,1,0,0,0,0,0,0,0,0:00
,224,Per Ledin,97,Luleå,F,50,0,5,5,47,0,0,0,0,0,0,0,0,0:00
,225,Fredrik Warg,29,MODO,F,38,3,1,4,26,0,1,0,0,0,0,0,0,0:00
,226,Vaclav Burda,,Luleå,D,20,2,2,4,12,0,0,0,0,0,0,0,0,0:00
,227,Mattias Wennerberg,26,MODO,F,24,2,2,4,16,1,0,0,0,0,0,0,0,0:00
,228,Christian Due-Boje,,Malmö,D,40,2,2,4,44,1,0,0,0,0,0,0,0,0:00
,229,Osmo Soutukorva,,Luleå,D,50,2,2,4,30,0,0,0,0,0,0,0,0,0:00
,230,Paul Brousseau,,AIK,F,13,1,3,4,4,0,0,0,0,0,0,0,0,0:00
,231,Magnus Gästrin,40,Linköping,F,18,1,3,4,10,0,0,0,0,0,0,0,0,0:00
,232,Stanislav Jasecko,,HV71,D,8,0,4,4,14,0,0,0,0,0,0,0,0,0:00
,233,Christoffer Norgren,29,Linköping,D,49,0,4,4,65,0,0,0,0,0,0,0,0,0:00
,234,Johan Bülow,,Linköping,F,40,3,0,3,36,0,0,0,0,0,0,0,0,0:00
,235,Henrik Petré,79,Brynäs,D,24,2,1,3,49,0,0,0,0,0,0,0,0,0:00
,236,Fredrik Sundin,1244,Färjestad,F,34,2,1,3,2,1,0,0,0,0,0,0,0,0:00
,237,Joakim Musakka,,Malmö,D,10,1,2,3,4,0,0,0,0,0,0,0,0,0:00
,238,Mattias Luukkonen,,Frölunda,F,15,1,2,3,6,1,0,0,0,0,0,0,0,0:00
,239,Håkan Åhlund,,Timrå,D,26,1,2,3,22,0,1,0,0,0,0,0,0,0:00
,240,Jonas Andersson Junkka,,Luleå,D,30,1,2,3,28,0,0,0,0,0,0,0,0,0:00
,241,Mikael Simons,78,Timrå,F,48,1,2,3,14,0,0,0,0,0,0,0,0,0:00
,242,Alexander Steen,20,Frölunda,F,26,0,3,3,14,0,0,0,0,0,0,0,0,0:00
,243,Anders Lönn,,Linköping,F,28,0,3,3,8,0,0,0,0,0,0,0,0,0:00
,244,Viktor Wallin,,Timrå,D,35,0,3,3,18,0,0,0,0,0,0,0,0,0:00
,245,Mattias Pålsson,,SSK,F,43,2,0,2,26,0,0,0,0,0,0,0,0,0:00
,246,Juha Hautamaa,,Timrå,F,11,1,1,2,8,0,0,0,0,0,0,0,0,0:00
,247,Kristoffer Jobs,,Brynäs,F,14,1,1,2,2,0,0,0,0,0,0,0,0,0:00
,248,Henrik Rehnberg,,Brynäs,D,27,1,1,2,47,0,0,0,0,0,0,0,0,0:00
,249,Peter Öberg,27,MODO,F,39,1,1,2,68,1,0,0,0,0,0,0,0,0:00
,250,Daniel Josefsson,12,HV71,D,48,1,1,2,29,0,0,0,0,0,0,0,0,0:00
,251,Karl Fabricius,52,Luleå,F,13,0,2,2,0,0,0,0,0,0,0,0,0,0:00
,252,André Mattsson,,AIK,D,26,0,2,2,10,0,0,0,0,0,0,0,0,0:00
,253,David Halvardsson,,Timrå,D,44,0,2,2,4,0,0,0,0,0,0,0,0,0:00
,254,Peter Hirsch,15,MODO,Gk,49,0,2,2,2,0,0,0,0,0,0,0,0,0:00
,255,Mikael Sandberg,,Linköping,Gk,50,0,2,2,12,0,0,0,0,0,0,0,0,0:00
,256,Andreas Lundin,,Timrå,F,1,1,0,1,0,0,0,0,0,0,0,0,0,0:00
,257,Dragan Umicevic,84,SSK,F,3,1,0,1,0,0,0,0,0,0,0,0,0,0:00
,258,Christian Eklund,20,Djurgården,F,4,1,0,1,0,0,0,0,0,0,0,0,0,0:00
,259,Peter Lindelöf,,Djurgården,F,10,1,0,1,4,1,0,0,0,0,0,0,0,0:00
,260,Jens Östling,,Brynäs,F,18,1,0,1,0,0,0,0,0,0,0,0,0,0:00
,261,Anders Back,,SSK,D,48,1,0,1,44,1,0,0,0,0,0,0,0,0:00
,262,Juha Ikonen,,Frölunda,F,6,0,1,1,2,0,0,0,0,0,0,0,0,0:00
,262,Mathias Tjärnqvist,71,Djurgården,F,6,0,1,1,4,0,0,0,0,0,0,0,0,0:00
,264,Rikard Ekström,,AIK,D,11,0,1,1,0,0,0,0,0,0,0,0,0,0:00
,265,Jeffrey Williams,,Brynäs,F,12,0,1,1,4,0,0,0,0,0,0,0,0,0:00
,266,Igor Matushkin,,Timrå,F,13,0,1,1,6,0,0,0,0,0,0,0,0,0:00
,267,Frans Nielsen,1015,Malmö,F,20,0,1,1,0,0,0,0,0,0,0,0,0,0:00
,268,Magnus Eriksson,,Brynäs,D,30,0,1,1,22,0,0,0,0,0,0,0,0,0:00
,269,Martin Johansson,,MODO,D,42,0,1,1,10,0,0,0,0,0,0,0,0,0:00
,270,Niklas Bäckström,,AIK,Gk,50,0,1,1,18,0,0,0,0,0,0,0,0,0:00
,271,Daniel Sandgren,,Timrå,D,1,0,0,0,0,0,0,0,0,0,0,0,0,0:00
,271,Bobbie Hagelin,,SSK,F,1,0,0,0,0,0,0,0,0,0,0,0,0,0:00
,271,Robin Jonsson,39,Färjestad,D,1,0,0,0,0,0,0,0,0,0,0,0,0,0:00
,271,Fredrik Jonsson,,HV71,F,1,0,0,0,0,0,0,0,0,0,0,0,0,0:00
,271,Per Åkerström,,HV71,Gk,1,0,0,0,0,0,0,0,0,0,0,0,0,0:00
,271,Stefan Gråhns,41,SSK,F,1,0,0,0,0,0,0,0,0,0,0,0,0,0:00
,271,Joakim Eklöv,,SSK,F,1,0,0,0,0,0,0,0,0,0,0,0,0,0:00
,271,Andreas Valdix,14,Malmö,F,1,0,0,0,0,0,0,0,0,0,0,0,0,0:00
,271,Niklas Holm,,Malmö,Gk,1,0,0,0,0,0,0,0,0,0,0,0,0,0:00
,271,John Lind,,MODO,D,1,0,0,0,0,0,0,0,0,0,0,0,0,0:00
,271,Marcus Forsberg,,SSK,F,1,0,0,0,0,0,0,0,0,0,0,0,0,0:00
,271,Tommy Karlsson,,HV71,D,1,0,0,0,0,0,0,0,0,0,0,0,0,0:00
,271,Björge Josefsen,,HV71,Gk,1,0,0,0,0,0,0,0,0,0,0,0,0,0:00
,271,Nicklas Eckerblom,,Djurgården,F,1,0,0,0,0,0,0,0,0,0,0,0,0,0:00
,271,Patrik Bäärnhielm,,Luleå,D,1,0,0,0,0,0,0,0,0,0,0,0,0,0:00
,286,Ola Svanberg,4,HV71,D,2,0,0,0,0,0,0,0,0,0,0,0,0,0:00
,286,Henric Gustavsson,,HV71,F,2,0,0,0,0,0,0,0,0,0,0,0,0,0:00
,286,Andreas Andersson,54,HV71,Gk,2,0,0,0,0,0,0,0,0,0,0,0,0,0:00
,286,Ulf Trogen,,Linköping,Gk,2,0,0,0,0,0,0,0,0,0,0,0,0,0:00
,286,Marcus Karlsson,,Timrå,D,2,0,0,0,0,0,0,0,0,0,0,0,0,0:00
,286,Fredrik Apel,,Brynäs,F,2,0,0,0,0,0,0,0,0,0,0,0,0,0:00
,286,Simon Östlund,,Brynäs,F,2,0,0,0,0,0,0,0,0,0,0,0,0,0:00
,286,Mattias Beck,83,AIK,F,2,0,0,0,0,0,0,0,0,0,0,0,0,0:00
,286,Fredrik Hynning,12,AIK,F,2,0,0,0,0,0,0,0,0,0,0,0,0,0:00
,286,Kristoffer Olsson,,Brynäs,Gk,2,0,0,0,0,0,0,0,0,0,0,0,0,0:00
,286,Niklas Zetterström,,Timrå,F,2,0,0,0,0,0,0,0,0,0,0,0,0,0:00
,297,Lars Ekelund,,HV71,F,3,0,0,0,0,0,0,0,0,0,0,0,0,0:00
,297,Jonas Almtorp,16,MODO,F,3,0,0,0,0,0,0,0,0,0,0,0,0,0:00
,297,Linus Thelander,,Timrå,Gk,3,0,0,0,0,0,0,0,0,0,0,0,0,0:00
,297,Christoffer Bohman,,SSK,Gk,3,0,0,0,0,0,0,0,0,0,0,0,0,0:00
,297,Martin Holst,99,Frölunda,Gk,3,0,0,0,0,0,0,0,0,0,0,0,0,0:00
,297,Erik Nilsson,,Färjestad,D,3,0,0,0,0,0,0,0,0,0,0,0,0,0:00
,297,Mattias Öhrling,,Timrå,Gk,3,0,0,0,0,0,0,0,0,0,0,0,0,0:00
,297,Johan Halvardsson,27,HV71,D,3,0,0,0,0,0,0,0,0,0,0,0,0,0:00
,305,Sebastian Meijer,13,HV71,F,4,0,0,0,0,0,0,0,0,0,0,0,0,0:00
,305,Ismo Kuoppala,,AIK,F,4,0,0,0,6,0,0,0,0,0,0,0,0,0:00
,305,Jeff Gustafsson,,HV71,F,4,0,0,0,0,0,0,0,0,0,0,0,0,0:00
,305,Fredrik Eriksson,,Färjestad,Gk,4,0,0,0,0,0,0,0,0,0,0,0,0,0:00
,309,Johan Jönfeldt,,Frölunda,Gk,5,0,0,0,0,0,0,0,0,0,0,0,0,0:00
,309,Jonas Johansson,61,HV71,F,5,0,0,0,0,0,0,0,0,0,0,0,0,0:00
,309,Björn Engström,,SSK,F,5,0,0,0,0,0,0,0,0,0,0,0,0,0:00
,312,Mats Christéen,,SSK,D,6,0,0,0,0,0,0,0,0,0,0,0,0,0:00
,312,Niclas Hedberg,,Timrå,D,6,0,0,0,8,0,0,0,0,0,0,0,0,0:00
,314,Mats Hansson,1021,Timrå,F,8,0,0,0,6,0,0,0,0,0,0,0,0,0:00
,314,David Ytfeldt,,Linköping,D,8,0,0,0,4,0,0,0,0,0,0,0,0,0:00
,316,Emil Lundberg,51,Luleå,F,9,0,0,0,0,0,0,0,0,0,0,0,0,0:00
,317,Jonas Fransson,32,HV71,Gk,10,0,0,0,0,0,0,0,0,0,0,0,0,0:00
,317,Erik Tägtström,,Timrå,D,10,0,0,0,2,0,0,0,0,0,0,0,0,0:00
,319,Stefan Jonsson,,SSK,D,11,0,0,0,16,0,0,0,0,0,0,0,0,0:00
,320,Per Mårs,,Brynäs,F,12,0,0,0,14,0,0,0,0,0,0,0,0,0:00
,321,Jonas Floberg,,Brynäs,F,13,0,0,0,0,0,0,0,0,0,0,0,0,0:00
,322,Michal Zajkowski,30,MODO,Gk,14,0,0,0,0,0,0,0,0,0,0,0,0,0:00
,322,Zdenek Smid,,Luleå,Gk,14,0,0,0,0,0,0,0,0,0,0,0,0,0:00
,322,Andreas Nyberg,,AIK,F,14,0,0,0,4,0,0,0,0,0,0,0,0,0:00
,322,Jiro Nihei,,Djurgården,Gk,14,0,0,0,0,0,0,0,0,0,0,0,0,0:00
,326,Per Helmersson,5,Frölunda,D,15,0,0,0,4,0,0,0,0,0,0,0,0,0:00
,327,Kimmo Kapanen,35,Timrå,Gk,20,0,0,0,0,0,0,0,0,0,0,0,0,0:00
,328,Santeri Heiskanen,,AIK,D,22,0,0,0,39,0,0,0,0,0,0,0,0,0:00
,329,Philippe De Rouville,,Timrå,Gk,28,0,0,0,0,0,0,0,0,0,0,0,0,0:00
,330,Jonas Johansson,,Luleå,D,34,0,0,0,0,0,0,0,0,0,0,0,0,0:00
,331,Erik Nilsson,,Luleå,Gk,36,0,0,0,0,0,0,0,0,0,0,0,0,0:00
,332,Tobias Lundström,,MODO,Gk,37,0,0,0,20,0,0,0,0,0,0,0,0,0:00
,333,Thomas Östlund,,Djurgården,Gk,38,0,0,0,0,0,0,0,0,0,0,0,0,0:00
,334,Stefan Liv,1,HV71,Gk,41,0,0,0,4,0,0,0,0,0,0,0,0,0:00
,334,Erik Lewerström,,/,D,41,0,0,0,53,0,0,0,0,0,0,0,0,0:00
,336,Boo Ahl,,HV71,Gk,45,0,0,0,2,0,0,0,0,0,0,0,0,0:00
,337,Henrik Lundqvist,,Frölunda,Gk,46,0,0,0,4,0,0,0,0,0,0,0,0,0:00
,337,Fredrik Andersson,,Timrå,Gk,46,0,0,0,29,0,0,0,0,0,0,0,0,0:00
,337,Mikael Gerdén,,Färjestad,Gk,46,0,0,0,2,0,0,0,0,0,0,0,0,0:00
,337,Petter Rönnquist,,Frölunda,Gk,46,0,0,0,4,0,0,0,0,0,0,0,0,0:00
,341,Magnus Lindquist,,SSK,Gk,47,0,0,0,0,0,0,0,0,0,0,0,0,0:00
,342,Fredrik Jensen,,Linköping,Gk,48,0,0,0,0,0,0,0,0,0,0,0,0,0:00
,342,Sergei Naumovs,,Djurgården,Gk,48,0,0,0,0,0,0,0,0,0,0,0,0,0:00
,344,Boris Zabka,,AIK,F,49,0,0,0,110,0,0,0,0,0,0,0,0,0:00
,344,Ola Nilsson,,Malmö,Gk,49,0,0,0,0,0,0,0,0,0,0,0,0,0:00
,344,Mattias Pettersson,,Brynäs,Gk,49,0,0,0,27,0,0,0,0,0,0,0,0,0:00
,344,Johan Asplund,35,Brynäs,Gk,49,0,0,0,6,0,0,0,0,0,0,0,0,0:00
,348,Rolf Wanhainen,,SSK,Gk,50,0,0,0,0,0,0,0,0,0,0,0,0,0:00
,348,Andreas Hadelöv,1,Malmö,Gk,50,0,0,0,16,0,0,0,0,0,0,0,0,0:00
,348,Martin Gerber,28,Färjestad,Gk,50,0,0,0,6,0,0,0,0,0,0,0,0,0:00
,348,Daniel Henriksson,40,Luleå,Gk,50,0,0,0,10,0,0,0,0,0,0,0,0,0:00
,348,Mike Valley,,AIK,Gk,50,0,0,0,2,0,0,0,0,0,0,0,0,0:00
,1,Kristian Huselius,20,Frölunda,F,49,32,35,67,26,9,10,0,0,0,0,0,0,0:00
,2,Mikael Renberg,19,Luleå,F,48,22,32,54,36,2,5,0,0,0,0,0,0,0:00
,3,Juha Riihijärvi,19,Malmö,F,50,22,31,53,26,2,6,0,0,0,0,0,0,0:00
,4,Jörgen Jönsson,21,Färjestad,F,50,20,26,46,32,4,3,0,0,0,0,0,0,0:00
,5,Jan Larsson,,Brynäs,F,50,17,29,46,16,3,6,0,0,0,0,0,0,0:00
,6,Henrik Zetterberg,,Timrå,F,47,15,31,46,24,4,4,0,0,0,0,0,0,0:00
,7,Robert Burakovsky,,Leksand,F,50,17,27,44,78,0,4,0,0,0,0,0,0,0:00
,8,Jonas Johnson,30,Frölunda,F,50,15,29,44,75,1,3,0,0,0,0,0,0,0:00
,9,Kristofer Ottosson,9,Djurgården,F,46,17,24,41,14,5,6,0,0,0,0,0,0,0:00
,10,Alexander Beliavski,,IFB,F,48,21,19,40,104,1,5,0,0,0,0,0,0,0:00
,11,Ulf Söderström,12,Färjestad,F,45,19,21,40,30,4,2,0,0,0,0,0,0,0:00
,12,Stefan Gustavson,,AIK,F,46,13,27,40,38,2,5,0,0,0,0,0,0,0:00
,13,Mikael Karlberg,,Leksand,F,47,12,27,39,16,1,0,0,0,0,0,0,0,0:00
,14,Tom Bissett,,Brynäs,F,50,21,17,38,30,5,6,0,0,0,0,0,0,0:00
,15,Daniel Rudslätt,14,Brynäs,F,48,17,21,38,46,6,4,0,0,0,0,0,0,0:00
,16,Christian Berglund,17,Färjestad,F,49,17,20,37,142,2,4,0,0,0,0,0,0,0:00
,17,Ove Molin,21,Brynäs,F,40,16,21,37,18,0,3,0,0,0,0,0,0,0:00
,18,Jens Nielsen,,Leksand,F,50,14,23,37,94,2,4,0,0,0,0,0,0,0:00
,19,Vladimir Orszagh,,Djurgården,F,50,23,13,36,62,3,10,0,0,0,0,0,0,0:00
,20,Marko Jantunen,1090,Färjestad,F,48,20,16,36,60,3,0,0,0,0,0,0,0,0:00
,21,Fredrik Öberg,48,HV71,F,45,18,17,35,73,4,3,0,0,0,0,0,0,0:00
,22,Stefan Hellkvist,,AIK,F,41,16,19,35,10,3,2,0,0,0,0,0,0,0:00
,23,Mathias Johansson,75,Färjestad,F,49,15,20,35,42,3,2,0,0,0,0,0,0,0:00
,24,Kristian Gahn,1017,AIK,F,50,14,21,35,38,3,4,0,0,0,0,0,0,0:00
,25,Jesper Mattsson,26,Malmö,F,49,17,17,34,63,0,3,0,0,0,0,0,0,0:00
,26,Magnus Johansson,7,Frölunda,D,50,6,28,34,26,4,4,0,0,0,0,0,0,0:00
,27,Peter Ström,1047,Frölunda,F,50,15,18,33,16,1,6,0,0,0,0,0,0,0:00
,28,Juha Ikonen,,Frölunda,F,50,12,21,33,36,1,2,0,0,0,0,0,0,0:00
,29,Mikael Johansson,,Djurgården,F,44,11,22,33,0,1,3,0,0,0,0,0,0,0:00
,30,Mattias Weinhandl,80,MODO,F,48,16,16,32,14,2,6,0,0,0,0,0,0,0:00
,31,Kim Staal,28,Malmö,F,48,16,15,31,32,4,1,0,0,0,0,0,0,0:00
,32,Martin Hostak,,Luleå,F,42,14,17,31,28,1,4,0,0,0,0,0,0,0:00
,33,Rickard Wallin,51,Färjestad,F,47,9,22,31,24,2,3,0,0,0,0,0,0,0:00
,34,Thomas Rhodin,25,Färjestad,D,50,7,24,31,77,1,5,0,0,0,0,0,0,0:00
,35,Nichlas Falk,16,Djurgården,F,47,6,25,31,14,1,3,0,0,0,0,0,0,0:00
,36,Robert Carlsson,12,Timrå,F,50,17,13,30,16,3,5,0,0,0,0,0,0,0:00
,37,Björn Ahlström,,AIK,F,38,16,14,30,47,2,3,0,0,0,0,0,0,0:00
,38,Hans Huczkowski,26,Luleå,F,49,13,16,29,14,4,5,0,0,0,0,0,0,0:00
,39,Marcel Jenni,,Färjestad,F,48,12,17,29,32,2,1,0,0,0,0,0,0,0:00
,40,Greger Artursson,,Färjestad,D,47,9,20,29,30,0,3,0,0,0,0,0,0,0:00
,41,Anders Burström,21,Luleå,F,48,11,17,28,44,3,4,0,0,0,0,0,0,0:00
,42,Dick Tärnström,6,AIK,D,50,10,18,28,28,4,4,0,0,0,0,0,0,0:00
,43,Jonathan Hedström,71,Luleå,F,46,9,19,28,68,2,2,0,0,0,0,0,0,0:00
,44,Roger Kyrö,,Brynäs,F,48,7,21,28,14,1,1,0,0,0,0,0,0,0:00
,45,Peter Ottosson,,HV71,F,45,16,11,27,20,1,6,0,0,0,0,0,0,0:00
,46,Mats Lindberg,,AIK,F,45,12,15,27,20,5,3,0,0,0,0,0,0,0:00
,47,Per Gustafsson,7,HV71,D,48,9,18,27,46,3,2,0,0,0,0,0,0,0:00
,48,Tomas Sandström,,Malmö,F,50,17,9,26,90,5,2,0,0,0,0,0,0,0:00
,49,Petter Nilsson,,Luleå,D,49,16,10,26,63,3,4,0,0,0,0,0,0,0:00
,50,Tony Mårtensson,9,Brynäs,F,50,15,11,26,20,3,1,0,0,0,0,0,0,0:00
,51,Mikko Luovi,,Brynäs,F,39,11,15,26,22,0,0,0,0,0,0,0,0,0:00
,52,Daniel Tjärnqvist,34,Djurgården,D,45,9,17,26,26,4,1,0,0,0,0,0,0,0:00
,53,Rikard Franzén,,AIK,D,50,7,19,26,100,2,3,0,0,0,0,0,0,0:00
,54,Tommy Pettersson,,MODO,F,50,18,7,25,49,5,5,0,0,0,0,0,0,0:00
,55,Radek Hamr,1032,Färjestad,F,50,13,12,25,38,2,3,0,0,0,0,0,0,0:00
,56,Mattias Remstam,75,HV71,F,43,11,14,25,49,2,5,0,0,0,0,0,0,0:00
,57,Björn Danielsson,23,AIK,F,47,11,14,25,20,3,1,0,0,0,0,0,0,0:00
,58,Tore Vikingstad,,Leksand,F,41,10,15,25,24,0,4,0,0,0,0,0,0,0:00
,59,Mikael Lind,36,Timrå,F,45,12,12,24,38,2,3,0,0,0,0,0,0,0:00
,60,Alexander Semjonov,,IFB,F,46,9,15,24,65,1,2,0,0,0,0,0,0,0:00
,61,Trond Magnussen,,Färjestad,F,45,7,17,24,26,0,0,0,0,0,0,0,0,0:00
,62,Joakim Eriksson,10,Djurgården,F,49,7,17,24,32,2,1,0,0,0,0,0,0,0:00
,63,Sami Mettovaara,,Luleå,F,48,6,18,24,69,0,1,0,0,0,0,0,0,0:00
,64,Linus Fagemo,,Timrå,F,48,14,9,23,24,4,3,0,0,0,0,0,0,0:00
,65,Pelle Prestberg,10,Frölunda,F,50,14,9,23,18,0,4,0,0,0,0,0,0,0:00
,66,Markus Matthiasson,92,Timrå,F,48,13,10,23,32,1,3,0,0,0,0,0,0,0:00
,67,Henrik Nordfeldt,,Leksand,F,50,13,10,23,73,3,1,0,0,0,0,0,0,0:00
,68,Oleg Belov,,HV71,F,47,9,14,23,10,2,2,0,0,0,0,0,0,0:00
,69,Mikael Wahlberg,,MODO,F,50,2,21,23,44,0,0,0,0,0,0,0,0,0:00
,70,Johan Tornberg,,Malmö,D,36,10,12,22,12,1,3,0,0,0,0,0,0,0:00
,71,Fredrik Bremberg,73,Malmö,F,42,10,12,22,10,5,2,0,0,0,0,0,0,0:00
,72,Pål Johnsen,,Leksand,F,47,10,12,22,10,2,2,0,0,0,0,0,0,0:00
,73,Andreas Salomonsson,15,Djurgården,F,48,10,12,22,46,1,3,0,0,0,0,0,0,0:00
,74,Clas Eriksson,,Färjestad,F,43,9,13,22,30,0,2,0,0,0,0,0,0,0:00
,75,Marko Tuulola,,Brynäs,D,44,8,14,22,95,1,2,0,0,0,0,0,0,0:00
,76,Thomas Berglund,,Luleå,F,48,8,14,22,99,2,4,0,0,0,0,0,0,0:00
,77,Peter Nordström,19,Färjestad,F,49,7,15,22,59,1,2,0,0,0,0,0,0,0:00
,78,Marcus Thuresson,,Malmö,F,40,5,17,22,47,0,0,0,0,0,0,0,0,0:00
,79,Peter Högardh,12,MODO,F,49,13,8,21,26,3,1,0,0,0,0,0,0,0:00
,80,Kyösti Karjalainen,,Djurgården,F,48,11,10,21,28,1,2,0,0,0,0,0,0,0:00
,81,Francois Bouchard,,Djurgården,D,48,10,11,21,58,3,5,0,0,0,0,0,0,0:00
,82,Daniel Wågström,,IFB,D,44,11,9,20,12,2,2,0,0,0,0,0,0,0:00
,83,Anders Gozzi,,AIK,F,48,10,10,20,40,1,3,0,0,0,0,0,0,0:00
,84,Mats Trygg,46,Färjestad,D,50,10,10,20,22,5,3,0,0,0,0,0,0,0:00
,85,Tommy Sjödin,7,Brynäs,D,50,9,11,20,69,0,1,0,0,0,0,0,0,0:00
,86,Magnus Wernblom,9,MODO,F,45,13,6,19,36,4,5,0,0,0,0,0,0,0:00
,87,Mathias Tjärnqvist,71,Djurgården,F,47,11,8,19,53,3,6,0,0,0,0,0,0,0:00
,88,Roger Åkerström,28,Luleå,D,47,6,13,19,28,3,3,0,0,0,0,0,0,0:00
,89,Pär Djoos,,Brynäs,D,43,2,17,19,44,0,1,0,0,0,0,0,0,0:00
,90,Jiri Kucera,,Luleå,F,34,10,8,18,8,3,2,0,0,0,0,0,0,0:00
,91,Timo Peltomaa,,Timrå,F,48,9,9,18,105,0,4,0,0,0,0,0,0,0:00
,92,David Nemirovsky,,HV71,F,26,7,11,18,45,0,0,0,0,0,0,0,0,0:00
,93,Patrik Carnbäck,,Frölunda,F,33,7,11,18,44,1,1,0,0,0,0,0,0,0:00
,94,Jan Hammar,,Malmö,F,45,7,11,18,10,2,0,0,0,0,0,0,0,0:00
,95,Charles Berglund,,Djurgården,F,48,7,11,18,60,1,1,0,0,0,0,0,0,0:00
,96,Mikael Wahlberg,23,Malmö,F,50,7,11,18,24,0,2,0,0,0,0,0,0,0:00
,97,Jörgen Bemström,24,MODO,F,35,5,13,18,16,1,1,0,0,0,0,0,0,0:00
,98,Johan Hult,,HV71,F,50,11,6,17,22,1,1,0,0,0,0,0,0,0:00
,99,Gabriel Karlsson,49,Leksand,F,35,9,8,17,10,2,4,0,0,0,0,0,0,0:00
,100,Marcus Magnertoft,,Malmö,F,47,9,8,17,20,0,4,0,0,0,0,0,0,0:00
,101,Marian Kacir,,IFB,F,19,8,9,17,4,0,2,0,0,0,0,0,0,0:00
,102,Stefan Larsson,,Frölunda,D,44,8,9,17,26,2,5,0,0,0,0,0,0,0:00
,103,Daniel Casselståhl,52,Timrå,D,49,7,10,17,28,1,4,0,0,0,0,0,0,0:00
,104,Martin Johansson,,IFB,D,50,5,12,17,22,0,1,0,0,0,0,0,0,0:00
,105,Niklas Brännström,,HV71,F,31,10,6,16,12,2,3,0,0,0,0,0,0,0:00
,106,Göran Hermansson,,IFB,F,40,10,6,16,42,2,1,0,0,0,0,0,0,0:00
,107,Mikael Andersson,,Frölunda,F,48,10,6,16,12,2,2,0,0,0,0,0,0,0:00
,108,Christer Olsson,,Brynäs,D,46,9,7,16,28,0,6,0,0,0,0,0,0,0:00
,109,Fredrik Stillman,,HV71,D,42,7,9,16,18,0,1,0,0,0,0,0,0,0:00
,110,Markus Sjöberg,,Timrå,F,40,4,12,16,6,1,1,0,0,0,0,0,0,0:00
,111,Peter Hagström,,/,F,47,4,12,16,14,1,2,0,0,0,0,0,0,0:00
,112,Anders Söderberg,26,MODO,F,42,11,4,15,12,2,0,0,0,0,0,0,0,0:00
,113,Johan Molin,,Brynäs,F,46,10,5,15,8,4,1,0,0,0,0,0,0,0:00
,114,Marius Trygg,,Färjestad,F,48,9,6,15,0,0,0,0,0,0,0,0,0,0:00
,115,Johan Garpenlöv,,Djurgården,F,29,8,7,15,80,2,3,0,0,0,0,0,0,0:00
,116,Johan Lindström,,Brynäs,F,38,8,7,15,52,1,0,0,0,0,0,0,0,0:00
,117,Christian Lechtaler,,IFB,F,50,7,8,15,46,0,5,0,0,0,0,0,0,0:00
,117,Jimmie Ölvestad,19,Djurgården,F,50,7,8,15,79,3,1,0,0,0,0,0,0,0:00
,119,Daniel Rydmark,,Malmö,F,43,6,9,15,48,3,2,0,0,0,0,0,0,0:00
,120,Mikael Lindman,,HV71,D,45,5,10,15,16,1,3,0,0,0,0,0,0,0:00
,121,Osmo Soutukorva,,Luleå,D,46,5,10,15,30,0,3,0,0,0,0,0,0,0:00
,122,Niklas Anger,17,AIK,F,50,5,10,15,22,0,0,0,0,0,0,0,0,0:00
,123,Lars Edström,,Luleå,F,45,4,11,15,37,1,1,0,0,0,0,0,0,0:00
,123,Xavier Majic,,MODO,F,45,4,11,15,93,0,2,0,0,0,0,0,0,0:00
,125,Mikael Pettersson,19,MODO,F,55,11,3,14,28,2,0,0,0,0,0,0,0,0:00
,126,Daniel Olsson,,Brynäs,F,47,8,6,14,16,2,0,0,0,0,0,0,0,0:00
,127,Magnus Kahnberg,11,Frölunda,F,50,8,6,14,6,0,1,0,0,0,0,0,0,0:00
,128,David Petrasek,22,Malmö,D,47,7,7,14,74,1,2,0,0,0,0,0,0,0:00
,129,Rastislav Pavlikovsky,14,HV71,F,23,6,8,14,93,0,0,0,0,0,0,0,0,0:00
,130,Henrik Eriksson,,Timrå,F,45,5,9,14,18,2,0,0,0,0,0,0,0,0:00
,131,Per Hallin,8,Timrå,F,48,5,9,14,18,0,2,0,0,0,0,0,0,0:00
,132,Daniel Glimmenvall,6,Brynäs,D,50,5,9,14,44,1,1,0,0,0,0,0,0,0:00
,133,Jan Huokko,,Leksand,F,44,8,5,13,28,1,1,0,0,0,0,0,0,0:00
,134,Stefan Örnskog,,HV71,F,41,7,6,13,16,1,0,0,0,0,0,0,0,0:00
,135,Edvin Frylén,36,Djurgården,D,47,7,6,13,34,1,0,0,0,0,0,0,0,0:00
,136,Pierre Hedin,21,MODO,D,46,5,8,13,59,2,1,0,0,0,0,0,0,0:00
,137,Erik Norbäck,,AIK,F,48,3,10,13,10,0,0,0,0,0,0,0,0,0:00
,138,Pasi Petriläinen,,Timrå,D,49,3,10,13,22,0,0,0,0,0,0,0,0,0:00
,139,Peter Ekelund,,HV71,F,19,8,4,12,10,2,0,0,0,0,0,0,0,0:00
,140,Lars Briell,,IFB,F,50,7,5,12,32,2,2,0,0,0,0,0,0,0:00
,141,Christian Söderström,82,Timrå,F,46,6,6,12,16,0,1,0,0,0,0,0,0,0:00
,142,Henrik Malmström,9,Malmö,F,50,6,6,12,10,0,1,0,0,0,0,0,0,0:00
,143,Lars Jansson,,MODO,D,44,3,9,12,18,1,3,0,0,0,0,0,0,0:00
,144,Fredrik Svensson,4,Luleå,D,46,3,9,12,51,0,1,0,0,0,0,0,0,0:00
,145,Henrik Nilsson,,Frölunda,F,49,3,9,12,16,1,1,0,0,0,0,0,0,0:00
,146,Ola Thorwalls,,HV71,D,47,2,10,12,57,0,0,0,0,0,0,0,0,0:00
,147,Tommi Hämäläinen,,IFB,D,49,2,10,12,76,0,1,0,0,0,0,0,0,0:00
,148,Fredrik Näsvall,,IFB,F,47,8,3,11,62,1,1,0,0,0,0,0,0,0:00
,149,Daniel Widing,41,Leksand,F,40,6,5,11,18,1,1,0,0,0,0,0,0,0:00
,150,Jörgen Hermansson,,IFB,D,48,6,5,11,61,1,2,0,0,0,0,0,0,0:00
,151,Timmy Pettersson,33,Frölunda,D,50,6,5,11,54,0,1,0,0,0,0,0,0,0:00
,152,Per-Åge Skröder,10,HV71,F,13,5,6,11,6,0,0,0,0,0,0,0,0,0:00
,153,Sergei Fokin,,Färjestad,D,43,5,6,11,34,0,1,0,0,0,0,0,0,0:00
,154,Pär Holmqvist,,IFB,F,49,4,7,11,28,1,1,0,0,0,0,0,0,0:00
,155,Peter Jakobsson,,Malmö,D,50,4,7,11,18,0,1,0,0,0,0,0,0,0:00
,156,Jan-Axel Alavaara,55,MODO,D,39,3,8,11,22,0,1,0,0,0,0,0,0,0:00
,157,Per Hållberg,18,MODO,D,40,3,8,11,38,2,0,0,0,0,0,0,0,0:00
,158,Mika Hannula,33,Malmö,F,45,2,9,11,26,0,0,0,0,0,0,0,0,0:00
,159,Marcus Karlsson,,Timrå,D,48,2,9,11,40,0,0,0,0,0,0,0,0,0:00
,160,Christian Bäckman,5,Frölunda,D,50,1,10,11,32,0,1,0,0,0,0,0,0,0:00
,161,Nik Zupancic,,Timrå,F,47,9,1,10,18,2,3,0,0,0,0,0,0,0:00
,162,Roger Öhman,,Malmö,D,20,5,5,10,12,2,0,0,0,0,0,0,0,0:00
,163,Stefan Öhman,,MODO,F,46,4,6,10,34,0,1,0,0,0,0,0,0,0:00
,164,Magnus Svensson,,Leksand,D,50,4,6,10,52,1,2,0,0,0,0,0,0,0:00
,165,Torgny Löwgren,,Leksand,F,45,3,7,10,10,2,1,0,0,0,0,0,0,0:00
,166,Ronnie Sundin,23,Frölunda,D,47,3,7,10,32,0,0,0,0,0,0,0,0,0:00
,167,Per Löfström,,Leksand,D,48,2,8,10,62,1,1,0,0,0,0,0,0,0:00
,168,Niklas Kronwall,,Djurgården,D,31,1,9,10,32,0,0,0,0,0,0,0,0,0:00
,169,Mattias Svedberg,,AIK,D,49,7,2,9,50,0,1,0,0,0,0,0,0,0:00
,170,Torbjörn Johansson,,Leksand,D,50,6,3,9,59,1,3,0,0,0,0,0,0,0:00
,171,Jonas Esbjörs,22,HV71,F,23,5,4,9,8,0,0,0,0,0,0,0,0,0:00
,172,Mathias Bosson,,IFB,F,47,5,4,9,18,0,1,0,0,0,0,0,0,0:00
,173,Pär Styf,36,Timrå,D,42,4,5,9,36,1,1,0,0,0,0,0,0,0:00
,174,Mikael Magnusson,,Djurgården,D,46,4,5,9,123,1,1,0,0,0,0,0,0,0:00
,175,Johan Boman,,IFB,F,47,4,5,9,36,1,0,0,0,0,0,0,0,0:00
,176,Roger Johansson,,Färjestad,D,31,3,6,9,34,0,1,0,0,0,0,0,0,0:00
,177,Jesper Jäger,,IFB,D,46,0,9,9,109,0,0,0,0,0,0,0,0,0:00
,178,Fredrik Warg,29,MODO,F,47,7,1,8,14,1,1,0,0,0,0,0,0,0:00
,179,Greg Parks,,Leksand,F,11,5,3,8,10,0,4,0,0,0,0,0,0,0:00
,180,Thomas Johansson,18,AIK,D,16,4,4,8,16,0,0,0,0,0,0,0,0,0:00
,181,Erik Andersson,,AIK,F,27,4,4,8,16,0,0,0,0,0,0,0,0,0:00
,182,Magnus Salmi,,Timrå,F,47,4,4,8,10,1,0,0,0,0,0,0,0,0:00
,183,Vaclav Burda,,Luleå,D,16,3,5,8,16,0,1,0,0,0,0,0,0,0:00
,184,Joakim Lundberg,,Malmö,D,43,3,5,8,42,1,0,0,0,0,0,0,0,0:00
,185,Niklas Eriksson,,Leksand,F,18,4,3,7,12,0,0,0,0,0,0,0,0,0:00
,186,Magnus Eriksson,,Luleå,D,47,3,4,7,26,0,0,0,0,0,0,0,0,0:00
,187,Niklas Persson,23,Leksand,F,48,3,4,7,43,2,0,0,0,0,0,0,0,0:00
,188,Fredrik Krekula,10,AIK,F,49,3,4,7,58,1,1,0,0,0,0,0,0,0:00
,189,Nicklas Rahm,,Frölunda,D,50,3,4,7,46,0,1,0,0,0,0,0,0,0:00
,190,Ronnie Pettersson,6,Djurgården,D,40,2,5,7,16,1,0,0,0,0,0,0,0,0:00
,191,Jari Tolsa,17,Frölunda,F,42,2,5,7,18,0,0,0,0,0,0,0,0,0:00
,191,Kenneth Bergqvist,41,Brynäs,F,42,2,5,7,12,0,0,0,0,0,0,0,0,0:00
,193,Jonas Finn Olsson,,Djurgården,F,45,1,6,7,59,0,0,0,0,0,0,0,0,0:00
,194,Johan Finnström,,Luleå,D,46,1,6,7,40,0,0,0,0,0,0,0,0,0:00
,195,Pär Edlund,,Frölunda,F,50,5,1,6,65,0,1,0,0,0,0,0,0,0:00
,196,Marcus Kristoffersson,38,Djurgården,F,29,4,2,6,72,0,2,0,0,0,0,0,0,0:00
,197,David Bornhammar,,AIK,D,37,4,2,6,57,0,0,0,0,0,0,0,0,0:00
,198,Tomas Nänsén,,Timrå,D,36,3,3,6,52,0,2,0,0,0,0,0,0,0:00
,199,Mattias Hedlund,,IFB,D,39,3,3,6,24,0,2,0,0,0,0,0,0,0:00
,200,Jesper Duus,14,MODO,D,43,3,3,6,18,1,0,0,0,0,0,0,0,0:00
,201,Igor Matushkin,,IFB,F,22,2,4,6,14,1,0,0,0,0,0,0,0,0:00
,202,Fredrik Bergquist,22,IFB,D,32,2,4,6,10,1,1,0,0,0,0,0,0,0:00
,203,Per-Anton Lundström,8,AIK,D,50,2,4,6,63,0,0,0,0,0,0,0,0,0:00
,204,Johan Lindbom,,HV71,F,21,1,5,6,26,0,0,0,0,0,0,0,0,0:00
,205,Christian Sjögren,14,Djurgården,F,35,4,1,5,73,1,0,0,0,0,0,0,0,0:00
,206,Robert Petrovicky,,MODO,F,7,3,2,5,10,0,0,0,0,0,0,0,0,0:00
,207,Jari Kauppila,33,Luleå,F,10,3,2,5,8,1,1,0,0,0,0,0,0,0:00
,208,Tomas Alm,,Djurgården,F,34,3,2,5,14,0,0,0,0,0,0,0,0,0:00
,209,Mikael Lövgren,,Luleå,F,36,3,2,5,6,0,1,0,0,0,0,0,0,0:00
,210,Joakim Lindström,10,MODO,F,10,2,3,5,2,0,0,0,0,0,0,0,0,0:00
,211,Henrik Petré,79,Brynäs,D,27,2,3,5,20,1,0,0,0,0,0,0,0,0:00
,212,Martin Jansson,77,Leksand,F,28,2,3,5,20,0,1,0,0,0,0,0,0,0:00
,213,Fredrik Sjöström,18,Frölunda,F,31,2,3,5,6,1,0,0,0,0,0,0,0,0:00
,214,Joacim Esbjörs,,HV71,D,40,2,3,5,36,1,1,0,0,0,0,0,0,0:00
,215,Jan Öberg,9,MODO,F,48,2,3,5,18,0,1,0,0,0,0,0,0,0:00
,216,Patrik Tano,,Luleå,F,23,1,4,5,0,0,1,0,0,0,0,0,0,0:00
,217,Andreas Pihl,2,MODO,D,48,1,4,5,88,0,0,0,0,0,0,0,0,0:00
,218,Mikael Lindholm,,Timrå,F,14,0,5,5,12,0,0,0,0,0,0,0,0,0:00
,219,Rikard Ekström,,AIK,D,46,0,5,5,24,0,0,0,0,0,0,0,0,0:00
,220,Erik Lewerström,,Färjestad,D,45,4,0,4,45,1,0,0,0,0,0,0,0,0:00
,221,Torbjörn Lindberg,,Luleå,D,46,3,1,4,22,1,0,0,0,0,0,0,0,0:00
,222,Magnus Axelsson,,HV71,F,29,2,2,4,2,1,0,0,0,0,0,0,0,0:00
,223,Jonas Nordquist,39,Leksand,F,35,2,2,4,4,0,0,0,0,0,0,0,0,0:00
,224,Christian Due-Boje,,Malmö,D,45,2,2,4,67,0,1,0,0,0,0,0,0,0:00
,225,Jan Sandström,7,AIK,D,18,1,3,4,10,0,0,0,0,0,0,0,0,0:00
,226,Jonas Elofsson,,HV71,D,30,1,3,4,12,1,1,0,0,0,0,0,0,0:00
,227,Peter Hasselblad,,Malmö,D,45,1,3,4,89,0,0,0,0,0,0,0,0,0:00
,227,Daniel Ljungkvist,16,HV71,D,45,1,3,4,14,0,0,0,0,0,0,0,0,0:00
,229,Jarmo Myllys,,Luleå,Gk,46,1,3,4,53,0,0,0,0,0,0,0,0,0:00
,230,Teemu Sillanpää,,Frölunda,D,47,1,3,4,75,0,0,0,0,0,0,0,0,0:00
,231,Jonas Frögren,24,Färjestad,D,49,3,0,3,10,1,0,0,0,0,0,0,0,0:00
,232,Lars Jonsson,20,Leksand,D,31,2,1,3,12,0,1,0,0,0,0,0,0,0:00
,233,Björn Melin,9,HV71,F,43,2,1,3,26,0,0,0,0,0,0,0,0,0:00
,234,Stefan Klockare,,Timrå,D,49,2,1,3,12,0,2,0,0,0,0,0,0,0:00
,235,Anders Carlsson,,Leksand,F,10,1,2,3,4,0,0,0,0,0,0,0,0,0:00
,236,Daniel Hermansson,22,Leksand,F,20,1,2,3,2,0,0,0,0,0,0,0,0,0:00
,237,Robert Ljunggren,,IFB,D,47,1,2,3,40,1,1,0,0,0,0,0,0,0:00
,237,Jörgen Eriksson,,Timrå,D,47,1,2,3,18,0,1,0,0,0,0,0,0,0:00
,239,Niko Halttunen,,IFB,F,13,0,3,3,6,0,0,0,0,0,0,0,0,0:00
,240,Joakim Persson,,Brynäs,D,42,0,3,3,8,0,0,0,0,0,0,0,0,0:00
,241,Jens Karlsson,58,Frölunda,F,19,2,0,2,4,0,2,0,0,0,0,0,0,0:00
,242,Daniel Josefsson,12,HV71,D,18,1,1,2,4,0,0,0,0,0,0,0,0,0:00
,243,Anders Huss,,Timrå,F,23,1,1,2,6,0,0,0,0,0,0,0,0,0:00
,244,Robert Schnabel,,Timrå,D,16,0,2,2,72,0,0,0,0,0,0,0,0,0:00
,245,Patrik Wallenberg,,MODO,F,18,0,2,2,2,0,0,0,0,0,0,0,0,0:00
,246,Kristoffer Jobs,,Brynäs,F,25,0,2,2,2,0,0,0,0,0,0,0,0,0:00
,247,Anders Lönn,,HV71,F,31,0,2,2,6,0,0,0,0,0,0,0,0,0:00
,248,Johan Asplund,35,Brynäs,Gk,44,0,2,2,6,0,0,0,0,0,0,0,0,0:00
,249,Mattias Nilimaa,,HV71,F,11,1,0,1,4,0,0,0,0,0,0,0,0,0:00
,250,Per Ledin,97,Luleå,F,18,1,0,1,14,0,0,0,0,0,0,0,0,0:00
,251,Johan Söderström,,Leksand,F,20,1,0,1,0,0,0,0,0,0,0,0,0,0:00
,252,Patrik Nilson,,Djurgården,F,24,1,0,1,4,0,0,0,0,0,0,0,0,0:00
,253,Johan Ramstedt,11,IFB,F,39,1,0,1,4,1,0,0,0,0,0,0,0,0:00
,254,John Vecchiarelli,,IFB,F,4,0,1,1,4,0,0,0,0,0,0,0,0,0:00
,255,Viktor Wallin,,HV71,D,5,0,1,1,2,0,0,0,0,0,0,0,0,0:00
,256,Raymond Giroux,,AIK,D,9,0,1,1,16,0,0,0,0,0,0,0,0,0:00
,256,David Ytfeldt,,Frölunda,D,9,0,1,1,8,0,0,0,0,0,0,0,0,0:00
,258,Jonas Floberg,,Brynäs,F,12,0,1,1,0,0,0,0,0,0,0,0,0,0:00
,259,André Mattsson,,AIK,D,18,0,1,1,2,0,0,0,0,0,0,0,0,0:00
,260,Viktor Ignatjevs,,Leksand,D,39,0,1,1,32,0,0,0,0,0,0,0,0,0:00
,261,Timothy Thomas,,AIK,Gk,43,0,1,1,10,0,0,0,0,0,0,0,0,0:00
,262,Andreas Hadelöv,1,Malmö,Gk,45,0,1,1,2,0,0,0,0,0,0,0,0,0:00
,263,Daniel Larsson,,Leksand,D,50,0,1,1,18,0,0,0,0,0,0,0,0,0:00
,263,Andreas Pettersson,,AIK,F,50,0,1,1,0,0,0,0,0,0,0,0,0,0:00
,263,Magnus Eriksson,,Färjestad,Gk,50,0,1,1,4,0,0,0,0,0,0,0,0,0:00
,266,Erik Nilsson,,Färjestad,D,1,0,0,0,0,0,0,0,0,0,0,0,0,0:00
,266,Andreas Jämtin,18,Färjestad,F,1,0,0,0,0,0,0,0,0,0,0,0,0,0:00
,266,Peter Öberg,27,MODO,F,1,0,0,0,0,0,0,0,0,0,0,0,0,0:00
,266,Martin Persson,,Malmö,D,1,0,0,0,0,0,0,0,0,0,0,0,0,0:00
,266,Lars Johansson,,Luleå,Gk,1,0,0,0,0,0,0,0,0,0,0,0,0,0:00
,266,Martin Axelsson,,HV71,F,1,0,0,0,0,0,0,0,0,0,0,0,0,0:00
,266,Magnus Lööf,,Timrå,Gk,1,0,0,0,0,0,0,0,0,0,0,0,0,0:00
,266,Mikael Zettergren,,Leksand,F,1,0,0,0,0,0,0,0,0,0,0,0,0,0:00
,266,Olle Häggström,,Brynäs,F,1,0,0,0,0,0,0,0,0,0,0,0,0,0:00
,266,Lars Modig,,Luleå,D,1,0,0,0,0,0,0,0,0,0,0,0,0,0:00
,266,David Finnström,,Färjestad,Gk,1,0,0,0,0,0,0,0,0,0,0,0,0,0:00
,266,Fredrik Elvebakk,,HV71,Gk,1,0,0,0,0,0,0,0,0,0,0,0,0,0:00
,266,Fredrik Hynning,12,AIK,F,1,0,0,0,0,0,0,0,0,0,0,0,0,0:00
,266,Björn Bjurling,31,Luleå,Gk,1,0,0,0,0,0,0,0,0,0,0,0,0,0:00
,280,Michal Zajkowski,30,MODO,Gk,2,0,0,0,0,0,0,0,0,0,0,0,0,0:00
,280,Jan Öhman,,Leksand,D,2,0,0,0,0,0,0,0,0,0,0,0,0,0:00
,280,Henrik Smångs,,Leksand,Gk,2,0,0,0,0,0,0,0,0,0,0,0,0,0:00
,280,Jeff Gustafsson,,HV71,F,2,0,0,0,0,0,0,0,0,0,0,0,0,0:00
,280,Fredrik Eriksson,8,Färjestad,D,2,0,0,0,0,0,0,0,0,0,0,0,0,0:00
,280,Johan Eneqvist,,Leksand,F,2,0,0,0,0,0,0,0,0,0,0,0,0,0:00
,286,Patrik Ström,,HV71,D,3,0,0,0,0,0,0,0,0,0,0,0,0,0:00
,286,Niklas Wästlund,,MODO,D,3,0,0,0,2,0,0,0,0,0,0,0,0,0:00
,286,Fredrik Eriksson,,Färjestad,Gk,3,0,0,0,0,0,0,0,0,0,0,0,0,0:00
,286,Jörgen Wikström,,IFB,Gk,3,0,0,0,0,0,0,0,0,0,0,0,0,0:00
,286,Michael Irani,,HV71,D,3,0,0,0,0,0,0,0,0,0,0,0,0,0:00
,286,Andreas Lindström,,Luleå,F,3,0,0,0,0,0,0,0,0,0,0,0,0,0:00
,292,Erik Nilsson,,Luleå,Gk,4,0,0,0,0,0,0,0,0,0,0,0,0,0:00
,292,Jan Chmelar,,Djurgården,Gk,4,0,0,0,0,0,0,0,0,0,0,0,0,0:00
,292,Mike Valley,,IFB,Gk,4,0,0,0,0,0,0,0,0,0,0,0,0,0:00
,292,Marko Kauppinen,6,AIK,D,4,0,0,0,4,0,0,0,0,0,0,0,0,0:00
,292,Daniel Wessner,62,Färjestad,F,4,0,0,0,0,0,0,0,0,0,0,0,0,0:00
,292,Ronnie Rüeger,,AIK,Gk,4,0,0,0,0,0,0,0,0,0,0,0,0,0:00
,292,Fredrik Ericson,38,AIK,D,4,0,0,0,0,0,0,0,0,0,0,0,0,0:00
,299,John Nyh,,Malmö,D,5,0,0,0,0,0,0,0,0,0,0,0,0,0:00
,299,Andreas Svensson,,Malmö,F,5,0,0,0,2,0,0,0,0,0,0,0,0,0:00
,299,Alexander Westin,,IFB,Gk,5,0,0,0,0,0,0,0,0,0,0,0,0,0:00
,302,Tobias Wiklund,,IFB,Gk,6,0,0,0,0,0,0,0,0,0,0,0,0,0:00
,302,Peter Kumpulainen,,AIK,F,6,0,0,0,0,0,0,0,0,0,0,0,0,0:00
,302,Kristoffer Olsson,,Brynäs,Gk,6,0,0,0,0,0,0,0,0,0,0,0,0,0:00
,302,Per Mårs,,Brynäs,F,6,0,0,0,0,0,0,0,0,0,0,0,0,0:00
,306,Daniel Lundholm,,Luleå,F,8,0,0,0,0,0,0,0,0,0,0,0,0,0:00
,307,Alexander Sundberg,24,Malmö,F,9,0,0,0,0,0,0,0,0,0,0,0,0,0:00
,307,Joel Lundqvist,20,Frölunda,F,9,0,0,0,0,0,0,0,0,0,0,0,0,0:00
,307,Alexander Bodén,,IFB,F,9,0,0,0,0,0,0,0,0,0,0,0,0,0:00
,307,Mikael Thomasson,,Malmö,F,9,0,0,0,0,0,0,0,0,0,0,0,0,0:00
,311,Jonnie Karlsson,,Malmö,D,10,0,0,0,0,0,0,0,0,0,0,0,0,0:00
,311,Mathias Lindmark,,IFB,Gk,10,0,0,0,0,0,0,0,0,0,0,0,0,0:00
,311,Jörgen Sundqvist,22,Leksand,D,10,0,0,0,2,0,0,0,0,0,0,0,0,0:00
,311,Niklas Holm,,Malmö,Gk,10,0,0,0,0,0,0,0,0,0,0,0,0,0:00
,315,Sergei Naumovs,,Leksand,Gk,12,0,0,0,0,0,0,0,0,0,0,0,0,0:00
,316,Henrik Lundqvist,,Frölunda,Gk,14,0,0,0,2,0,0,0,0,0,0,0,0,0:00
,316,Pär Arlbrandt,40,HV71,F,14,0,0,0,0,0,0,0,0,0,0,0,0,0:00
,318,Daniel Sperrle,1,Leksand,Gk,16,0,0,0,0,0,0,0,0,0,0,0,0,0:00
,318,Joakim Nimarker,,Malmö,D,16,0,0,0,4,0,0,0,0,0,0,0,0,0:00
,320,Fredrik Josefson,,AIK,Gk,23,0,0,0,0,0,0,0,0,0,0,0,0,0:00
,321,Petter Rönnquist,,IFB,Gk,24,0,0,0,0,0,0,0,0,0,0,0,0,0:00
,322,Jimmy Danielsson,,Leksand,Gk,27,0,0,0,0,0,0,0,0,0,0,0,0,0:00
,323,Karl Fabricius,52,Luleå,F,28,0,0,0,6,0,0,0,0,0,0,0,0,0:00
,323,Olli Julkunen,,Luleå,F,28,0,0,0,0,0,0,0,0,0,0,0,0,0:00
,325,Kjell Bennemark,,AIK,Gk,30,0,0,0,0,0,0,0,0,0,0,0,0,0:00
,326,Stefan Bergkvist,,Leksand,D,31,0,0,0,82,0,0,0,0,0,0,0,0,0:00
,327,Johan Halvardsson,27,HV71,D,33,0,0,0,24,0,0,0,0,0,0,0,0,0:00
,328,Pat Jablonski,,Frölunda,Gk,36,0,0,0,0,0,0,0,0,0,0,0,0,0:00
,328,Herman Hultgren,,Brynäs,D,36,0,0,0,30,0,0,0,0,0,0,0,0,0:00
,330,Tomi Källarsson,,Timrå,D,37,0,0,0,54,0,0,0,0,0,0,0,0,0:00
,331,Reinhard Divis,38,Leksand,Gk,42,0,0,0,8,0,0,0,0,0,0,0,0,0:00
,332,Ola Nilsson,,Malmö,Gk,45,0,0,0,2,0,0,0,0,0,0,0,0,0:00
,333,Mikael Gerdén,,Färjestad,Gk,46,0,0,0,4,0,0,0,0,0,0,0,0,0:00
,334,Martin Holst,99,Djurgården,Gk,47,0,0,0,0,0,0,0,0,0,0,0,0,0:00
,335,Daniel Henriksson,40,Luleå,Gk,48,0,0,0,2,0,0,0,0,0,0,0,0,0:00
,335,Tobias Lundström,,MODO,Gk,48,0,0,0,2,0,0,0,0,0,0,0,0,0:00
,335,Petter Sandström,,IFB,Gk,48,0,0,0,2,0,0,0,0,0,0,0,0,0:00
,338,Mikael Tellqvist,32,Djurgården,Gk,49,0,0,0,2,0,0,0,0,0,0,0,0,0:00
,338,Fredrik Andersson,,Timrå,Gk,49,0,0,0,4,0,0,0,0,0,0,0,0,0:00
,338,Stefan Liv,1,HV71,Gk,49,0,0,0,4,0,0,0,0,0,0,0,0,0:00
,341,Boo Ahl,,Timrå,Gk,50,0,0,0,4,0,0,0,0,0,0,0,0,0:00
,341,Jonas Fransson,32,HV71,Gk,50,0,0,0,4,0,0,0,0,0,0,0,0,0:00
,341,Håkan Algotsson,,Frölunda,Gk,50,0,0,0,2,0,0,0,0,0,0,0,0,0:00
,341,Mattias Pettersson,,Brynäs,Gk,50,0,0,0,0,0,0,0,0,0,0,0,0,0:00
,341,Peter Hirsch,15,MODO,Gk,50,0,0,0,0,0,0,0,0,0,0,0,0,0:00
,1,Juha Riihijärvi,19,Malmö,F,48,20,36,56,26,2,0,0,0,0,0,0,0,0:00
,2,Espen Knutsen,,Djurgården,F,48,18,35,53,65,5,0,0,0,0,0,0,0,0:00
,3,Tom Bissett,,Brynäs,F,50,15,37,52,55,4,0,0,0,0,0,0,0,0:00
,4,Jan Larsson,,Brynäs,F,50,26,25,51,55,3,0,0,0,0,0,0,0,0:00
,5,Kristian Gahn,1017,AIK,F,50,9,39,48,52,3,0,0,0,0,0,0,0,0:00
,6,Stefan Gustavson,,AIK,F,49,18,29,47,20,3,0,0,0,0,0,0,0,0:00
,6,Jens Nielsen,,Leksand,F,49,18,29,47,47,2,0,0,0,0,0,0,0,0:00
,8,Henrik Sedin,,MODO,F,50,9,38,47,22,3,0,0,0,0,0,0,0,0:00
,9,Roger Kyrö,,Brynäs,F,50,19,27,46,18,2,0,0,0,0,0,0,0,0:00
,10,Rikard Franzén,,AIK,D,49,17,29,46,54,4,0,0,0,0,0,0,0,0:00
,11,Daniel Sedin,,MODO,F,50,19,26,45,28,4,0,0,0,0,0,0,0,0:00
,12,Mats Lindberg,,AIK,F,40,25,19,44,18,3,0,0,0,0,0,0,0,0:00
,13,Björn Ahlström,,AIK,F,48,21,23,44,42,4,0,0,0,0,0,0,0,0:00
,14,Kristian Huselius,20,Frölunda,F,50,21,23,44,20,3,0,0,0,0,0,0,0,0:00
,15,Ove Molin,21,Brynäs,F,48,22,21,43,44,5,0,0,0,0,0,0,0,0:00
,16,Anders Carlsson,,Leksand,F,48,11,30,41,34,2,0,0,0,0,0,0,0,0:00
,17,Kristofer Ottosson,9,Djurgården,F,47,25,15,40,12,5,0,0,0,0,0,0,0,0:00
,18,Patrik Carnbäck,,Frölunda,F,46,17,23,40,85,4,0,0,0,0,0,0,0,0:00
,19,Martin Hostak,,Luleå,F,50,23,16,39,60,8,0,0,0,0,0,0,0,0:00
,20,Mathias Johansson,75,Färjestad,F,49,20,19,39,40,3,0,0,0,0,0,0,0,0:00
,21,Mikael Johansson,,Djurgården,F,49,17,22,39,16,4,0,0,0,0,0,0,0,0:00
,22,Peter Ekelund,,HV71,F,50,17,22,39,28,3,0,0,0,0,0,0,0,0:00
,23,Jonas Rönnqvist,,Luleå,F,49,15,24,39,42,1,0,0,0,0,0,0,0,0:00
,24,Peter Ström,1047,Frölunda,F,50,12,26,38,20,3,0,0,0,0,0,0,0,0:00
,25,Oleg Belov,,HV71,F,49,16,21,37,53,2,0,0,0,0,0,0,0,0:00
,26,Stefan Hellkvist,,Leksand,F,49,23,13,36,22,1,0,0,0,0,0,0,0,0:00
,27,Marko Jantunen,1090,Färjestad,F,50,18,18,36,36,3,0,0,0,0,0,0,0,0:00
,28,Jesper Mattsson,26,Malmö,F,50,17,19,36,40,3,0,0,0,0,0,0,0,0:00
,29,Anders Burström,21,Luleå,F,50,16,20,36,54,1,0,0,0,0,0,0,0,0:00
,30,Jonas Johnson,30,Frölunda,F,50,17,18,35,73,3,0,0,0,0,0,0,0,0:00
,31,Marcus Thuresson,,Malmö,F,45,9,26,35,50,0,0,0,0,0,0,0,0,0:00
,32,Daniel Rydmark,,VIK,F,46,17,17,34,36,3,0,0,0,0,0,0,0,0:00
,33,Mikael Håkanson,51,Djurgården,F,48,17,17,34,26,1,0,0,0,0,0,0,0,0:00
,34,Jiri Kucera,,Luleå,F,47,13,21,34,34,1,0,0,0,0,0,0,0,0:00
,35,Magnus Johansson,7,Frölunda,D,49,12,22,34,20,3,0,0,0,0,0,0,0,0:00
,36,Hans Huczkowski,26,Luleå,F,48,20,13,33,10,1,0,0,0,0,0,0,0,0:00
,37,Per Eklund,,Djurgården,F,50,20,13,33,38,3,0,0,0,0,0,0,0,0:00
,38,Antti Törmänen,,HV71,F,50,18,15,33,76,3,0,0,0,0,0,0,0,0:00
,39,Niklas Sundblad,,Malmö,F,47,22,10,32,75,4,0,0,0,0,0,0,0,0:00
,40,Jonas Esbjörs,22,HV71,F,47,19,13,32,36,2,0,0,0,0,0,0,0,0:00
,41,Markus Åkerblom,,Leksand,F,48,13,19,32,56,1,0,0,0,0,0,0,0,0:00
,42,Juha Ikonen,,Frölunda,F,49,12,20,32,38,3,0,0,0,0,0,0,0,0:00
,43,Trond Magnussen,,Färjestad,F,49,18,13,31,32,5,0,0,0,0,0,0,0,0:00
,44,Magnus Wernblom,9,MODO,F,49,20,10,30,84,3,0,0,0,0,0,0,0,0:00
,45,Mikael Karlberg,,Leksand,F,50,14,16,30,32,1,0,0,0,0,0,0,0,0:00
,46,Jörgen Bemström,24,Luleå,F,36,10,20,30,6,2,0,0,0,0,0,0,0,0:00
,47,Fredrik Öberg,48,VIK,F,49,10,20,30,64,2,0,0,0,0,0,0,0,0:00
,48,Pasi Saarela,,Frölunda,F,49,17,12,29,18,5,0,0,0,0,0,0,0,0:00
,49,Greg Parks,,Leksand,F,36,16,13,29,52,3,0,0,0,0,0,0,0,0:00
,50,Tomas Sandström,,Malmö,F,42,16,13,29,28,3,0,0,0,0,0,0,0,0:00
,51,Thomas Johansson,18,Djurgården,D,39,15,14,29,20,1,0,0,0,0,0,0,0,0:00
,52,Björn Nord,,Djurgården,D,49,17,11,28,62,3,0,0,0,0,0,0,0,0:00
,53,Niklas Eriksson,,Leksand,F,44,11,17,28,61,2,0,0,0,0,0,0,0,0:00
,54,Lars Edström,,Luleå,F,48,11,17,28,16,4,0,0,0,0,0,0,0,0:00
,54,Niklas Sjökvist,,Färjestad,F,48,11,17,28,33,3,0,0,0,0,0,0,0,0:00
,56,Thomas Berglund,,Luleå,F,45,5,23,28,67,1,0,0,0,0,0,0,0,0:00
,57,Pär Djoos,,Brynäs,D,48,5,23,28,40,3,0,0,0,0,0,0,0,0:00
,58,Samuel Påhlsson,26,MODO,F,47,16,11,27,87,3,0,0,0,0,0,0,0,0:00
,59,Clas Eriksson,,Färjestad,F,46,11,16,27,26,0,0,0,0,0,0,0,0,0:00
,60,Marko Tuulola,,Brynäs,D,49,10,17,27,51,2,0,0,0,0,0,0,0,0:00
,61,Ulf Söderström,12,Linköping,F,49,9,18,27,32,0,0,0,0,0,0,0,0,0:00
,62,Tore Vikingstad,,Färjestad,F,47,8,19,27,26,0,0,0,0,0,0,0,0,0:00
,63,Nichlas Falk,16,Djurgården,F,49,4,23,27,18,2,0,0,0,0,0,0,0,0:00
,64,Johan Tornberg,,Malmö,D,42,11,15,26,50,3,0,0,0,0,0,0,0,0:00
,65,Mikko Luovi,,Brynäs,F,38,9,17,26,18,1,0,0,0,0,0,0,0,0:00
,66,Jonathan Hedström,71,Luleå,F,48,9,17,26,46,1,0,0,0,0,0,0,0,0:00
,67,Anders Söderberg,26,MODO,F,43,15,10,25,18,2,0,0,0,0,0,0,0,0:00
,68,Daniel Rudslätt,14,Brynäs,F,44,13,12,25,24,2,0,0,0,0,0,0,0,0:00
,69,Jan Huokko,,Leksand,F,44,10,15,25,30,2,0,0,0,0,0,0,0,0:00
,70,Marcus Magnertoft,,Malmö,F,45,9,16,25,26,3,0,0,0,0,0,0,0,0:00
,71,Mattias Weinhandl,80,MODO,F,32,15,9,24,6,4,0,0,0,0,0,0,0,0:00
,72,Kim Staal,28,Malmö,F,50,14,10,24,24,1,0,0,0,0,0,0,0,0:00
,73,Mattias Remstam,75,HV71,F,41,13,11,24,35,2,0,0,0,0,0,0,0,0:00
,74,Per Lundell,,Leksand,D,46,12,12,24,10,3,0,0,0,0,0,0,0,0:00
,75,Mathias Tjärnqvist,71,Djurgården,F,50,12,12,24,20,1,0,0,0,0,0,0,0,0:00
,76,Stefan Larsson,,Frölunda,D,50,11,13,24,24,0,0,0,0,0,0,0,0,0:00
,76,Niklas Anger,17,AIK,F,50,11,13,24,14,2,0,0,0,0,0,0,0,0:00
,78,Peter Hagström,,Färjestad,F,50,10,14,24,10,3,0,0,0,0,0,0,0,0:00
,79,Andreas Salomonsson,15,MODO,F,48,9,15,24,38,0,0,0,0,0,0,0,0,0:00
,80,Pelle Prestberg,10,Färjestad,F,48,13,9,22,26,2,0,0,0,0,0,0,0,0:00
,81,Johan Molin,,VIK,F,48,10,12,22,2,1,0,0,0,0,0,0,0,0:00
,82,Henrik Nordfeldt,,Linköping,F,50,9,13,22,107,0,0,0,0,0,0,0,0,0:00
,83,Peter Nordström,19,Färjestad,F,45,8,14,22,48,3,0,0,0,0,0,0,0,0:00
,84,Tommy Sjödin,7,Brynäs,D,50,8,14,22,44,1,0,0,0,0,0,0,0,0:00
,85,Dick Tärnström,6,AIK,D,42,7,15,22,20,1,0,0,0,0,0,0,0,0:00
,86,Greger Artursson,,Färjestad,D,49,10,11,21,40,1,0,0,0,0,0,0,0,0:00
,87,Patrik Zetterberg,,/ VIK,F,46,7,14,21,18,1,0,0,0,0,0,0,0,0:00
,88,Petter Nilsson,,Frölunda,D,47,7,14,21,50,1,0,0,0,0,0,0,0,0:00
,89,Radek Hamr,1032,Färjestad,F,50,7,14,21,46,0,0,0,0,0,0,0,0,0:00
,90,Per Gustafsson,7,HV71,D,40,6,15,21,47,4,0,0,0,0,0,0,0,0:00
,91,Henrik Andersson,,Linköping,F,50,12,8,20,36,0,0,0,0,0,0,0,0,0:00
,92,Erik Norbäck,,AIK,F,50,11,9,20,32,0,0,0,0,0,0,0,0,0:00
,93,Peter Casparsson,,Linköping,F,48,8,11,19,42,1,0,0,0,0,0,0,0,0:00
,94,Andreas Lilja,,Malmö,D,49,8,11,19,88,2,0,0,0,0,0,0,0,0:00
,95,Anders Lönn,,HV71,F,43,7,12,19,64,0,0,0,0,0,0,0,0,0:00
,96,Jesper Duus,14,MODO,D,49,7,12,19,53,1,0,0,0,0,0,0,0,0:00
,97,Daniel Tjärnqvist,34,Djurgården,D,42,3,16,19,8,3,0,0,0,0,0,0,0,0:00
,98,Jan Hammar,,Malmö,F,50,10,8,18,6,1,0,0,0,0,0,0,0,0:00
,99,Johan Forsander,,HV71,F,48,9,9,18,6,2,0,0,0,0,0,0,0,0:00
,100,Roger Johansson,,Färjestad,D,43,5,13,18,58,1,0,0,0,0,0,0,0,0:00
,101,Mikael Lindholm,,Malmö,F,48,3,15,18,114,0,0,0,0,0,0,0,0,0:00
,102,Charles Berglund,,Djurgården,F,50,3,15,18,54,1,0,0,0,0,0,0,0,0:00
,103,Roger Rosén,,VIK,F,49,10,7,17,63,0,0,0,0,0,0,0,0,0:00
,104,Joakim Eriksson,10,Djurgården,F,50,8,9,17,32,1,0,0,0,0,0,0,0,0:00
,105,Edvin Frylén,36,Linköping,D,45,10,6,16,30,0,0,0,0,0,0,0,0,0:00
,106,Niclas Wallin,26,Brynäs,D,48,7,9,16,73,0,0,0,0,0,0,0,0,0:00
,107,Henrik Nilsson,,Frölunda,F,50,3,13,16,10,2,0,0,0,0,0,0,0,0:00
,108,Roger Jönsson,,VIK,F,49,10,5,15,40,2,0,0,0,0,0,0,0,0:00
,109,Vaclav Burda,,Luleå,D,44,7,8,15,30,1,0,0,0,0,0,0,0,0:00
,110,Erik Andersson,,AIK,F,50,7,8,15,62,4,0,0,0,0,0,0,0,0:00
,111,Paul Andersson Everberg,,VIK,F,46,6,9,15,16,1,0,0,0,0,0,0,0,0:00
,112,Jonas Finn Olsson,,VIK,F,49,6,9,15,83,1,0,0,0,0,0,0,0,0:00
,113,Sergei Fokin,,Färjestad,D,50,5,10,15,50,0,0,0,0,0,0,0,0,0:00
,114,Mikael Lövgren,,Luleå,F,50,10,4,14,26,1,0,0,0,0,0,0,0,0:00
,115,Pierre Hedin,21,MODO,D,48,9,5,14,36,1,0,0,0,0,0,0,0,0:00
,116,Jukka Tiilikainen,,AIK,F,29,8,6,14,22,0,0,0,0,0,0,0,0,0:00
,117,Christian Berglund,17,Färjestad,F,43,8,6,14,44,1,0,0,0,0,0,0,0,0:00
,118,Peter Jakobsson,,Malmö,D,45,6,8,14,28,2,0,0,0,0,0,0,0,0:00
,119,Jan-Axel Alavaara,55,MODO,D,43,5,9,14,48,0,0,0,0,0,0,0,0,0:00
,120,Mikael Pettersson,,VIK,F,26,4,10,14,0,0,0,0,0,0,0,0,0,0:00
,121,Tommy Pettersson,,MODO,F,28,4,10,14,10,2,0,0,0,0,0,0,0,0:00
,122,Fredrik Johansson,,Linköping,F,24,9,4,13,32,2,0,0,0,0,0,0,0,0:00
,123,Mike Helber,,Linköping,F,46,9,4,13,36,0,0,0,0,0,0,0,0,0:00
,124,Fredrik Svensson,4,Luleå,D,44,7,6,13,68,3,0,0,0,0,0,0,0,0:00
,125,Joacim Esbjörs,,HV71,D,46,6,7,13,38,1,0,0,0,0,0,0,0,0:00
,126,Fredrik Emvall,33,Linköping,F,48,5,8,13,44,0,0,0,0,0,0,0,0,0:00
,127,Jarkko Varvio,,AIK,F,26,4,9,13,12,0,0,0,0,0,0,0,0,0:00
,128,Roger Åkerström,28,Luleå,D,47,4,9,13,24,3,0,0,0,0,0,0,0,0:00
,129,Mattias Nilimaa,,Linköping,F,48,3,10,13,34,0,0,0,0,0,0,0,0,0:00
,130,Ragnar Karlsson,27,Linköping,F,45,6,6,12,47,2,0,0,0,0,0,0,0,0:00
,131,Johan Lindström,,Brynäs,F,46,6,6,12,91,1,0,0,0,0,0,0,0,0:00
,132,Mats Lusth,,Malmö,D,38,5,7,12,81,1,0,0,0,0,0,0,0,0:00
,133,Dennis Ejdeholm,,Linköping,F,43,5,7,12,14,3,0,0,0,0,0,0,0,0:00
,134,Andreas Pihl,2,MODO,D,50,5,7,12,76,1,0,0,0,0,0,0,0,0:00
,135,Johan Hult,,HV71,F,49,4,8,12,28,0,0,0,0,0,0,0,0,0:00
,136,David Ytfeldt,,Leksand,D,50,3,9,12,72,0,0,0,0,0,0,0,0,0:00
,137,Linus Fagemo,,Frölunda,F,50,7,4,11,49,0,0,0,0,0,0,0,0,0:00
,138,Toivo Suursoo,,Malmö,F,32,6,5,11,24,1,0,0,0,0,0,0,0,0:00
,139,Jani Nikko,,HV71,D,47,6,5,11,55,3,0,0,0,0,0,0,0,0:00
,140,Mikael Pettersson,19,MODO,F,49,6,5,11,22,2,0,0,0,0,0,0,0,0:00
,141,Mikael Magnusson,,Djurgården,D,49,5,6,11,73,0,0,0,0,0,0,0,0,0:00
,142,Daniel Olsson,,Brynäs,F,48,3,8,11,20,1,0,0,0,0,0,0,0,0:00
,143,Stefan Örnskog,,HV71,F,25,2,9,11,8,1,0,0,0,0,0,0,0,0:00
,144,Joakim Lundberg,,VIK,D,46,7,3,10,61,1,0,0,0,0,0,0,0,0:00
,145,Marcel Jenni,,Färjestad,F,14,6,4,10,18,2,0,0,0,0,0,0,0,0:00
,146,Stefan Lundqvist,,Brynäs,F,48,6,4,10,12,0,0,0,0,0,0,0,0,0:00
,147,Magnus Nilsson,24,Malmö,F,44,5,5,10,63,1,0,0,0,0,0,0,0,0:00
,148,Ronnie Sundin,23,Frölunda,D,49,5,5,10,40,0,0,0,0,0,0,0,0,0:00
,149,David Petrasek,22,HV71,D,46,4,6,10,54,2,0,0,0,0,0,0,0,0:00
,150,Peter Nylander,11,VIK,F,50,4,6,10,32,0,0,0,0,0,0,0,0,0:00
,151,Johan Bülow,,Linköping,F,50,3,7,10,32,1,0,0,0,0,0,0,0,0:00
,152,Mikael Lindman,,HV71,D,45,2,8,10,18,0,0,0,0,0,0,0,0,0:00
,153,Henrik Malmström,9,Malmö,F,43,1,9,10,4,0,0,0,0,0,0,0,0,0:00
,154,Per-Åge Skröder,10,/,F,37,7,2,9,51,2,0,0,0,0,0,0,0,0:00
,155,Jimmie Ölvestad,19,Djurgården,F,50,6,3,9,34,1,0,0,0,0,0,0,0,0:00
,156,Dave Archibald,,Linköping,F,21,5,4,9,18,0,0,0,0,0,0,0,0,0:00
,157,Torgny Löwgren,,Leksand,F,37,5,4,9,12,0,0,0,0,0,0,0,0,0:00
,158,Johan Lindbom,,HV71,F,31,4,5,9,28,0,0,0,0,0,0,0,0,0:00
,159,Pär Edlund,,Frölunda,F,44,4,5,9,46,0,0,0,0,0,0,0,0,0:00
,160,Fredrik Krekula,10,AIK,F,46,4,5,9,32,0,0,0,0,0,0,0,0,0:00
,161,Per-Anton Lundström,8,AIK,D,50,4,5,9,48,0,0,0,0,0,0,0,0,0:00
,162,Jonas Elofsson,,Färjestad,D,47,3,6,9,44,0,0,0,0,0,0,0,0,0:00
,163,Marius Trygg,,Färjestad,F,43,2,7,9,4,0,0,0,0,0,0,0,0,0:00
,164,Henric Björkman,,VIK,D,48,2,7,9,22,0,0,0,0,0,0,0,0,0:00
,165,Andreas Custemo,,Brynäs,D,47,1,8,9,16,0,0,0,0,0,0,0,0,0:00
,166,Mats Trygg,46,Färjestad,D,29,0,9,9,8,0,0,0,0,0,0,0,0,0:00
,167,Kenneth Bergqvist,41,Brynäs,F,35,5,3,8,2,1,0,0,0,0,0,0,0,0:00
,168,Magnus Salmi,,VIK,F,49,5,3,8,20,0,0,0,0,0,0,0,0,0:00
,169,Gabriel Karlsson,49,HV71,F,50,5,3,8,12,1,0,0,0,0,0,0,0,0:00
,170,Lars-Göran Wiklander,,Djurgården,F,46,4,4,8,18,1,0,0,0,0,0,0,0,0:00
,170,Martin Jansson,77,Leksand,F,46,4,4,8,26,0,0,0,0,0,0,0,0,0:00
,172,Vadym Slivchenko,,Färjestad,F,17,3,5,8,26,0,0,0,0,0,0,0,0,0:00
,173,Peter Hasselblad,,Malmö,D,46,3,5,8,48,2,0,0,0,0,0,0,0,0:00
,174,Torbjörn Lindberg,,Luleå,D,40,2,6,8,18,2,0,0,0,0,0,0,0,0:00
,175,Francois Bouchard,,MODO,D,41,2,6,8,38,0,0,0,0,0,0,0,0,0:00
,176,Patrik Allvin,,Leksand,D,46,2,6,8,60,1,0,0,0,0,0,0,0,0:00
,177,Jan Sandström,7,AIK,D,49,2,6,8,22,0,0,0,0,0,0,0,0,0:00
,178,Stefan Öhman,,MODO,F,47,5,2,7,16,0,0,0,0,0,0,0,0,0:00
,179,Mikael Samuelsson,37,Brynäs,F,40,4,3,7,76,1,0,0,0,0,0,0,0,0:00
,180,Timmy Pettersson,33,Frölunda,D,47,4,3,7,8,0,0,0,0,0,0,0,0,0:00
,181,Osmo Soutukorva,,Luleå,D,33,3,4,7,22,0,0,0,0,0,0,0,0,0:00
,182,Göran Hermansson,,Brynäs,F,45,3,4,7,12,1,0,0,0,0,0,0,0,0:00
,183,Niklas Persson,23,Leksand,F,49,2,5,7,34,1,0,0,0,0,0,0,0,0:00
,183,Peter Berndtsson,,Frölunda,F,49,2,5,7,16,0,0,0,0,0,0,0,0,0:00
,185,Mikko Konttila,,Djurgården,F,45,1,6,7,12,0,0,0,0,0,0,0,0,0:00
,186,Fredrik Wallberg,,Linköping,D,44,0,7,7,59,0,0,0,0,0,0,0,0,0:00
,187,Bo Svanberg,,Malmö,F,43,3,3,6,55,1,0,0,0,0,0,0,0,0:00
,188,Henrik Petré,79,Brynäs,D,47,3,3,6,73,1,0,0,0,0,0,0,0,0:00
,189,Rikard Ekström,,VIK,D,45,2,4,6,34,1,0,0,0,0,0,0,0,0:00
,190,Per Hållberg,18,MODO,D,41,1,5,6,38,1,0,0,0,0,0,0,0,0:00
,191,Marcus Karlsson,,MODO,D,27,0,6,6,8,0,0,0,0,0,0,0,0,0:00
,192,Jesper Damgaard,7,Malmö,D,35,0,6,6,16,0,0,0,0,0,0,0,0,0:00
,193,Martin Knold,,Linköping,D,26,3,2,5,16,1,0,0,0,0,0,0,0,0:00
,194,Torbjörn Johansson,,Leksand,D,50,3,2,5,32,0,0,0,0,0,0,0,0,0:00
,195,Erkki Saramaa,,Linköping,D,47,2,3,5,36,0,0,0,0,0,0,0,0,0:00
,196,Niklas Kronwall,,Djurgården,D,37,1,4,5,16,0,0,0,0,0,0,0,0,0:00
,197,Johan Finnström,,Luleå,D,46,1,4,5,71,1,0,0,0,0,0,0,0,0:00
,198,Niklas Nordquist,,Linköping,D,34,0,5,5,18,0,0,0,0,0,0,0,0,0:00
,199,Morten Green,13,Leksand,F,40,0,5,5,0,0,0,0,0,0,0,0,0,0:00
,200,Mattias Karlin,,MODO,F,42,0,5,5,10,0,0,0,0,0,0,0,0,0:00
,201,Pierre Ivarsson,,Linköping,D,45,0,5,5,32,0,0,0,0,0,0,0,0,0:00
,202,Mattias Svedberg,,AIK,D,34,2,2,4,18,0,0,0,0,0,0,0,0,0:00
,203,Daniel Carlsson,,Linköping,D,35,2,2,4,46,0,0,0,0,0,0,0,0,0:00
,203,Lars Hallström,,Djurgården,F,35,2,2,4,12,0,0,0,0,0,0,0,0,0:00
,205,Viktor Wallin,,HV71,D,43,2,2,4,16,0,0,0,0,0,0,0,0,0:00
,206,Joakim Musakka,,Malmö,D,47,2,2,4,56,0,0,0,0,0,0,0,0,0:00
,207,Andrey Lyulin,,VIK,D,32,1,3,4,20,1,0,0,0,0,0,0,0,0:00
,208,Henrik Rehnberg,,Färjestad,D,46,1,3,4,66,0,0,0,0,0,0,0,0,0:00
,208,Joakim Backlund,,VIK,F,46,1,3,4,12,1,0,0,0,0,0,0,0,0:00
,210,Anders Myrvold,,AIK,D,49,1,3,4,87,0,0,0,0,0,0,0,0,0:00
,211,Magnus Eriksson,,Luleå,D,50,1,3,4,32,0,0,0,0,0,0,0,0,0:00
,212,Björn Melin,9,HV71,F,23,3,0,3,2,0,0,0,0,0,0,0,0,0:00
,213,Andreas Kreü,,Linköping,F,10,2,1,3,6,0,0,0,0,0,0,0,0,0:00
,214,Henric Höglund,,Leksand,F,19,2,1,3,4,0,0,0,0,0,0,0,0,0:00
,215,Ronnie Pettersson,6,Djurgården,D,40,1,2,3,38,0,0,0,0,0,0,0,0,0:00
,216,Daniel Larsson,,Leksand,D,41,1,2,3,16,0,0,0,0,0,0,0,0,0:00
,217,Johan Åström,,Luleå,F,50,1,2,3,32,0,0,0,0,0,0,0,0,0:00
,218,Stefan Bergkvist,,Leksand,D,27,0,3,3,61,0,0,0,0,0,0,0,0,0:00
,219,Patrik Aronsson,,Frölunda,D,38,0,3,3,14,0,0,0,0,0,0,0,0,0:00
,220,Johan Halvardsson,27,HV71,D,46,0,3,3,75,0,0,0,0,0,0,0,0,0:00
,220,Reid Simonton,,Frölunda,D,46,0,3,3,66,0,0,0,0,0,0,0,0,0:00
,222,Oleg Yashin,,Linköping,F,5,1,1,2,29,0,0,0,0,0,0,0,0,0:00
,223,Jens Öhman,,MODO,F,14,1,1,2,2,1,0,0,0,0,0,0,0,0:00
,224,Conny Strömberg,24,MODO,F,25,1,1,2,2,0,0,0,0,0,0,0,0,0:00
,225,Vesa Toskala,31,Färjestad,Gk,50,1,1,2,30,0,0,0,0,0,0,0,0,0:00
,226,Jonnie Karlsson,,VIK,D,17,0,2,2,22,0,0,0,0,0,0,0,0,0:00
,227,Daniel Wallin,,HV71,F,21,0,2,2,14,0,0,0,0,0,0,0,0,0:00
,228,Denis Chervyakov,,VIK,D,33,0,2,2,136,0,0,0,0,0,0,0,0,0:00
,229,David Engblom,33,AIK,F,37,0,2,2,24,0,0,0,0,0,0,0,0,0:00
,230,Henrik Tallinder,,AIK,D,50,0,2,2,59,0,0,0,0,0,0,0,0,0:00
,231,Christian Sjögren,14,Djurgården,F,13,1,0,1,12,0,0,0,0,0,0,0,0,0:00
,232,Fredrik Johnsson,,HV71,F,18,1,0,1,0,0,0,0,0,0,0,0,0,0:00
,233,Christian Bäckman,5,Frölunda,D,27,1,0,1,14,0,0,0,0,0,0,0,0,0:00
,234,Matthias Holmstedt,,VIK,D,40,1,0,1,16,0,0,0,0,0,0,0,0,0:00
,235,Rod Miller,,Linköping,D,4,0,1,1,14,0,0,0,0,0,0,0,0,0:00
,236,Thomas Fahlstedt,,Brynäs,F,5,0,1,1,0,0,0,0,0,0,0,0,0,0:00
,237,Martin Persson,,Malmö,D,7,0,1,1,4,0,0,0,0,0,0,0,0,0:00
,238,Olli Julkunen,,Luleå,F,15,0,1,1,0,0,0,0,0,0,0,0,0,0:00
,239,Tobias Holm,,VIK,F,21,0,1,1,14,0,0,0,0,0,0,0,0,0:00
,240,Jan Öberg,9,MODO,F,40,0,1,1,4,0,0,0,0,0,0,0,0,0:00
,241,Jarmo Myllys,,Luleå,Gk,44,0,1,1,46,0,0,0,0,0,0,0,0,0:00
,242,Johan Asplund,35,Brynäs,Gk,48,0,1,1,2,0,0,0,0,0,0,0,0,0:00
,242,Per-Ragnar Bergkvist,,Färjestad,Gk,48,0,1,1,2,0,0,0,0,0,0,0,0,0:00
,242,Tommy Söderström,,Djurgården,Gk,48,0,1,1,2,0,0,0,0,0,0,0,0,0:00
,245,Jonas Forsberg,,AIK,Gk,50,0,1,1,2,0,0,0,0,0,0,0,0,0:00
,245,Tobias Lundström,,MODO,Gk,50,0,1,1,2,0,0,0,0,0,0,0,0,0:00
,245,Magnus Eriksson,,VIK,Gk,50,0,1,1,8,0,0,0,0,0,0,0,0,0:00
,248,Daniel Strid,,Linköping,F,1,0,0,0,0,0,0,0,0,0,0,0,0,0:00
,248,Jim Ivars,,Frölunda,D,1,0,0,0,0,0,0,0,0,0,0,0,0,0:00
,248,Johan Reineck,,Leksand,F,1,0,0,0,0,0,0,0,0,0,0,0,0,0:00
,248,Rickard Rehnberg,,Färjestad,F,1,0,0,0,0,0,0,0,0,0,0,0,0,0:00
,248,Olle Häggström,,Brynäs,F,1,0,0,0,0,0,0,0,0,0,0,0,0,0:00
,248,Martin Albihn,,Malmö,Gk,1,0,0,0,0,0,0,0,0,0,0,0,0,0:00
,248,Ola Thorwalls,,HV71,D,1,0,0,0,2,0,0,0,0,0,0,0,0,0:00
,248,Fredrik Eriksson,,Färjestad,Gk,1,0,0,0,0,0,0,0,0,0,0,0,0,0:00
,248,Patrik Lindfors,,Malmö,D,1,0,0,0,0,0,0,0,0,0,0,0,0,0:00
,248,Marcus Liljeblad,,HV71,F,1,0,0,0,0,0,0,0,0,0,0,0,0,0:00
,248,Jens Kellertz,,Linköping,F,1,0,0,0,0,0,0,0,0,0,0,0,0,0:00
,248,Tom Olsson,,Färjestad,Gk,1,0,0,0,0,0,0,0,0,0,0,0,0,0:00
,248,Kristoffer Jobs,,Brynäs,F,1,0,0,0,0,0,0,0,0,0,0,0,0,0:00
,261,Andreas Hallberg,,Leksand,F,2,0,0,0,0,0,0,0,0,0,0,0,0,0:00
,261,Daniel Sperrle,1,Leksand,Gk,2,0,0,0,0,0,0,0,0,0,0,0,0,0:00
,261,Mikael Hammarström,,Brynäs,F,2,0,0,0,0,0,0,0,0,0,0,0,0,0:00
,261,Nicklas Dyrén,,Frölunda,Gk,2,0,0,0,0,0,0,0,0,0,0,0,0,0:00
,261,Jonas Fransson,32,HV71,Gk,2,0,0,0,0,0,0,0,0,0,0,0,0,0:00
,261,Jörgen Sundqvist,22,Leksand,D,2,0,0,0,2,0,0,0,0,0,0,0,0,0:00
,261,Jonas Fändriks,,Leksand,D,2,0,0,0,0,0,0,0,0,0,0,0,0,0:00
,261,Tamas Gröschl,,Leksand,F,2,0,0,0,0,0,0,0,0,0,0,0,0,0:00
,261,Johan Söderström,,Leksand,F,2,0,0,0,0,0,0,0,0,0,0,0,0,0:00
,261,Erik Nilsén,,Luleå,D,2,0,0,0,0,0,0,0,0,0,0,0,0,0:00
,271,Johan Högberg,,AIK,Gk,3,0,0,0,0,0,0,0,0,0,0,0,0,0:00
,271,Daniel Widing,41,Leksand,F,3,0,0,0,2,0,0,0,0,0,0,0,0,0:00
,271,Kalle Mattsson,,Brynäs,Gk,3,0,0,0,0,0,0,0,0,0,0,0,0,0:00
,271,Jonas Nordquist,39,Leksand,F,3,0,0,0,0,0,0,0,0,0,0,0,0,0:00
,271,Jens Lodén,,VIK,Gk,3,0,0,0,0,0,0,0,0,0,0,0,0,0:00
,276,Jens Fredriksson,,Luleå,Gk,4,0,0,0,0,0,0,0,0,0,0,0,0,0:00
,276,Erik Nilsson,,Luleå,Gk,4,0,0,0,0,0,0,0,0,0,0,0,0,0:00
,276,Olov Modig,,Luleå,Gk,4,0,0,0,0,0,0,0,0,0,0,0,0,0:00
,276,Magnus Kahnberg,11,Frölunda,F,4,0,0,0,0,0,0,0,0,0,0,0,0,0:00
,276,Magnus Zirath,,Djurgården,Gk,4,0,0,0,0,0,0,0,0,0,0,0,0,0:00
,276,Daniel Josefsson,12,HV71,D,4,0,0,0,0,0,0,0,0,0,0,0,0,0:00
,282,Daniel Westin,,Färjestad,D,5,0,0,0,0,0,0,0,0,0,0,0,0,0:00
,282,Lars Jonsson,20,Leksand,D,5,0,0,0,4,0,0,0,0,0,0,0,0,0:00
,282,Andreas Sundvall,,Luleå,D,5,0,0,0,0,0,0,0,0,0,0,0,0,0:00
,282,Daniel Lundholm,,Luleå,F,5,0,0,0,0,0,0,0,0,0,0,0,0,0:00
,282,Kristoffer Nyberg,,MODO,Gk,5,0,0,0,0,0,0,0,0,0,0,0,0,0:00
,282,Fredrik Ericson,38,AIK,D,5,0,0,0,0,0,0,0,0,0,0,0,0,0:00
,288,Stefan Holmgren,,VIK,F,6,0,0,0,2,0,0,0,0,0,0,0,0,0:00
,288,Patrik Nilson,,Djurgården,F,6,0,0,0,2,0,0,0,0,0,0,0,0,0:00
,288,Niklas Holm,,Malmö,Gk,6,0,0,0,0,0,0,0,0,0,0,0,0,0:00
,291,Kjell Bennemark,,AIK,Gk,7,0,0,0,0,0,0,0,0,0,0,0,0,0:00
,291,Jonas Norberg,,Linköping,F,7,0,0,0,0,0,0,0,0,0,0,0,0,0:00
,293,Jan Chmelar,,Djurgården,Gk,8,0,0,0,0,0,0,0,0,0,0,0,0,0:00
,294,Jonas Ferm,,Linköping,F,9,0,0,0,0,0,0,0,0,0,0,0,0,0:00
,294,Joakim Persson,,Brynäs,D,9,0,0,0,0,0,0,0,0,0,0,0,0,0:00
,294,Patrik Höglund,,VIK,D,9,0,0,0,0,0,0,0,0,0,0,0,0,0:00
,297,Jari Tolsa,17,Frölunda,F,10,0,0,0,0,0,0,0,0,0,0,0,0,0:00
,297,Marcus Kristoffersson,38,HV71,F,10,0,0,0,0,0,0,0,0,0,0,0,0,0:00
,299,Marco Poulsen,,AIK,F,11,0,0,0,0,0,0,0,0,0,0,0,0,0:00
,299,Arto Blomsten,,VIK,D,11,0,0,0,6,0,0,0,0,0,0,0,0,0:00
,299,Mårten Parbrand,,Linköping,D,11,0,0,0,8,0,0,0,0,0,0,0,0,0:00
,299,Fredrik Warg,29,MODO,F,11,0,0,0,4,0,0,0,0,0,0,0,0,0:00
,303,André Mattsson,,AIK,D,12,0,0,0,4,0,0,0,0,0,0,0,0,0:00
,303,Tobias Bössfall,,Linköping,Gk,12,0,0,0,0,0,0,0,0,0,0,0,0,0:00
,305,Daniel Christiansson,,Leksand,D,15,0,0,0,14,0,0,0,0,0,0,0,0,0:00
,306,Magnus Boman,,Luleå,F,16,0,0,0,2,0,0,0,0,0,0,0,0,0:00
,307,Dan Fredriksson,,Leksand,D,17,0,0,0,2,0,0,0,0,0,0,0,0,0:00
,308,Jan Lundell,,Frölunda,Gk,19,0,0,0,0,0,0,0,0,0,0,0,0,0:00
,309,Daniel Ljungkvist,16,HV71,D,20,0,0,0,6,0,0,0,0,0,0,0,0,0:00
,310,Dmitri Tchikin,,VIK,D,21,0,0,0,45,0,0,0,0,0,0,0,0,0:00
,311,Andreas Andersson,54,HV71,Gk,22,0,0,0,0,0,0,0,0,0,0,0,0,0:00
,312,Jesper Hendén,,Linköping,D,23,0,0,0,6,0,0,0,0,0,0,0,0,0:00
,313,Stefan Liv,1,HV71,Gk,27,0,0,0,2,0,0,0,0,0,0,0,0,0:00
,314,Pat Jablonski,,Frölunda,Gk,29,0,0,0,0,0,0,0,0,0,0,0,0,0:00
,315,Herman Hultgren,,Brynäs,D,35,0,0,0,18,0,0,0,0,0,0,0,0,0:00
,316,Fredrik Jensen,,Linköping,Gk,38,0,0,0,4,0,0,0,0,0,0,0,0,0:00
,317,Mikael Tellqvist,32,Djurgården,Gk,40,0,0,0,2,0,0,0,0,0,0,0,0,0:00
,317,Andreas Pettersson,,AIK,F,40,0,0,0,0,0,0,0,0,0,0,0,0,0:00
,317,Mattias Pettersson,,AIK,Gk,40,0,0,0,8,0,0,0,0,0,0,0,0,0:00
,320,Ola Nilsson,,Malmö,Gk,43,0,0,0,0,0,0,0,0,0,0,0,0,0:00
,321,Daniel Henriksson,40,Luleå,Gk,44,0,0,0,2,0,0,0,0,0,0,0,0,0:00
,322,Marko Leinonen,,MODO,Gk,45,0,0,0,0,0,0,0,0,0,0,0,0,0:00
,323,Johan Lindblad,,VIK,Gk,47,0,0,0,2,0,0,0,0,0,0,0,0,0:00
,324,Bengt Höglund,,Leksand,Gk,48,0,0,0,0,0,0,0,0,0,0,0,0,0:00
,325,Kari Takko,,HV71,Gk,49,0,0,0,4,0,0,0,0,0,0,0,0,0:00
,325,Andreas Hadelöv,1,Malmö,Gk,49,0,0,0,0,0,0,0,0,0,0,0,0,0:00
,325,Johan Holmqvist,40,Brynäs,Gk,49,0,0,0,4,0,0,0,0,0,0,0,0,0:00
,328,Mattias Elm,,Linköping,Gk,50,0,0,0,6,0,0,0,0,0,0,0,0,0:00
,328,Reinhard Divis,38,Leksand,Gk,50,0,0,0,8,0,0,0,0,0,0,0,0,0:00
,328,Mario Brunetta,,Frölunda,Gk,50,0,0,0,8,0,0,0,0,0,0,0,0,0:00